region	tags	indicator	Программы подготовки квалифицированных рабочих, служащих на базе основного общего образования > В том числе обучаются > за счет бюджетных ассигнований > бюджета субъекта Российской Федерации > 15.0	Программы подготовки квалифицированных рабочих, служащих на базе основного общего образования > В том числе обучаются > за счет бюджетных ассигнований > местного бюджета > 16.0	Программы подготовки квалифицированных рабочих, служащих на базе основного общего образования > В том числе обучаются > за счет бюджетных ассигнований > федерального бюджета > 14.0	Программы подготовки квалифицированных рабочих, служащих на базе основного общего образования > В том числе обучаются > по договорам об оказании платных образова-тельных услуг > 17.0	Программы подготовки квалифицированных рабочих, служащих на базе основного общего образования > Всего (сумма гр. 14–17) > 13.0	Программы подготовки квалифицированных рабочих, служащих на базе среднего общего образования > В том числе обучаются > за счет бюджетных ассигнований > бюджета субъекта Российской Федерации > 20.0	Программы подготовки квалифицированных рабочих, служащих на базе среднего общего образования > В том числе обучаются > за счет бюджетных ассигнований > местного бюджета > 21.0	Программы подготовки квалифицированных рабочих, служащих на базе среднего общего образования > В том числе обучаются > за счет бюджетных ассигнований > федерального бюджета > 19.0	Программы подготовки квалифицированных рабочих, служащих на базе среднего общего образования > В том числе обучаются > по договорам об оказании платных образова-тельных услуг > 22.0	Программы подготовки квалифицированных рабочих, служащих на базе среднего общего образования > Всего (сумма гр. 19–22) > 18.0	Программы подготовки специалистов среднего звена на базе основного общего образования > В том числе обучаются > за счет бюджетных ассигнований > бюджета субъекта Российской Федерации > 5.0	Программы подготовки специалистов среднего звена на базе основного общего образования > В том числе обучаются > за счет бюджетных ассигнований > местного бюджета > 6.0	Программы подготовки специалистов среднего звена на базе основного общего образования > В том числе обучаются > за счет бюджетных ассигнований > федерального бюджета > 4.0	Программы подготовки специалистов среднего звена на базе основного общего образования > В том числе обучаются > по договорам об оказании платных образова-тельных услуг > 7.0	Программы подготовки специалистов среднего звена на базе основного общего образования > Всего (сумма гр. 4–7) > 3.0	Программы подготовки специалистов среднего звена на базе среднего общего образования > В том числе обучаются > за счет бюджетных ассигнований > бюджета субъекта Российской Федерации > 10.0	Программы подготовки специалистов среднего звена на базе среднего общего образования > В том числе обучаются > за счет бюджетных ассигнований > местного бюджета > 11.0	Программы подготовки специалистов среднего звена на базе среднего общего образования > В том числе обучаются > за счет бюджетных ассигнований > федерального бюджета > 9.0	Программы подготовки специалистов среднего звена на базе среднего общего образования > В том числе обучаются > по договорам об оказании платных образовате-льных услуг > 12.0	Программы подготовки специалистов среднего звена на базе среднего общего образования > Всего (сумма гр. 9–12) > 8.0
Алтайский край	Государственные, муниципальные (без учета организаций в ведении ФСИН); Заочная	            из стр. 11 - не прошли итоговую аттестацию / 12.0	0	0	0	0	0	0	0	0	0	0	0	0	0	0	0	0	0	0	0	0
Алтайский край	Государственные, муниципальные (без учета организаций в ведении ФСИН); Заочная	"            из стр. 11 – лица с ограниченными возможностями здоровья,
            инвалиды, дети-инвалиды / 13.0"	0	0	0	0	0	0	0	0	0	0	0	0	0	0	0	0	0	0	0	0
Алтайский край	Государственные, муниципальные (без учета организаций в ведении ФСИН); Заочная	         отчислено в виде меры дисциплинарного взыскания / 14.0	0	0	0	0	0	0	0	0	0	0	0	0	0	0	0	1	0	0	0	1
Алтайский край	Государственные, муниципальные (без учета организаций в ведении ФСИН); Заочная	         отчислено из-за просрочки оплаты обучения / 15.0	0	0	0	0	0	0	0	0	0	0	0	0	0	6	6	0	0	0	22	22
Алтайский край	Государственные, муниципальные (без учета организаций в ведении ФСИН); Заочная	"    в том числе:
    переведено на другие формы обучения данной
    организации на программы того же уровня / 7.0"	0	0	0	0	0	0	0	0	0	0	1	0	0	0	1	38	0	0	0	38
Алтайский край	Государственные, муниципальные (без учета организаций в ведении ФСИН); Заочная	"    в том числе:
    переведено с других форм обучения данной
    образовательной организации с программ того же уровня / 2.0"	0	0	0	0	0	0	0	0	0	0	2	0	0	6	8	67	0	3	33	103
Алтайский край	Государственные, муниципальные (без учета организаций в ведении ФСИН); Заочная	    восстановлены из числа ранее отчисленных / 4.0	0	0	0	0	0	0	0	0	0	0	0	0	0	4	4	14	0	4	30	48
Алтайский край	Государственные, муниципальные (без учета организаций в ведении ФСИН); Заочная	    выбыло по другим причинам / 16.0	0	0	0	0	0	0	0	0	0	0	0	0	0	0	0	49	0	27	12	88
Алтайский край	Государственные, муниципальные (без учета организаций в ведении ФСИН); Заочная	"    добровольно прекратили образовательные отношения
    (бросили учебу) / 10.0"	0	0	0	0	0	0	0	0	0	0	13	0	0	3	16	246	0	22	150	418
Алтайский край	Государственные, муниципальные (без учета организаций в ведении ФСИН); Заочная	"    отчислено:
         по неуспеваемости / 11.0"	0	0	0	0	0	0	0	0	0	0	0	0	0	0	0	77	0	19	26	122
Алтайский край	Государственные, муниципальные (без учета организаций в ведении ФСИН); Заочная	"    переведено в другие образовательные организации
    на программы того же уровня / 8.0"	0	0	0	0	0	0	0	0	0	0	0	0	0	3	3	20	0	0	2	22
Алтайский край	Государственные, муниципальные (без учета организаций в ведении ФСИН); Заочная	"    переведено из других образовательных организаций 
    с программ того же уровня / 3.0"	0	0	0	0	0	0	0	0	0	0	0	0	0	0	0	6	0	0	3	9
Алтайский край	Государственные, муниципальные (без учета организаций в ведении ФСИН); Заочная	    по болезни / 9.0	0	0	0	0	0	0	0	0	0	0	0	0	0	0	0	0	0	0	1	1
Алтайский край	Государственные, муниципальные (без учета организаций в ведении ФСИН); Заочная	    прибыло по другим причинам / 5.0	0	0	0	0	0	0	0	0	0	0	1	0	0	3	4	51	0	0	17	68
Алтайский край	Государственные, муниципальные (без учета организаций в ведении ФСИН); Заочная	Выбыло студентов - всего (сумма стр. 07-11, 13-15) / 6.0	0	0	0	0	0	0	0	0	0	0	14	0	0	12	26	431	0	68	213	712
Алтайский край	Государственные, муниципальные (без учета организаций в ведении ФСИН); Заочная	Прибыло студентов - всего (сумма стр. 02-05) / 1.0	0	0	0	0	0	0	0	0	0	0	3	0	0	13	16	138	0	7	83	228
Алтайский край	Государственные, муниципальные (без учета организаций в ведении ФСИН); Заочная	"Численность студентов на начало прошлого учебного года
(на 1 октября) / 17.0"	0	0	0	0	0	0	0	0	0	0	53	0	0	83	136	3015	0	297	1501	4813
Алтайский край	Государственные, муниципальные (без учета организаций в ведении ФСИН); Очная	            из стр. 11 - не прошли итоговую аттестацию / 12.0	24	0	0	2	26	0	0	0	0	0	3	0	0	3	6	2	0	0	0	2
Алтайский край	Государственные, муниципальные (без учета организаций в ведении ФСИН); Очная	"            из стр. 11 – лица с ограниченными возможностями здоровья,
            инвалиды, дети-инвалиды / 13.0"	0	0	0	0	0	0	0	0	0	0	0	0	0	0	0	0	0	0	0	0
Алтайский край	Государственные, муниципальные (без учета организаций в ведении ФСИН); Очная	         отчислено в виде меры дисциплинарного взыскания / 14.0	4	0	0	0	4	0	0	0	0	0	4	0	1	2	7	0	0	0	0	0
Алтайский край	Государственные, муниципальные (без учета организаций в ведении ФСИН); Очная	         отчислено из-за просрочки оплаты обучения / 15.0	0	0	0	16	16	0	0	0	4	4	0	0	0	48	48	0	0	0	30	30
Алтайский край	Государственные, муниципальные (без учета организаций в ведении ФСИН); Очная	"    в том числе:
    переведено на другие формы обучения данной
    организации на программы того же уровня / 7.0"	18	0	0	18	36	1	0	0	1	2	52	0	3	33	88	3	0	0	34	37
Алтайский край	Государственные, муниципальные (без учета организаций в ведении ФСИН); Очная	"    в том числе:
    переведено с других форм обучения данной
    образовательной организации с программ того же уровня / 2.0"	38	0	0	0	38	2	0	0	0	2	46	0	3	4	53	14	0	4	4	22
Алтайский край	Государственные, муниципальные (без учета организаций в ведении ФСИН); Очная	    восстановлены из числа ранее отчисленных / 4.0	30	0	0	2	32	1	0	0	0	1	71	0	1	43	115	13	0	6	20	39
Алтайский край	Государственные, муниципальные (без учета организаций в ведении ФСИН); Очная	    выбыло по другим причинам / 16.0	155	0	0	14	169	2	0	0	0	2	125	0	2	134	261	21	0	1	63	85
Алтайский край	Государственные, муниципальные (без учета организаций в ведении ФСИН); Очная	"    добровольно прекратили образовательные отношения
    (бросили учебу) / 10.0"	505	2	0	135	642	34	0	0	12	46	857	0	18	460	1335	295	0	48	233	576
Алтайский край	Государственные, муниципальные (без учета организаций в ведении ФСИН); Очная	"    отчислено:
         по неуспеваемости / 11.0"	147	0	0	6	153	1	0	0	1	2	133	0	5	52	190	33	0	37	39	109
Алтайский край	Государственные, муниципальные (без учета организаций в ведении ФСИН); Очная	"    переведено в другие образовательные организации
    на программы того же уровня / 8.0"	36	0	0	3	39	2	0	0	1	3	125	0	1	49	175	19	0	2	20	41
Алтайский край	Государственные, муниципальные (без учета организаций в ведении ФСИН); Очная	"    переведено из других образовательных организаций 
    с программ того же уровня / 3.0"	37	0	0	5	42	0	0	0	1	1	71	0	0	52	123	9	0	0	8	17
Алтайский край	Государственные, муниципальные (без учета организаций в ведении ФСИН); Очная	    по болезни / 9.0	3	0	0	0	3	0	0	0	0	0	1	0	0	2	3	0	0	10	58	68
Алтайский край	Государственные, муниципальные (без учета организаций в ведении ФСИН); Очная	    прибыло по другим причинам / 5.0	96	0	0	9	105	5	0	0	8	13	139	0	3	46	188	35	0	9	20	64
Алтайский край	Государственные, муниципальные (без учета организаций в ведении ФСИН); Очная	Выбыло студентов - всего (сумма стр. 07-11, 13-15) / 6.0	868	2	0	192	1062	40	0	0	19	59	1297	0	30	780	2107	371	0	98	477	946
Алтайский край	Государственные, муниципальные (без учета организаций в ведении ФСИН); Очная	Прибыло студентов - всего (сумма стр. 02-05) / 1.0	201	0	0	16	217	8	0	0	9	17	327	0	7	145	479	71	0	19	52	142
Алтайский край	Государственные, муниципальные (без учета организаций в ведении ФСИН); Очная	"Численность студентов на начало прошлого учебного года
(на 1 октября) / 17.0"	11480	25	183	1390	13078	364	0	49	94	507	16988	104	484	9090	26666	4117	0	570	3911	8598
Алтайский край	Очно-заочная; Государственные, муниципальные (без учета организаций в ведении ФСИН)	            из стр. 11 - не прошли итоговую аттестацию / 12.0	0	0	0	0	0	0	0	0	0	0	0	0	0	0	0	0	0	0	0	0
Алтайский край	Очно-заочная; Государственные, муниципальные (без учета организаций в ведении ФСИН)	"            из стр. 11 – лица с ограниченными возможностями здоровья,
            инвалиды, дети-инвалиды / 13.0"	0	0	0	0	0	0	0	0	0	0	0	0	0	0	0	0	0	0	0	0
Алтайский край	Очно-заочная; Государственные, муниципальные (без учета организаций в ведении ФСИН)	         отчислено в виде меры дисциплинарного взыскания / 14.0	0	0	0	0	0	0	0	0	0	0	0	0	0	0	0	0	0	0	0	0
Алтайский край	Очно-заочная; Государственные, муниципальные (без учета организаций в ведении ФСИН)	         отчислено из-за просрочки оплаты обучения / 15.0	0	0	0	0	0	0	0	0	0	0	0	0	0	0	0	0	0	0	0	0
Алтайский край	Очно-заочная; Государственные, муниципальные (без учета организаций в ведении ФСИН)	"    в том числе:
    переведено на другие формы обучения данной
    организации на программы того же уровня / 7.0"	0	0	0	0	0	0	0	0	0	0	0	0	0	0	0	0	0	0	5	5
Алтайский край	Очно-заочная; Государственные, муниципальные (без учета организаций в ведении ФСИН)	"    в том числе:
    переведено с других форм обучения данной
    образовательной организации с программ того же уровня / 2.0"	0	0	0	0	0	0	0	0	0	0	0	0	0	0	0	5	0	0	2	7
Алтайский край	Очно-заочная; Государственные, муниципальные (без учета организаций в ведении ФСИН)	    восстановлены из числа ранее отчисленных / 4.0	0	0	0	0	0	0	0	0	0	0	0	0	0	0	0	0	0	0	1	1
Алтайский край	Очно-заочная; Государственные, муниципальные (без учета организаций в ведении ФСИН)	    выбыло по другим причинам / 16.0	0	0	0	0	0	0	0	0	0	0	0	0	0	0	0	0	0	0	0	0
Алтайский край	Очно-заочная; Государственные, муниципальные (без учета организаций в ведении ФСИН)	"    добровольно прекратили образовательные отношения
    (бросили учебу) / 10.0"	0	0	0	0	0	0	0	0	1	1	0	0	0	0	0	9	0	0	29	38
Алтайский край	Очно-заочная; Государственные, муниципальные (без учета организаций в ведении ФСИН)	"    отчислено:
         по неуспеваемости / 11.0"	0	0	0	0	0	0	0	0	0	0	0	0	0	0	0	3	0	0	1	4
Алтайский край	Очно-заочная; Государственные, муниципальные (без учета организаций в ведении ФСИН)	"    переведено в другие образовательные организации
    на программы того же уровня / 8.0"	0	0	0	0	0	0	0	0	0	0	0	0	0	0	0	1	0	0	0	1
Алтайский край	Очно-заочная; Государственные, муниципальные (без учета организаций в ведении ФСИН)	"    переведено из других образовательных организаций 
    с программ того же уровня / 3.0"	0	0	0	0	0	0	0	0	0	0	0	0	0	0	0	0	0	0	0	0
Алтайский край	Очно-заочная; Государственные, муниципальные (без учета организаций в ведении ФСИН)	    по болезни / 9.0	0	0	0	0	0	0	0	0	0	0	0	0	0	0	0	0	0	0	0	0
Алтайский край	Очно-заочная; Государственные, муниципальные (без учета организаций в ведении ФСИН)	    прибыло по другим причинам / 5.0	0	0	0	0	0	0	0	0	0	0	0	0	0	0	0	0	0	0	0	0
Алтайский край	Очно-заочная; Государственные, муниципальные (без учета организаций в ведении ФСИН)	Выбыло студентов - всего (сумма стр. 07-11, 13-15) / 6.0	0	0	0	0	0	0	0	0	1	1	0	0	0	0	0	13	0	0	35	48
Алтайский край	Очно-заочная; Государственные, муниципальные (без учета организаций в ведении ФСИН)	Прибыло студентов - всего (сумма стр. 02-05) / 1.0	0	0	0	0	0	0	0	0	0	0	0	0	0	0	0	5	0	0	3	8
Алтайский край	Очно-заочная; Государственные, муниципальные (без учета организаций в ведении ФСИН)	"Численность студентов на начало прошлого учебного года
(на 1 октября) / 17.0"	0	0	0	0	0	0	0	0	0	0	0	0	0	0	0	154	0	0	395	549
Алтайский край	Частные; Заочная	            из стр. 11 - не прошли итоговую аттестацию / 12.0	0	0	0	0	0	0	0	0	0	0	0	0	0	1	1	0	0	0	1	1
Алтайский край	Частные; Заочная	"            из стр. 11 – лица с ограниченными возможностями здоровья,
            инвалиды, дети-инвалиды / 13.0"	0	0	0	0	0	0	0	0	0	0	0	0	0	0	0	0	0	0	0	0
Алтайский край	Частные; Заочная	         отчислено в виде меры дисциплинарного взыскания / 14.0	0	0	0	0	0	0	0	0	0	0	0	0	0	0	0	0	0	0	0	0
Алтайский край	Частные; Заочная	         отчислено из-за просрочки оплаты обучения / 15.0	0	0	0	0	0	0	0	0	0	0	0	0	0	20	20	0	0	0	5	5
Алтайский край	Частные; Заочная	"    в том числе:
    переведено на другие формы обучения данной
    организации на программы того же уровня / 7.0"	0	0	0	0	0	0	0	0	0	0	0	0	0	0	0	0	0	0	0	0
Алтайский край	Частные; Заочная	"    в том числе:
    переведено с других форм обучения данной
    образовательной организации с программ того же уровня / 2.0"	0	0	0	0	0	0	0	0	0	0	0	0	0	29	29	0	0	0	6	6
Алтайский край	Частные; Заочная	    восстановлены из числа ранее отчисленных / 4.0	0	0	0	0	0	0	0	0	0	0	0	0	0	4	4	0	0	0	4	4
Алтайский край	Частные; Заочная	    выбыло по другим причинам / 16.0	0	0	0	0	0	0	0	0	0	0	0	0	0	5	5	0	0	0	13	13
Алтайский край	Частные; Заочная	"    добровольно прекратили образовательные отношения
    (бросили учебу) / 10.0"	0	0	0	0	0	0	0	0	0	0	0	0	0	15	15	0	0	0	2	2
Алтайский край	Частные; Заочная	"    отчислено:
         по неуспеваемости / 11.0"	0	0	0	0	0	0	0	0	0	0	0	0	0	10	10	0	0	0	10	10
Алтайский край	Частные; Заочная	"    переведено в другие образовательные организации
    на программы того же уровня / 8.0"	0	0	0	0	0	0	0	0	0	0	0	0	0	2	2	0	0	0	11	11
Алтайский край	Частные; Заочная	"    переведено из других образовательных организаций 
    с программ того же уровня / 3.0"	0	0	0	0	0	0	0	0	0	0	0	0	0	8	8	0	0	0	1	1
Алтайский край	Частные; Заочная	    по болезни / 9.0	0	0	0	0	0	0	0	0	0	0	0	0	0	3	3	0	0	0	1	1
Алтайский край	Частные; Заочная	    прибыло по другим причинам / 5.0	0	0	0	0	0	0	0	0	0	0	0	0	0	0	0	0	0	0	0	0
Алтайский край	Частные; Заочная	Выбыло студентов - всего (сумма стр. 07-11, 13-15) / 6.0	0	0	0	0	0	0	0	0	0	0	0	0	0	55	55	0	0	0	42	42
Алтайский край	Частные; Заочная	Прибыло студентов - всего (сумма стр. 02-05) / 1.0	0	0	0	0	0	0	0	0	0	0	0	0	0	41	41	0	0	0	11	11
Алтайский край	Частные; Заочная	"Численность студентов на начало прошлого учебного года
(на 1 октября) / 17.0"	0	0	0	0	0	0	0	0	0	0	0	0	0	238	238	0	0	0	190	190
Алтайский край	Частные; Очная	            из стр. 11 - не прошли итоговую аттестацию / 12.0	0	0	0	0	0	0	0	0	0	0	0	0	0	9	9	0	0	0	3	3
Алтайский край	Частные; Очная	"            из стр. 11 – лица с ограниченными возможностями здоровья,
            инвалиды, дети-инвалиды / 13.0"	0	0	0	0	0	0	0	0	0	0	0	0	0	0	0	0	0	0	0	0
Алтайский край	Частные; Очная	         отчислено в виде меры дисциплинарного взыскания / 14.0	0	0	0	0	0	0	0	0	0	0	0	0	0	1	1	0	0	0	0	0
Алтайский край	Частные; Очная	         отчислено из-за просрочки оплаты обучения / 15.0	0	0	0	0	0	0	0	0	0	0	0	0	0	38	38	0	0	0	11	11
Алтайский край	Частные; Очная	"    в том числе:
    переведено на другие формы обучения данной
    организации на программы того же уровня / 7.0"	0	0	0	0	0	0	0	0	0	0	0	0	0	33	33	0	0	0	3	3
Алтайский край	Частные; Очная	"    в том числе:
    переведено с других форм обучения данной
    образовательной организации с программ того же уровня / 2.0"	0	0	0	0	0	0	0	0	0	0	0	0	0	4	4	0	0	0	0	0
Алтайский край	Частные; Очная	    восстановлены из числа ранее отчисленных / 4.0	0	0	0	0	0	0	0	0	0	0	0	0	0	26	26	0	0	0	4	4
Алтайский край	Частные; Очная	    выбыло по другим причинам / 16.0	0	0	0	0	0	0	0	0	0	0	0	0	0	59	59	0	0	0	21	21
Алтайский край	Частные; Очная	"    добровольно прекратили образовательные отношения
    (бросили учебу) / 10.0"	0	0	0	0	0	0	0	0	0	0	0	0	0	99	99	0	0	0	17	17
Алтайский край	Частные; Очная	"    отчислено:
         по неуспеваемости / 11.0"	0	0	0	0	0	0	0	0	0	0	0	0	0	42	42	0	0	0	8	8
Алтайский край	Частные; Очная	"    переведено в другие образовательные организации
    на программы того же уровня / 8.0"	0	0	0	0	0	0	0	0	0	0	0	0	0	32	32	0	0	0	7	7
Алтайский край	Частные; Очная	"    переведено из других образовательных организаций 
    с программ того же уровня / 3.0"	0	0	0	0	0	0	0	0	0	0	0	0	0	14	14	0	0	0	11	11
Алтайский край	Частные; Очная	    по болезни / 9.0	0	0	0	0	0	0	0	0	0	0	0	0	0	0	0	0	0	0	0	0
Алтайский край	Частные; Очная	    прибыло по другим причинам / 5.0	0	0	0	0	0	0	0	0	0	0	0	0	0	37	37	0	0	0	11	11
Алтайский край	Частные; Очная	Выбыло студентов - всего (сумма стр. 07-11, 13-15) / 6.0	0	0	0	0	0	0	0	0	0	0	0	0	0	304	304	0	0	0	67	67
Алтайский край	Частные; Очная	Прибыло студентов - всего (сумма стр. 02-05) / 1.0	0	0	0	0	0	0	0	0	0	0	0	0	0	81	81	0	0	0	26	26
Алтайский край	Частные; Очная	"Численность студентов на начало прошлого учебного года
(на 1 октября) / 17.0"	0	0	0	0	0	0	0	0	0	0	0	0	0	2084	2084	0	0	0	475	475
Амурская область	Государственные, муниципальные (без учета организаций в ведении ФСИН); Заочная	            из стр. 11 - не прошли итоговую аттестацию / 12.0	0	0	0	0	0	0	0	0	0	0	0	0	0	0	0	0	0	0	0	0
Амурская область	Государственные, муниципальные (без учета организаций в ведении ФСИН); Заочная	"            из стр. 11 – лица с ограниченными возможностями здоровья,
            инвалиды, дети-инвалиды / 13.0"	0	0	0	0	0	0	0	0	0	0	0	0	0	0	0	0	0	0	0	0
Амурская область	Государственные, муниципальные (без учета организаций в ведении ФСИН); Заочная	         отчислено в виде меры дисциплинарного взыскания / 14.0	0	0	0	0	0	0	0	0	0	0	0	0	0	0	0	0	0	0	0	0
Амурская область	Государственные, муниципальные (без учета организаций в ведении ФСИН); Заочная	         отчислено из-за просрочки оплаты обучения / 15.0	0	0	0	0	0	0	0	0	0	0	0	0	0	42	42	0	0	0	50	50
Амурская область	Государственные, муниципальные (без учета организаций в ведении ФСИН); Заочная	"    в том числе:
    переведено на другие формы обучения данной
    организации на программы того же уровня / 7.0"	0	0	0	0	0	0	0	0	0	0	0	0	0	7	7	0	0	1	18	19
Амурская область	Государственные, муниципальные (без учета организаций в ведении ФСИН); Заочная	"    в том числе:
    переведено с других форм обучения данной
    образовательной организации с программ того же уровня / 2.0"	0	0	0	0	0	0	0	0	0	0	0	0	0	77	77	1	0	11	24	36
Амурская область	Государственные, муниципальные (без учета организаций в ведении ФСИН); Заочная	    восстановлены из числа ранее отчисленных / 4.0	0	0	0	0	0	0	0	0	0	0	10	0	0	59	69	3	0	3	39	45
Амурская область	Государственные, муниципальные (без учета организаций в ведении ФСИН); Заочная	    выбыло по другим причинам / 16.0	0	0	0	0	0	0	0	0	0	0	0	0	0	44	44	4	0	18	59	81
Амурская область	Государственные, муниципальные (без учета организаций в ведении ФСИН); Заочная	"    добровольно прекратили образовательные отношения
    (бросили учебу) / 10.0"	0	0	0	0	0	0	0	0	0	0	0	0	0	42	42	15	0	24	41	80
Амурская область	Государственные, муниципальные (без учета организаций в ведении ФСИН); Заочная	"    отчислено:
         по неуспеваемости / 11.0"	0	0	0	0	0	0	0	0	0	0	0	0	0	15	15	4	0	3	20	27
Амурская область	Государственные, муниципальные (без учета организаций в ведении ФСИН); Заочная	"    переведено в другие образовательные организации
    на программы того же уровня / 8.0"	0	0	0	0	0	0	0	0	0	0	0	0	0	4	4	1	0	0	0	1
Амурская область	Государственные, муниципальные (без учета организаций в ведении ФСИН); Заочная	"    переведено из других образовательных организаций 
    с программ того же уровня / 3.0"	0	0	0	0	0	0	0	0	0	0	9	0	0	4	13	0	0	0	7	7
Амурская область	Государственные, муниципальные (без учета организаций в ведении ФСИН); Заочная	    по болезни / 9.0	0	0	0	0	0	0	0	0	0	0	0	0	0	0	0	0	0	0	0	0
Амурская область	Государственные, муниципальные (без учета организаций в ведении ФСИН); Заочная	    прибыло по другим причинам / 5.0	0	0	0	0	0	0	0	0	0	0	0	0	0	0	0	5	0	0	11	16
Амурская область	Государственные, муниципальные (без учета организаций в ведении ФСИН); Заочная	Выбыло студентов - всего (сумма стр. 07-11, 13-15) / 6.0	0	0	0	0	0	0	0	0	0	0	0	0	0	154	154	24	0	46	188	258
Амурская область	Государственные, муниципальные (без учета организаций в ведении ФСИН); Заочная	Прибыло студентов - всего (сумма стр. 02-05) / 1.0	0	0	0	0	0	0	0	0	0	0	19	0	0	140	159	9	0	14	81	104
Амурская область	Государственные, муниципальные (без учета организаций в ведении ФСИН); Заочная	"Численность студентов на начало прошлого учебного года
(на 1 октября) / 17.0"	0	0	0	0	0	0	0	0	0	0	74	0	0	758	832	279	0	456	1149	1884
Амурская область	Государственные, муниципальные (без учета организаций в ведении ФСИН); Очная	            из стр. 11 - не прошли итоговую аттестацию / 12.0	0	0	0	0	0	0	0	0	0	0	0	0	0	0	0	0	0	0	0	0
Амурская область	Государственные, муниципальные (без учета организаций в ведении ФСИН); Очная	"            из стр. 11 – лица с ограниченными возможностями здоровья,
            инвалиды, дети-инвалиды / 13.0"	0	0	0	0	0	0	0	0	0	0	2	0	0	0	2	0	0	0	0	0
Амурская область	Государственные, муниципальные (без учета организаций в ведении ФСИН); Очная	         отчислено в виде меры дисциплинарного взыскания / 14.0	18	0	0	0	18	0	0	0	0	0	27	0	5	6	38	0	0	0	0	0
Амурская область	Государственные, муниципальные (без учета организаций в ведении ФСИН); Очная	         отчислено из-за просрочки оплаты обучения / 15.0	0	0	0	2	2	0	0	0	0	0	0	0	0	50	50	0	0	0	29	29
Амурская область	Государственные, муниципальные (без учета организаций в ведении ФСИН); Очная	"    в том числе:
    переведено на другие формы обучения данной
    организации на программы того же уровня / 7.0"	1	0	0	0	1	0	0	0	0	0	63	0	11	135	209	5	0	0	18	23
Амурская область	Государственные, муниципальные (без учета организаций в ведении ФСИН); Очная	"    в том числе:
    переведено с других форм обучения данной
    образовательной организации с программ того же уровня / 2.0"	0	0	0	0	0	0	0	0	0	0	30	0	21	65	116	6	0	2	1	9
Амурская область	Государственные, муниципальные (без учета организаций в ведении ФСИН); Очная	    восстановлены из числа ранее отчисленных / 4.0	7	0	3	0	10	0	0	0	0	0	28	0	6	70	104	2	0	0	15	17
Амурская область	Государственные, муниципальные (без учета организаций в ведении ФСИН); Очная	    выбыло по другим причинам / 16.0	24	0	0	0	24	8	0	0	0	8	81	0	78	106	265	22	0	9	13	44
Амурская область	Государственные, муниципальные (без учета организаций в ведении ФСИН); Очная	"    добровольно прекратили образовательные отношения
    (бросили учебу) / 10.0"	277	0	35	18	330	12	0	0	0	12	271	0	127	248	646	50	0	13	61	124
Амурская область	Государственные, муниципальные (без учета организаций в ведении ФСИН); Очная	"    отчислено:
         по неуспеваемости / 11.0"	64	0	10	0	74	4	0	0	0	4	116	0	28	44	188	3	0	4	17	24
Амурская область	Государственные, муниципальные (без учета организаций в ведении ФСИН); Очная	"    переведено в другие образовательные организации
    на программы того же уровня / 8.0"	32	0	5	0	37	0	0	0	0	0	72	0	57	102	231	12	0	1	4	17
Амурская область	Государственные, муниципальные (без учета организаций в ведении ФСИН); Очная	"    переведено из других образовательных организаций 
    с программ того же уровня / 3.0"	24	0	0	0	24	0	0	0	0	0	49	0	21	44	114	11	0	1	2	14
Амурская область	Государственные, муниципальные (без учета организаций в ведении ФСИН); Очная	    по болезни / 9.0	37	0	0	0	37	0	0	0	0	0	2	0	0	3	5	7	0	0	0	7
Амурская область	Государственные, муниципальные (без учета организаций в ведении ФСИН); Очная	    прибыло по другим причинам / 5.0	17	0	0	34	51	2	0	0	0	2	16	0	27	39	82	2	0	2	3	7
Амурская область	Государственные, муниципальные (без учета организаций в ведении ФСИН); Очная	Выбыло студентов - всего (сумма стр. 07-11, 13-15) / 6.0	453	0	50	20	523	24	0	0	0	24	632	0	306	694	1632	99	0	27	142	268
Амурская область	Государственные, муниципальные (без учета организаций в ведении ФСИН); Очная	Прибыло студентов - всего (сумма стр. 02-05) / 1.0	48	0	3	34	85	2	0	0	0	2	123	0	75	218	416	21	0	5	21	47
Амурская область	Государственные, муниципальные (без учета организаций в ведении ФСИН); Очная	"Численность студентов на начало прошлого учебного года
(на 1 октября) / 17.0"	3418	0	363	179	3960	125	0	0	13	138	6592	0	3188	3525	13305	863	4	290	1102	2259
Амурская область	Очно-заочная; Государственные, муниципальные (без учета организаций в ведении ФСИН)	            из стр. 11 - не прошли итоговую аттестацию / 12.0	0	0	0	0	0	0	0	0	0	0	0	0	0	0	0	0	0	0	0	0
Амурская область	Очно-заочная; Государственные, муниципальные (без учета организаций в ведении ФСИН)	"            из стр. 11 – лица с ограниченными возможностями здоровья,
            инвалиды, дети-инвалиды / 13.0"	0	0	0	0	0	0	0	0	0	0	0	0	0	0	0	0	0	0	0	0
Амурская область	Очно-заочная; Государственные, муниципальные (без учета организаций в ведении ФСИН)	         отчислено в виде меры дисциплинарного взыскания / 14.0	0	0	0	0	0	0	0	0	0	0	0	0	0	0	0	0	0	0	0	0
Амурская область	Очно-заочная; Государственные, муниципальные (без учета организаций в ведении ФСИН)	         отчислено из-за просрочки оплаты обучения / 15.0	0	0	0	0	0	0	0	0	0	0	0	0	0	0	0	0	0	0	0	0
Амурская область	Очно-заочная; Государственные, муниципальные (без учета организаций в ведении ФСИН)	"    в том числе:
    переведено на другие формы обучения данной
    организации на программы того же уровня / 7.0"	0	0	0	0	0	0	0	0	0	0	0	0	0	2	2	0	0	0	1	1
Амурская область	Очно-заочная; Государственные, муниципальные (без учета организаций в ведении ФСИН)	"    в том числе:
    переведено с других форм обучения данной
    образовательной организации с программ того же уровня / 2.0"	0	0	0	0	0	0	0	0	0	0	0	0	0	1	1	3	0	0	0	3
Амурская область	Очно-заочная; Государственные, муниципальные (без учета организаций в ведении ФСИН)	    восстановлены из числа ранее отчисленных / 4.0	0	0	0	0	0	0	0	0	0	0	0	0	0	0	0	4	0	0	9	13
Амурская область	Очно-заочная; Государственные, муниципальные (без учета организаций в ведении ФСИН)	    выбыло по другим причинам / 16.0	0	0	0	0	0	0	0	0	0	0	0	0	0	8	8	0	0	0	2	2
Амурская область	Очно-заочная; Государственные, муниципальные (без учета организаций в ведении ФСИН)	"    добровольно прекратили образовательные отношения
    (бросили учебу) / 10.0"	0	0	0	0	0	0	0	0	0	0	0	0	0	0	0	25	0	0	25	50
Амурская область	Очно-заочная; Государственные, муниципальные (без учета организаций в ведении ФСИН)	"    отчислено:
         по неуспеваемости / 11.0"	0	0	0	0	0	0	0	0	0	0	0	0	0	0	0	0	0	0	1	1
Амурская область	Очно-заочная; Государственные, муниципальные (без учета организаций в ведении ФСИН)	"    переведено в другие образовательные организации
    на программы того же уровня / 8.0"	0	0	0	0	0	0	0	0	0	0	0	0	0	0	0	0	0	0	2	2
Амурская область	Очно-заочная; Государственные, муниципальные (без учета организаций в ведении ФСИН)	"    переведено из других образовательных организаций 
    с программ того же уровня / 3.0"	0	0	0	0	0	0	0	0	0	0	0	0	0	1	1	0	0	0	0	0
Амурская область	Очно-заочная; Государственные, муниципальные (без учета организаций в ведении ФСИН)	    по болезни / 9.0	0	0	0	0	0	0	0	0	0	0	0	0	0	0	0	0	0	0	0	0
Амурская область	Очно-заочная; Государственные, муниципальные (без учета организаций в ведении ФСИН)	    прибыло по другим причинам / 5.0	0	0	0	0	0	0	0	0	0	0	0	0	0	0	0	0	0	0	0	0
Амурская область	Очно-заочная; Государственные, муниципальные (без учета организаций в ведении ФСИН)	Выбыло студентов - всего (сумма стр. 07-11, 13-15) / 6.0	0	0	0	0	0	0	0	0	0	0	0	0	0	10	10	25	0	0	31	56
Амурская область	Очно-заочная; Государственные, муниципальные (без учета организаций в ведении ФСИН)	Прибыло студентов - всего (сумма стр. 02-05) / 1.0	0	0	0	0	0	0	0	0	0	0	0	0	0	2	2	7	0	0	9	16
Амурская область	Очно-заочная; Государственные, муниципальные (без учета организаций в ведении ФСИН)	"Численность студентов на начало прошлого учебного года
(на 1 октября) / 17.0"	0	0	0	0	0	0	0	0	0	0	0	0	0	24	24	154	0	0	248	402
Амурская область	Частные; Очная	            из стр. 11 - не прошли итоговую аттестацию / 12.0	0	0	0	0	0	0	0	0	0	0	0	0	0	0	0	0	0	0	0	0
Амурская область	Частные; Очная	"            из стр. 11 – лица с ограниченными возможностями здоровья,
            инвалиды, дети-инвалиды / 13.0"	0	0	0	0	0	0	0	0	0	0	0	0	0	0	0	0	0	0	0	0
Амурская область	Частные; Очная	         отчислено в виде меры дисциплинарного взыскания / 14.0	0	0	0	0	0	0	0	0	0	0	0	0	0	0	0	0	0	0	0	0
Амурская область	Частные; Очная	         отчислено из-за просрочки оплаты обучения / 15.0	0	0	0	0	0	0	0	0	0	0	0	0	0	0	0	0	0	0	0	0
Амурская область	Частные; Очная	"    в том числе:
    переведено на другие формы обучения данной
    организации на программы того же уровня / 7.0"	0	0	0	0	0	0	0	0	0	0	0	0	0	0	0	0	0	0	0	0
Амурская область	Частные; Очная	"    в том числе:
    переведено с других форм обучения данной
    образовательной организации с программ того же уровня / 2.0"	0	0	0	0	0	0	0	0	0	0	0	0	0	0	0	0	0	0	0	0
Амурская область	Частные; Очная	    восстановлены из числа ранее отчисленных / 4.0	0	0	0	0	0	0	0	0	0	0	0	0	0	0	0	0	0	0	0	0
Амурская область	Частные; Очная	    выбыло по другим причинам / 16.0	0	0	0	0	0	0	0	0	0	0	0	0	0	0	0	0	0	0	0	0
Амурская область	Частные; Очная	"    добровольно прекратили образовательные отношения
    (бросили учебу) / 10.0"	0	0	0	0	0	0	0	0	0	0	0	0	0	0	0	0	0	0	3	3
Амурская область	Частные; Очная	"    отчислено:
         по неуспеваемости / 11.0"	0	0	0	0	0	0	0	0	0	0	0	0	0	0	0	0	0	0	0	0
Амурская область	Частные; Очная	"    переведено в другие образовательные организации
    на программы того же уровня / 8.0"	0	0	0	0	0	0	0	0	0	0	0	0	0	0	0	0	0	0	0	0
Амурская область	Частные; Очная	"    переведено из других образовательных организаций 
    с программ того же уровня / 3.0"	0	0	0	0	0	0	0	0	0	0	0	0	0	0	0	0	0	0	0	0
Амурская область	Частные; Очная	    по болезни / 9.0	0	0	0	0	0	0	0	0	0	0	0	0	0	0	0	0	0	0	0	0
Амурская область	Частные; Очная	    прибыло по другим причинам / 5.0	0	0	0	0	0	0	0	0	0	0	0	0	0	0	0	0	0	0	0	0
Амурская область	Частные; Очная	Выбыло студентов - всего (сумма стр. 07-11, 13-15) / 6.0	0	0	0	0	0	0	0	0	0	0	0	0	0	0	0	0	0	0	3	3
Амурская область	Частные; Очная	Прибыло студентов - всего (сумма стр. 02-05) / 1.0	0	0	0	0	0	0	0	0	0	0	0	0	0	0	0	0	0	0	0	0
Амурская область	Частные; Очная	"Численность студентов на начало прошлого учебного года
(на 1 октября) / 17.0"	0	0	0	0	0	0	0	0	8	8	0	0	0	0	0	0	0	0	45	45
Амурская область	Частные; Очно-заочная	            из стр. 11 - не прошли итоговую аттестацию / 12.0	0	0	0	0	0	0	0	0	0	0	0	0	0	0	0	0	0	0	0	0
Амурская область	Частные; Очно-заочная	"            из стр. 11 – лица с ограниченными возможностями здоровья,
            инвалиды, дети-инвалиды / 13.0"	0	0	0	0	0	0	0	0	0	0	0	0	0	0	0	0	0	0	0	0
Амурская область	Частные; Очно-заочная	         отчислено в виде меры дисциплинарного взыскания / 14.0	0	0	0	0	0	0	0	0	0	0	0	0	0	0	0	0	0	0	0	0
Амурская область	Частные; Очно-заочная	         отчислено из-за просрочки оплаты обучения / 15.0	0	0	0	0	0	0	0	0	0	0	0	0	0	0	0	0	0	0	0	0
Амурская область	Частные; Очно-заочная	"    в том числе:
    переведено на другие формы обучения данной
    организации на программы того же уровня / 7.0"	0	0	0	0	0	0	0	0	0	0	0	0	0	0	0	0	0	0	0	0
Амурская область	Частные; Очно-заочная	"    в том числе:
    переведено с других форм обучения данной
    образовательной организации с программ того же уровня / 2.0"	0	0	0	0	0	0	0	0	0	0	0	0	0	0	0	0	0	0	0	0
Амурская область	Частные; Очно-заочная	    восстановлены из числа ранее отчисленных / 4.0	0	0	0	0	0	0	0	0	0	0	0	0	0	0	0	0	0	0	0	0
Амурская область	Частные; Очно-заочная	    выбыло по другим причинам / 16.0	0	0	0	0	0	0	0	0	0	0	0	0	0	0	0	0	0	0	0	0
Амурская область	Частные; Очно-заочная	"    добровольно прекратили образовательные отношения
    (бросили учебу) / 10.0"	0	0	0	0	0	0	0	0	4	4	0	0	0	0	0	0	0	0	0	0
Амурская область	Частные; Очно-заочная	"    отчислено:
         по неуспеваемости / 11.0"	0	0	0	0	0	0	0	0	0	0	0	0	0	0	0	0	0	0	0	0
Амурская область	Частные; Очно-заочная	"    переведено в другие образовательные организации
    на программы того же уровня / 8.0"	0	0	0	0	0	0	0	0	0	0	0	0	0	0	0	0	0	0	0	0
Амурская область	Частные; Очно-заочная	"    переведено из других образовательных организаций 
    с программ того же уровня / 3.0"	0	0	0	0	0	0	0	0	0	0	0	0	0	0	0	0	0	0	0	0
Амурская область	Частные; Очно-заочная	    по болезни / 9.0	0	0	0	0	0	0	0	0	0	0	0	0	0	0	0	0	0	0	0	0
Амурская область	Частные; Очно-заочная	    прибыло по другим причинам / 5.0	0	0	0	0	0	0	0	0	0	0	0	0	0	0	0	0	0	0	0	0
Амурская область	Частные; Очно-заочная	Выбыло студентов - всего (сумма стр. 07-11, 13-15) / 6.0	0	0	0	0	0	0	0	0	4	4	0	0	0	0	0	0	0	0	0	0
Амурская область	Частные; Очно-заочная	Прибыло студентов - всего (сумма стр. 02-05) / 1.0	0	0	0	0	0	0	0	0	0	0	0	0	0	0	0	0	0	0	0	0
Амурская область	Частные; Очно-заочная	"Численность студентов на начало прошлого учебного года
(на 1 октября) / 17.0"	0	0	0	0	0	0	0	0	34	34	0	0	0	0	0	0	0	0	0	0
Архангельская область	Государственные, муниципальные (без учета организаций в ведении ФСИН); Заочная	            из стр. 11 - не прошли итоговую аттестацию / 12.0	0	0	0	0	0	0	0	0	0	0	0	0	0	0	0	0	0	0	0	0
Архангельская область	Государственные, муниципальные (без учета организаций в ведении ФСИН); Заочная	"            из стр. 11 – лица с ограниченными возможностями здоровья,
            инвалиды, дети-инвалиды / 13.0"	0	0	0	0	0	0	0	0	0	0	0	0	0	0	0	0	0	0	0	0
Архангельская область	Государственные, муниципальные (без учета организаций в ведении ФСИН); Заочная	         отчислено в виде меры дисциплинарного взыскания / 14.0	0	0	0	0	0	0	0	0	0	0	0	0	0	0	0	0	0	0	0	0
Архангельская область	Государственные, муниципальные (без учета организаций в ведении ФСИН); Заочная	         отчислено из-за просрочки оплаты обучения / 15.0	0	0	0	0	0	0	0	0	0	0	0	0	0	0	0	0	0	0	16	16
Архангельская область	Государственные, муниципальные (без учета организаций в ведении ФСИН); Заочная	"    в том числе:
    переведено на другие формы обучения данной
    организации на программы того же уровня / 7.0"	0	0	0	0	0	0	0	0	0	0	0	0	0	0	0	0	0	1	4	5
Архангельская область	Государственные, муниципальные (без учета организаций в ведении ФСИН); Заочная	"    в том числе:
    переведено с других форм обучения данной
    образовательной организации с программ того же уровня / 2.0"	0	0	0	0	0	0	0	0	0	0	0	0	0	0	0	5	0	0	13	18
Архангельская область	Государственные, муниципальные (без учета организаций в ведении ФСИН); Заочная	    восстановлены из числа ранее отчисленных / 4.0	0	0	0	0	0	0	0	0	0	0	0	0	2	0	2	5	0	3	14	22
Архангельская область	Государственные, муниципальные (без учета организаций в ведении ФСИН); Заочная	    выбыло по другим причинам / 16.0	0	0	0	0	0	0	0	0	0	0	0	0	1	0	1	36	0	0	22	58
Архангельская область	Государственные, муниципальные (без учета организаций в ведении ФСИН); Заочная	"    добровольно прекратили образовательные отношения
    (бросили учебу) / 10.0"	0	0	0	0	0	0	0	0	0	0	0	0	0	0	0	125	0	25	84	234
Архангельская область	Государственные, муниципальные (без учета организаций в ведении ФСИН); Заочная	"    отчислено:
         по неуспеваемости / 11.0"	0	0	0	0	0	0	0	0	0	0	0	0	1	0	1	27	0	58	31	116
Архангельская область	Государственные, муниципальные (без учета организаций в ведении ФСИН); Заочная	"    переведено в другие образовательные организации
    на программы того же уровня / 8.0"	0	0	0	0	0	0	0	0	0	0	0	0	0	0	0	0	0	3	4	7
Архангельская область	Государственные, муниципальные (без учета организаций в ведении ФСИН); Заочная	"    переведено из других образовательных организаций 
    с программ того же уровня / 3.0"	0	0	0	0	0	0	0	0	0	0	0	0	0	0	0	3	0	0	0	3
Архангельская область	Государственные, муниципальные (без учета организаций в ведении ФСИН); Заочная	    по болезни / 9.0	0	0	0	0	0	0	0	0	0	0	0	0	0	0	0	1	0	0	0	1
Архангельская область	Государственные, муниципальные (без учета организаций в ведении ФСИН); Заочная	    прибыло по другим причинам / 5.0	0	0	0	0	0	0	0	0	0	0	0	0	0	0	0	23	0	15	13	51
Архангельская область	Государственные, муниципальные (без учета организаций в ведении ФСИН); Заочная	Выбыло студентов - всего (сумма стр. 07-11, 13-15) / 6.0	0	0	0	0	0	0	0	0	0	0	0	0	2	0	2	189	0	87	161	437
Архангельская область	Государственные, муниципальные (без учета организаций в ведении ФСИН); Заочная	Прибыло студентов - всего (сумма стр. 02-05) / 1.0	0	0	0	0	0	0	0	0	0	0	0	0	2	0	2	36	0	18	40	94
Архангельская область	Государственные, муниципальные (без учета организаций в ведении ФСИН); Заочная	"Численность студентов на начало прошлого учебного года
(на 1 октября) / 17.0"	0	0	0	0	0	0	0	0	0	0	0	0	4	1	5	1537	0	484	1042	3063
Архангельская область	Государственные, муниципальные (без учета организаций в ведении ФСИН); Очная	            из стр. 11 - не прошли итоговую аттестацию / 12.0	1	0	0	0	1	0	0	0	0	0	19	0	0	0	19	0	0	1	0	1
Архангельская область	Государственные, муниципальные (без учета организаций в ведении ФСИН); Очная	"            из стр. 11 – лица с ограниченными возможностями здоровья,
            инвалиды, дети-инвалиды / 13.0"	0	0	0	0	0	0	0	0	0	0	1	0	1	0	2	0	0	0	0	0
Архангельская область	Государственные, муниципальные (без учета организаций в ведении ФСИН); Очная	         отчислено в виде меры дисциплинарного взыскания / 14.0	2	0	0	0	2	0	0	0	0	0	7	0	0	0	7	1	0	0	0	1
Архангельская область	Государственные, муниципальные (без учета организаций в ведении ФСИН); Очная	         отчислено из-за просрочки оплаты обучения / 15.0	0	0	0	0	0	0	0	0	0	0	0	0	0	4	4	0	0	0	6	6
Архангельская область	Государственные, муниципальные (без учета организаций в ведении ФСИН); Очная	"    в том числе:
    переведено на другие формы обучения данной
    организации на программы того же уровня / 7.0"	6	12	0	0	18	0	0	0	0	0	18	3	0	28	49	19	0	0	2	21
Архангельская область	Государственные, муниципальные (без учета организаций в ведении ФСИН); Очная	"    в том числе:
    переведено с других форм обучения данной
    образовательной организации с программ того же уровня / 2.0"	18	0	0	0	18	0	0	0	0	0	6	3	2	2	13	1	0	2	2	5
Архангельская область	Государственные, муниципальные (без учета организаций в ведении ФСИН); Очная	    восстановлены из числа ранее отчисленных / 4.0	29	2	0	0	31	0	0	0	1	1	22	4	23	8	57	0	0	2	2	4
Архангельская область	Государственные, муниципальные (без учета организаций в ведении ФСИН); Очная	    выбыло по другим причинам / 16.0	168	0	0	2	170	6	0	0	0	6	77	0	15	33	125	176	0	2	33	211
Архангельская область	Государственные, муниципальные (без учета организаций в ведении ФСИН); Очная	"    добровольно прекратили образовательные отношения
    (бросили учебу) / 10.0"	238	84	0	1	323	7	0	0	0	7	284	37	102	44	467	71	0	44	18	133
Архангельская область	Государственные, муниципальные (без учета организаций в ведении ФСИН); Очная	"    отчислено:
         по неуспеваемости / 11.0"	127	12	0	5	144	0	0	0	0	0	108	11	126	12	257	24	0	48	14	86
Архангельская область	Государственные, муниципальные (без учета организаций в ведении ФСИН); Очная	"    переведено в другие образовательные организации
    на программы того же уровня / 8.0"	48	18	0	0	66	0	0	0	0	0	81	5	42	22	150	17	0	1	3	21
Архангельская область	Государственные, муниципальные (без учета организаций в ведении ФСИН); Очная	"    переведено из других образовательных организаций 
    с программ того же уровня / 3.0"	30	0	0	0	30	0	0	0	0	0	42	2	67	8	119	4	0	5	4	13
Архангельская область	Государственные, муниципальные (без учета организаций в ведении ФСИН); Очная	    по болезни / 9.0	11	0	0	0	11	0	0	0	0	0	7	0	33	3	43	0	0	0	6	6
Архангельская область	Государственные, муниципальные (без учета организаций в ведении ФСИН); Очная	    прибыло по другим причинам / 5.0	119	0	0	0	119	11	0	0	0	11	116	0	27	23	166	26	0	9	20	55
Архангельская область	Государственные, муниципальные (без учета организаций в ведении ФСИН); Очная	Выбыло студентов - всего (сумма стр. 07-11, 13-15) / 6.0	600	126	0	8	734	13	0	0	0	13	582	56	318	146	1102	308	0	95	82	485
Архангельская область	Государственные, муниципальные (без учета организаций в ведении ФСИН); Очная	Прибыло студентов - всего (сумма стр. 02-05) / 1.0	196	2	0	0	198	11	0	0	1	12	186	9	119	41	355	31	0	18	28	77
Архангельская область	Государственные, муниципальные (без учета организаций в ведении ФСИН); Очная	"Численность студентов на начало прошлого учебного года
(на 1 октября) / 17.0"	6976	544	0	47	7567	136	0	0	13	149	6821	230	3353	813	11217	2443	8	779	348	3578
Архангельская область	Очно-заочная; Государственные, муниципальные (без учета организаций в ведении ФСИН)	            из стр. 11 - не прошли итоговую аттестацию / 12.0	0	0	0	0	0	0	0	0	0	0	0	0	0	0	0	0	0	0	0	0
Архангельская область	Очно-заочная; Государственные, муниципальные (без учета организаций в ведении ФСИН)	"            из стр. 11 – лица с ограниченными возможностями здоровья,
            инвалиды, дети-инвалиды / 13.0"	0	0	0	0	0	0	0	0	0	0	0	0	0	0	0	0	0	0	0	0
Архангельская область	Очно-заочная; Государственные, муниципальные (без учета организаций в ведении ФСИН)	         отчислено в виде меры дисциплинарного взыскания / 14.0	0	0	0	0	0	0	0	0	0	0	0	0	0	0	0	0	0	0	0	0
Архангельская область	Очно-заочная; Государственные, муниципальные (без учета организаций в ведении ФСИН)	         отчислено из-за просрочки оплаты обучения / 15.0	0	0	0	0	0	0	0	0	0	0	0	0	0	0	0	0	0	0	0	0
Архангельская область	Очно-заочная; Государственные, муниципальные (без учета организаций в ведении ФСИН)	"    в том числе:
    переведено на другие формы обучения данной
    организации на программы того же уровня / 7.0"	0	0	0	0	0	0	0	0	0	0	0	0	0	0	0	0	0	0	0	0
Архангельская область	Очно-заочная; Государственные, муниципальные (без учета организаций в ведении ФСИН)	"    в том числе:
    переведено с других форм обучения данной
    образовательной организации с программ того же уровня / 2.0"	0	0	0	0	0	0	0	0	0	0	0	0	0	0	0	0	0	0	1	1
Архангельская область	Очно-заочная; Государственные, муниципальные (без учета организаций в ведении ФСИН)	    восстановлены из числа ранее отчисленных / 4.0	0	0	0	0	0	0	0	0	0	0	0	0	0	0	0	0	0	0	2	2
Архангельская область	Очно-заочная; Государственные, муниципальные (без учета организаций в ведении ФСИН)	    выбыло по другим причинам / 16.0	0	0	0	0	0	0	0	0	0	0	0	0	0	0	0	0	0	0	41	41
Архангельская область	Очно-заочная; Государственные, муниципальные (без учета организаций в ведении ФСИН)	"    добровольно прекратили образовательные отношения
    (бросили учебу) / 10.0"	0	0	0	0	0	0	0	0	0	0	0	0	0	0	0	0	0	0	0	0
Архангельская область	Очно-заочная; Государственные, муниципальные (без учета организаций в ведении ФСИН)	"    отчислено:
         по неуспеваемости / 11.0"	0	0	0	0	0	0	0	0	0	0	0	0	0	0	0	0	0	0	0	0
Архангельская область	Очно-заочная; Государственные, муниципальные (без учета организаций в ведении ФСИН)	"    переведено в другие образовательные организации
    на программы того же уровня / 8.0"	0	0	0	0	0	0	0	0	0	0	0	0	0	0	0	0	0	0	0	0
Архангельская область	Очно-заочная; Государственные, муниципальные (без учета организаций в ведении ФСИН)	"    переведено из других образовательных организаций 
    с программ того же уровня / 3.0"	0	0	0	0	0	0	0	0	0	0	0	0	0	0	0	0	0	0	1	1
Архангельская область	Очно-заочная; Государственные, муниципальные (без учета организаций в ведении ФСИН)	    по болезни / 9.0	0	0	0	0	0	0	0	0	0	0	0	0	0	0	0	0	0	0	0	0
Архангельская область	Очно-заочная; Государственные, муниципальные (без учета организаций в ведении ФСИН)	    прибыло по другим причинам / 5.0	0	0	0	0	0	0	0	0	0	0	0	0	0	0	0	0	0	0	0	0
Архангельская область	Очно-заочная; Государственные, муниципальные (без учета организаций в ведении ФСИН)	Выбыло студентов - всего (сумма стр. 07-11, 13-15) / 6.0	0	0	0	0	0	0	0	0	0	0	0	0	0	0	0	0	0	0	41	41
Архангельская область	Очно-заочная; Государственные, муниципальные (без учета организаций в ведении ФСИН)	Прибыло студентов - всего (сумма стр. 02-05) / 1.0	0	0	0	0	0	0	0	0	0	0	0	0	0	0	0	0	0	0	4	4
Архангельская область	Очно-заочная; Государственные, муниципальные (без учета организаций в ведении ФСИН)	"Численность студентов на начало прошлого учебного года
(на 1 октября) / 17.0"	0	0	0	0	0	0	0	0	0	0	0	0	0	0	0	15	0	0	273	288
Архангельская область	Частные; Заочная	            из стр. 11 - не прошли итоговую аттестацию / 12.0	0	0	0	0	0	0	0	0	0	0	0	0	0	0	0	0	0	0	0	0
Архангельская область	Частные; Заочная	"            из стр. 11 – лица с ограниченными возможностями здоровья,
            инвалиды, дети-инвалиды / 13.0"	0	0	0	0	0	0	0	0	0	0	0	0	0	0	0	0	0	0	0	0
Архангельская область	Частные; Заочная	         отчислено в виде меры дисциплинарного взыскания / 14.0	0	0	0	0	0	0	0	0	0	0	0	0	0	0	0	0	0	0	0	0
Архангельская область	Частные; Заочная	         отчислено из-за просрочки оплаты обучения / 15.0	0	0	0	0	0	0	0	0	0	0	0	0	0	3	3	0	0	0	3	3
Архангельская область	Частные; Заочная	"    в том числе:
    переведено на другие формы обучения данной
    организации на программы того же уровня / 7.0"	0	0	0	0	0	0	0	0	0	0	0	0	0	0	0	0	0	0	2	2
Архангельская область	Частные; Заочная	"    в том числе:
    переведено с других форм обучения данной
    образовательной организации с программ того же уровня / 2.0"	0	0	0	0	0	0	0	0	0	0	0	0	0	5	5	0	0	0	0	0
Архангельская область	Частные; Заочная	    восстановлены из числа ранее отчисленных / 4.0	0	0	0	0	0	0	0	0	0	0	0	0	0	3	3	0	0	0	4	4
Архангельская область	Частные; Заочная	    выбыло по другим причинам / 16.0	0	0	0	0	0	0	0	0	0	0	0	0	0	14	14	0	0	0	6	6
Архангельская область	Частные; Заочная	"    добровольно прекратили образовательные отношения
    (бросили учебу) / 10.0"	0	0	0	0	0	0	0	0	0	0	0	0	0	29	29	0	0	0	35	35
Архангельская область	Частные; Заочная	"    отчислено:
         по неуспеваемости / 11.0"	0	0	0	0	0	0	0	0	0	0	0	0	0	19	19	0	0	0	16	16
Архангельская область	Частные; Заочная	"    переведено в другие образовательные организации
    на программы того же уровня / 8.0"	0	0	0	0	0	0	0	0	0	0	0	0	0	1	1	0	0	0	0	0
Архангельская область	Частные; Заочная	"    переведено из других образовательных организаций 
    с программ того же уровня / 3.0"	0	0	0	0	0	0	0	0	0	0	0	0	0	0	0	0	0	0	1	1
Архангельская область	Частные; Заочная	    по болезни / 9.0	0	0	0	0	0	0	0	0	0	0	0	0	0	0	0	0	0	0	0	0
Архангельская область	Частные; Заочная	    прибыло по другим причинам / 5.0	0	0	0	0	0	0	0	0	0	0	0	0	0	16	16	0	0	0	30	30
Архангельская область	Частные; Заочная	Выбыло студентов - всего (сумма стр. 07-11, 13-15) / 6.0	0	0	0	0	0	0	0	0	0	0	0	0	0	66	66	0	0	0	62	62
Архангельская область	Частные; Заочная	Прибыло студентов - всего (сумма стр. 02-05) / 1.0	0	0	0	0	0	0	0	0	0	0	0	0	0	24	24	0	0	0	35	35
Архангельская область	Частные; Заочная	"Численность студентов на начало прошлого учебного года
(на 1 октября) / 17.0"	0	0	0	0	0	0	0	0	0	0	0	0	0	218	218	0	0	0	208	208
Архангельская область	Частные; Очная	            из стр. 11 - не прошли итоговую аттестацию / 12.0	0	0	0	0	0	0	0	0	0	0	0	0	0	1	1	0	0	0	1	1
Архангельская область	Частные; Очная	"            из стр. 11 – лица с ограниченными возможностями здоровья,
            инвалиды, дети-инвалиды / 13.0"	0	0	0	0	0	0	0	0	0	0	0	0	0	0	0	0	0	0	0	0
Архангельская область	Частные; Очная	         отчислено в виде меры дисциплинарного взыскания / 14.0	0	0	0	0	0	0	0	0	0	0	0	0	0	1	1	0	0	0	0	0
Архангельская область	Частные; Очная	         отчислено из-за просрочки оплаты обучения / 15.0	0	0	0	0	0	0	0	0	0	0	0	0	0	0	0	0	0	0	0	0
Архангельская область	Частные; Очная	"    в том числе:
    переведено на другие формы обучения данной
    организации на программы того же уровня / 7.0"	0	0	0	0	0	0	0	0	0	0	0	0	0	6	6	0	0	0	1	1
Архангельская область	Частные; Очная	"    в том числе:
    переведено с других форм обучения данной
    образовательной организации с программ того же уровня / 2.0"	0	0	0	0	0	0	0	0	0	0	0	0	0	0	0	0	0	0	2	2
Архангельская область	Частные; Очная	    восстановлены из числа ранее отчисленных / 4.0	0	0	0	0	0	0	0	0	0	0	0	0	0	5	5	0	0	0	1	1
Архангельская область	Частные; Очная	    выбыло по другим причинам / 16.0	0	0	0	0	0	0	0	0	0	0	0	0	0	3	3	0	0	0	2	2
Архангельская область	Частные; Очная	"    добровольно прекратили образовательные отношения
    (бросили учебу) / 10.0"	0	0	0	0	0	0	0	0	0	0	0	0	0	17	17	0	0	0	6	6
Архангельская область	Частные; Очная	"    отчислено:
         по неуспеваемости / 11.0"	0	0	0	0	0	0	0	0	0	0	0	0	0	8	8	0	0	0	4	4
Архангельская область	Частные; Очная	"    переведено в другие образовательные организации
    на программы того же уровня / 8.0"	0	0	0	0	0	0	0	0	0	0	0	0	0	2	2	0	0	0	0	0
Архангельская область	Частные; Очная	"    переведено из других образовательных организаций 
    с программ того же уровня / 3.0"	0	0	0	0	0	0	0	0	0	0	0	0	0	2	2	0	0	0	0	0
Архангельская область	Частные; Очная	    по болезни / 9.0	0	0	0	0	0	0	0	0	0	0	0	0	0	0	0	0	0	0	0	0
Архангельская область	Частные; Очная	    прибыло по другим причинам / 5.0	0	0	0	0	0	0	0	0	0	0	0	0	0	14	14	0	0	0	0	0
Архангельская область	Частные; Очная	Выбыло студентов - всего (сумма стр. 07-11, 13-15) / 6.0	0	0	0	0	0	0	0	0	0	0	0	0	0	37	37	0	0	0	13	13
Архангельская область	Частные; Очная	Прибыло студентов - всего (сумма стр. 02-05) / 1.0	0	0	0	0	0	0	0	0	0	0	0	0	0	21	21	0	0	0	3	3
Архангельская область	Частные; Очная	"Численность студентов на начало прошлого учебного года
(на 1 октября) / 17.0"	0	0	0	0	0	0	0	0	0	0	0	0	0	233	233	0	0	0	71	71
Архангельская область	Частные; Очно-заочная	            из стр. 11 - не прошли итоговую аттестацию / 12.0	0	0	0	0	0	0	0	0	0	0	0	0	0	0	0	0	0	0	0	0
Архангельская область	Частные; Очно-заочная	"            из стр. 11 – лица с ограниченными возможностями здоровья,
            инвалиды, дети-инвалиды / 13.0"	0	0	0	0	0	0	0	0	0	0	0	0	0	0	0	0	0	0	0	0
Архангельская область	Частные; Очно-заочная	         отчислено в виде меры дисциплинарного взыскания / 14.0	0	0	0	0	0	0	0	0	0	0	0	0	0	0	0	0	0	0	0	0
Архангельская область	Частные; Очно-заочная	         отчислено из-за просрочки оплаты обучения / 15.0	0	0	0	0	0	0	0	0	0	0	0	0	0	0	0	0	0	0	0	0
Архангельская область	Частные; Очно-заочная	"    в том числе:
    переведено на другие формы обучения данной
    организации на программы того же уровня / 7.0"	0	0	0	0	0	0	0	0	0	0	0	0	0	0	0	0	0	0	0	0
Архангельская область	Частные; Очно-заочная	"    в том числе:
    переведено с других форм обучения данной
    образовательной организации с программ того же уровня / 2.0"	0	0	0	0	0	0	0	0	0	0	0	0	0	0	0	0	0	0	0	0
Архангельская область	Частные; Очно-заочная	    восстановлены из числа ранее отчисленных / 4.0	0	0	0	0	0	0	0	0	0	0	0	0	0	0	0	0	0	0	0	0
Архангельская область	Частные; Очно-заочная	    выбыло по другим причинам / 16.0	0	0	0	0	0	0	0	0	0	0	0	0	0	0	0	0	0	0	1	1
Архангельская область	Частные; Очно-заочная	"    добровольно прекратили образовательные отношения
    (бросили учебу) / 10.0"	0	0	0	0	0	0	0	0	0	0	0	0	0	3	3	0	0	0	14	14
Архангельская область	Частные; Очно-заочная	"    отчислено:
         по неуспеваемости / 11.0"	0	0	0	0	0	0	0	0	0	0	0	0	0	2	2	0	0	0	5	5
Архангельская область	Частные; Очно-заочная	"    переведено в другие образовательные организации
    на программы того же уровня / 8.0"	0	0	0	0	0	0	0	0	0	0	0	0	0	0	0	0	0	0	0	0
Архангельская область	Частные; Очно-заочная	"    переведено из других образовательных организаций 
    с программ того же уровня / 3.0"	0	0	0	0	0	0	0	0	0	0	0	0	0	0	0	0	0	0	0	0
Архангельская область	Частные; Очно-заочная	    по болезни / 9.0	0	0	0	0	0	0	0	0	0	0	0	0	0	0	0	0	0	0	0	0
Архангельская область	Частные; Очно-заочная	    прибыло по другим причинам / 5.0	0	0	0	0	0	0	0	0	0	0	0	0	0	0	0	0	0	0	46	46
Архангельская область	Частные; Очно-заочная	Выбыло студентов - всего (сумма стр. 07-11, 13-15) / 6.0	0	0	0	0	0	0	0	0	0	0	0	0	0	5	5	0	0	0	20	20
Архангельская область	Частные; Очно-заочная	Прибыло студентов - всего (сумма стр. 02-05) / 1.0	0	0	0	0	0	0	0	0	0	0	0	0	0	0	0	0	0	0	46	46
Архангельская область	Частные; Очно-заочная	"Численность студентов на начало прошлого учебного года
(на 1 октября) / 17.0"	0	0	0	0	0	0	0	0	0	0	0	0	0	96	96	0	0	0	41	41
Астраханская область	Государственные, муниципальные (без учета организаций в ведении ФСИН); Заочная	            из стр. 11 - не прошли итоговую аттестацию / 12.0	0	0	0	0	0	0	0	0	0	0	0	0	0	2	2	0	0	0	0	0
Астраханская область	Государственные, муниципальные (без учета организаций в ведении ФСИН); Заочная	"            из стр. 11 – лица с ограниченными возможностями здоровья,
            инвалиды, дети-инвалиды / 13.0"	0	0	0	0	0	0	0	0	0	0	0	0	0	0	0	0	0	0	0	0
Астраханская область	Государственные, муниципальные (без учета организаций в ведении ФСИН); Заочная	         отчислено в виде меры дисциплинарного взыскания / 14.0	0	0	0	0	0	0	0	0	0	0	0	0	0	0	0	0	0	0	0	0
Астраханская область	Государственные, муниципальные (без учета организаций в ведении ФСИН); Заочная	         отчислено из-за просрочки оплаты обучения / 15.0	0	0	0	0	0	0	0	0	0	0	0	0	0	59	59	0	0	0	38	38
Астраханская область	Государственные, муниципальные (без учета организаций в ведении ФСИН); Заочная	"    в том числе:
    переведено на другие формы обучения данной
    организации на программы того же уровня / 7.0"	0	0	0	0	0	0	0	0	0	0	0	0	0	19	19	0	0	2	6	8
Астраханская область	Государственные, муниципальные (без учета организаций в ведении ФСИН); Заочная	"    в том числе:
    переведено с других форм обучения данной
    образовательной организации с программ того же уровня / 2.0"	0	0	0	0	0	0	0	0	0	0	0	0	1	58	59	3	0	3	67	73
Астраханская область	Государственные, муниципальные (без учета организаций в ведении ФСИН); Заочная	    восстановлены из числа ранее отчисленных / 4.0	0	0	0	0	0	0	0	0	0	0	0	0	9	36	45	0	0	3	37	40
Астраханская область	Государственные, муниципальные (без учета организаций в ведении ФСИН); Заочная	    выбыло по другим причинам / 16.0	0	0	0	0	0	0	0	0	0	0	0	0	1	0	1	5	0	1	45	51
Астраханская область	Государственные, муниципальные (без учета организаций в ведении ФСИН); Заочная	"    добровольно прекратили образовательные отношения
    (бросили учебу) / 10.0"	0	0	0	0	0	0	0	0	0	0	0	0	6	47	53	6	0	7	42	55
Астраханская область	Государственные, муниципальные (без учета организаций в ведении ФСИН); Заочная	"    отчислено:
         по неуспеваемости / 11.0"	0	0	0	0	0	0	0	0	0	0	0	0	18	76	94	3	0	23	79	105
Астраханская область	Государственные, муниципальные (без учета организаций в ведении ФСИН); Заочная	"    переведено в другие образовательные организации
    на программы того же уровня / 8.0"	0	0	0	0	0	0	0	0	0	0	0	0	0	5	5	0	0	0	1	1
Астраханская область	Государственные, муниципальные (без учета организаций в ведении ФСИН); Заочная	"    переведено из других образовательных организаций 
    с программ того же уровня / 3.0"	0	0	0	0	0	0	0	0	0	0	0	0	0	12	12	0	0	0	13	13
Астраханская область	Государственные, муниципальные (без учета организаций в ведении ФСИН); Заочная	    по болезни / 9.0	0	0	0	0	0	0	0	0	0	0	0	0	0	0	0	0	0	0	0	0
Астраханская область	Государственные, муниципальные (без учета организаций в ведении ФСИН); Заочная	    прибыло по другим причинам / 5.0	0	0	0	0	0	0	0	0	0	0	0	0	0	7	7	0	0	5	44	49
Астраханская область	Государственные, муниципальные (без учета организаций в ведении ФСИН); Заочная	Выбыло студентов - всего (сумма стр. 07-11, 13-15) / 6.0	0	0	0	0	0	0	0	0	0	0	0	0	25	206	231	14	0	33	211	258
Астраханская область	Государственные, муниципальные (без учета организаций в ведении ФСИН); Заочная	Прибыло студентов - всего (сумма стр. 02-05) / 1.0	0	0	0	0	0	0	0	0	0	0	0	0	10	113	123	3	0	11	161	175
Астраханская область	Государственные, муниципальные (без учета организаций в ведении ФСИН); Заочная	"Численность студентов на начало прошлого учебного года
(на 1 октября) / 17.0"	0	0	0	0	0	0	0	0	0	0	0	0	130	836	966	149	0	204	1259	1612
Астраханская область	Государственные, муниципальные (без учета организаций в ведении ФСИН); Очная	            из стр. 11 - не прошли итоговую аттестацию / 12.0	0	2	0	0	2	0	0	0	0	0	1	0	0	1	2	0	0	0	1	1
Астраханская область	Государственные, муниципальные (без учета организаций в ведении ФСИН); Очная	"            из стр. 11 – лица с ограниченными возможностями здоровья,
            инвалиды, дети-инвалиды / 13.0"	3	0	0	0	3	0	0	0	0	0	3	0	1	0	4	0	0	0	1	1
Астраханская область	Государственные, муниципальные (без учета организаций в ведении ФСИН); Очная	         отчислено в виде меры дисциплинарного взыскания / 14.0	0	0	0	0	0	0	0	0	0	0	7	0	0	1	8	0	0	0	0	0
Астраханская область	Государственные, муниципальные (без учета организаций в ведении ФСИН); Очная	         отчислено из-за просрочки оплаты обучения / 15.0	0	0	0	0	0	0	0	0	0	0	0	0	0	79	79	0	0	0	25	25
Астраханская область	Государственные, муниципальные (без учета организаций в ведении ФСИН); Очная	"    в том числе:
    переведено на другие формы обучения данной
    организации на программы того же уровня / 7.0"	5	0	0	0	5	0	0	0	0	0	29	0	7	85	121	0	0	0	22	22
Астраханская область	Государственные, муниципальные (без учета организаций в ведении ФСИН); Очная	"    в том числе:
    переведено с других форм обучения данной
    образовательной организации с программ того же уровня / 2.0"	5	0	0	0	5	0	0	0	0	0	17	0	0	34	51	0	0	14	7	21
Астраханская область	Государственные, муниципальные (без учета организаций в ведении ФСИН); Очная	    восстановлены из числа ранее отчисленных / 4.0	16	0	0	4	20	0	0	0	0	0	38	0	8	101	147	3	0	1	12	16
Астраханская область	Государственные, муниципальные (без учета организаций в ведении ФСИН); Очная	    выбыло по другим причинам / 16.0	143	0	5	13	161	0	0	0	0	0	289	0	19	176	484	15	0	0	27	42
Астраханская область	Государственные, муниципальные (без учета организаций в ведении ФСИН); Очная	"    добровольно прекратили образовательные отношения
    (бросили учебу) / 10.0"	191	9	0	29	229	0	0	0	2	2	415	0	116	331	862	5	0	23	72	100
Астраханская область	Государственные, муниципальные (без учета организаций в ведении ФСИН); Очная	"    отчислено:
         по неуспеваемости / 11.0"	113	14	0	15	142	0	0	0	0	0	207	0	89	137	433	5	0	14	49	68
Астраханская область	Государственные, муниципальные (без учета организаций в ведении ФСИН); Очная	"    переведено в другие образовательные организации
    на программы того же уровня / 8.0"	8	0	0	4	12	0	0	0	0	0	112	0	38	115	265	2	0	0	11	13
Астраханская область	Государственные, муниципальные (без учета организаций в ведении ФСИН); Очная	"    переведено из других образовательных организаций 
    с программ того же уровня / 3.0"	29	0	0	1	30	0	0	0	0	0	48	0	6	75	129	0	0	1	5	6
Астраханская область	Государственные, муниципальные (без учета организаций в ведении ФСИН); Очная	    по болезни / 9.0	0	0	0	0	0	0	0	0	0	0	2	0	6	0	8	0	0	0	0	0
Астраханская область	Государственные, муниципальные (без учета организаций в ведении ФСИН); Очная	    прибыло по другим причинам / 5.0	61	0	0	8	69	0	0	0	0	0	192	0	47	164	403	7	0	0	11	18
Астраханская область	Государственные, муниципальные (без учета организаций в ведении ФСИН); Очная	Выбыло студентов - всего (сумма стр. 07-11, 13-15) / 6.0	460	23	5	61	549	0	0	0	2	2	1061	0	275	924	2260	27	0	37	206	270
Астраханская область	Государственные, муниципальные (без учета организаций в ведении ФСИН); Очная	Прибыло студентов - всего (сумма стр. 02-05) / 1.0	111	0	0	13	124	0	0	0	0	0	295	0	61	374	730	10	0	16	35	61
Астраханская область	Государственные, муниципальные (без учета организаций в ведении ФСИН); Очная	"Численность студентов на начало прошлого учебного года
(на 1 октября) / 17.0"	2877	144	7	367	3395	0	0	0	5	5	9304	0	3083	6536	18923	341	0	282	1084	1707
Астраханская область	Очно-заочная; Государственные, муниципальные (без учета организаций в ведении ФСИН)	            из стр. 11 - не прошли итоговую аттестацию / 12.0	0	0	0	0	0	0	0	0	0	0	0	0	0	0	0	0	0	0	0	0
Астраханская область	Очно-заочная; Государственные, муниципальные (без учета организаций в ведении ФСИН)	"            из стр. 11 – лица с ограниченными возможностями здоровья,
            инвалиды, дети-инвалиды / 13.0"	0	0	0	0	0	0	0	0	0	0	0	0	0	0	0	0	0	0	0	0
Астраханская область	Очно-заочная; Государственные, муниципальные (без учета организаций в ведении ФСИН)	         отчислено в виде меры дисциплинарного взыскания / 14.0	0	0	0	0	0	0	0	0	0	0	0	0	0	0	0	0	0	0	0	0
Астраханская область	Очно-заочная; Государственные, муниципальные (без учета организаций в ведении ФСИН)	         отчислено из-за просрочки оплаты обучения / 15.0	0	0	0	0	0	0	0	0	0	0	0	0	0	13	13	0	0	0	21	21
Астраханская область	Очно-заочная; Государственные, муниципальные (без учета организаций в ведении ФСИН)	"    в том числе:
    переведено на другие формы обучения данной
    организации на программы того же уровня / 7.0"	0	0	0	0	0	0	0	0	0	0	0	0	0	7	7	0	0	0	0	0
Астраханская область	Очно-заочная; Государственные, муниципальные (без учета организаций в ведении ФСИН)	"    в том числе:
    переведено с других форм обучения данной
    образовательной организации с программ того же уровня / 2.0"	0	0	0	0	0	0	0	0	0	0	0	0	0	5	5	0	0	0	0	0
Астраханская область	Очно-заочная; Государственные, муниципальные (без учета организаций в ведении ФСИН)	    восстановлены из числа ранее отчисленных / 4.0	0	0	0	0	0	0	0	0	0	0	0	0	0	7	7	0	0	0	2	2
Астраханская область	Очно-заочная; Государственные, муниципальные (без учета организаций в ведении ФСИН)	    выбыло по другим причинам / 16.0	0	0	0	0	0	0	0	0	0	0	0	0	0	1	1	1	0	0	3	4
Астраханская область	Очно-заочная; Государственные, муниципальные (без учета организаций в ведении ФСИН)	"    добровольно прекратили образовательные отношения
    (бросили учебу) / 10.0"	0	0	0	0	0	0	0	0	0	0	0	0	0	16	16	0	0	0	6	6
Астраханская область	Очно-заочная; Государственные, муниципальные (без учета организаций в ведении ФСИН)	"    отчислено:
         по неуспеваемости / 11.0"	0	0	0	0	0	0	0	0	0	0	0	0	0	14	14	1	0	0	8	9
Астраханская область	Очно-заочная; Государственные, муниципальные (без учета организаций в ведении ФСИН)	"    переведено в другие образовательные организации
    на программы того же уровня / 8.0"	0	0	0	0	0	0	0	0	0	0	0	0	0	0	0	0	0	0	2	2
Астраханская область	Очно-заочная; Государственные, муниципальные (без учета организаций в ведении ФСИН)	"    переведено из других образовательных организаций 
    с программ того же уровня / 3.0"	0	0	0	0	0	0	0	0	0	0	0	0	0	0	0	0	0	0	0	0
Астраханская область	Очно-заочная; Государственные, муниципальные (без учета организаций в ведении ФСИН)	    по болезни / 9.0	0	0	0	0	0	0	0	0	0	0	0	0	0	0	0	0	0	0	0	0
Астраханская область	Очно-заочная; Государственные, муниципальные (без учета организаций в ведении ФСИН)	    прибыло по другим причинам / 5.0	0	0	0	0	0	0	0	0	0	0	0	0	0	0	0	0	0	0	0	0
Астраханская область	Очно-заочная; Государственные, муниципальные (без учета организаций в ведении ФСИН)	Выбыло студентов - всего (сумма стр. 07-11, 13-15) / 6.0	0	0	0	0	0	0	0	0	0	0	0	0	0	51	51	2	0	0	40	42
Астраханская область	Очно-заочная; Государственные, муниципальные (без учета организаций в ведении ФСИН)	Прибыло студентов - всего (сумма стр. 02-05) / 1.0	0	0	0	0	0	0	0	0	0	0	0	0	0	12	12	0	0	0	2	2
Астраханская область	Очно-заочная; Государственные, муниципальные (без учета организаций в ведении ФСИН)	"Численность студентов на начало прошлого учебного года
(на 1 октября) / 17.0"	0	0	0	0	0	0	0	0	0	0	0	0	0	229	229	57	0	0	673	730
Астраханская область	Частные; Заочная	            из стр. 11 - не прошли итоговую аттестацию / 12.0	0	0	0	0	0	0	0	0	0	0	0	0	0	0	0	0	0	0	0	0
Астраханская область	Частные; Заочная	"            из стр. 11 – лица с ограниченными возможностями здоровья,
            инвалиды, дети-инвалиды / 13.0"	0	0	0	0	0	0	0	0	0	0	0	0	0	0	0	0	0	0	0	0
Астраханская область	Частные; Заочная	         отчислено в виде меры дисциплинарного взыскания / 14.0	0	0	0	0	0	0	0	0	0	0	0	0	0	0	0	0	0	0	0	0
Астраханская область	Частные; Заочная	         отчислено из-за просрочки оплаты обучения / 15.0	0	0	0	0	0	0	0	0	0	0	0	0	0	12	12	0	0	0	20	20
Астраханская область	Частные; Заочная	"    в том числе:
    переведено на другие формы обучения данной
    организации на программы того же уровня / 7.0"	0	0	0	0	0	0	0	0	0	0	0	0	0	2	2	0	0	0	0	0
Астраханская область	Частные; Заочная	"    в том числе:
    переведено с других форм обучения данной
    образовательной организации с программ того же уровня / 2.0"	0	0	0	0	0	0	0	0	0	0	0	0	0	0	0	0	0	0	12	12
Астраханская область	Частные; Заочная	    восстановлены из числа ранее отчисленных / 4.0	0	0	0	0	0	0	0	0	0	0	0	0	0	2	2	0	0	0	11	11
Астраханская область	Частные; Заочная	    выбыло по другим причинам / 16.0	0	0	0	0	0	0	0	0	0	0	0	0	0	0	0	0	0	0	1	1
Астраханская область	Частные; Заочная	"    добровольно прекратили образовательные отношения
    (бросили учебу) / 10.0"	0	0	0	0	0	0	0	0	0	0	0	0	0	5	5	0	0	0	0	0
Астраханская область	Частные; Заочная	"    отчислено:
         по неуспеваемости / 11.0"	0	0	0	0	0	0	0	0	0	0	0	0	0	0	0	0	0	0	0	0
Астраханская область	Частные; Заочная	"    переведено в другие образовательные организации
    на программы того же уровня / 8.0"	0	0	0	0	0	0	0	0	0	0	0	0	0	21	21	0	0	0	16	16
Астраханская область	Частные; Заочная	"    переведено из других образовательных организаций 
    с программ того же уровня / 3.0"	0	0	0	0	0	0	0	0	0	0	0	0	0	0	0	0	0	0	41	41
Астраханская область	Частные; Заочная	    по болезни / 9.0	0	0	0	0	0	0	0	0	0	0	0	0	0	0	0	0	0	0	0	0
Астраханская область	Частные; Заочная	    прибыло по другим причинам / 5.0	0	0	0	0	0	0	0	0	0	0	0	0	0	0	0	0	0	0	0	0
Астраханская область	Частные; Заочная	Выбыло студентов - всего (сумма стр. 07-11, 13-15) / 6.0	0	0	0	0	0	0	0	0	0	0	0	0	0	40	40	0	0	0	37	37
Астраханская область	Частные; Заочная	Прибыло студентов - всего (сумма стр. 02-05) / 1.0	0	0	0	0	0	0	0	0	0	0	0	0	0	2	2	0	0	0	64	64
Астраханская область	Частные; Заочная	"Численность студентов на начало прошлого учебного года
(на 1 октября) / 17.0"	0	0	0	0	0	0	0	0	0	0	0	0	0	80	80	0	0	0	173	173
Астраханская область	Частные; Очная	            из стр. 11 - не прошли итоговую аттестацию / 12.0	0	0	0	0	0	0	0	0	0	0	0	0	0	1	1	0	0	0	0	0
Астраханская область	Частные; Очная	"            из стр. 11 – лица с ограниченными возможностями здоровья,
            инвалиды, дети-инвалиды / 13.0"	0	0	0	0	0	0	0	0	0	0	0	0	0	0	0	0	0	0	0	0
Астраханская область	Частные; Очная	         отчислено в виде меры дисциплинарного взыскания / 14.0	0	0	0	0	0	0	0	0	0	0	0	0	0	0	0	0	0	0	0	0
Астраханская область	Частные; Очная	         отчислено из-за просрочки оплаты обучения / 15.0	0	0	0	0	0	0	0	0	0	0	0	0	0	31	31	0	0	0	1	1
Астраханская область	Частные; Очная	"    в том числе:
    переведено на другие формы обучения данной
    организации на программы того же уровня / 7.0"	0	0	0	0	0	0	0	0	0	0	0	0	0	18	18	0	0	0	0	0
Астраханская область	Частные; Очная	"    в том числе:
    переведено с других форм обучения данной
    образовательной организации с программ того же уровня / 2.0"	0	0	0	0	0	0	0	0	0	0	0	0	0	1	1	0	0	0	0	0
Астраханская область	Частные; Очная	    восстановлены из числа ранее отчисленных / 4.0	0	0	0	0	0	0	0	0	0	0	0	0	0	17	17	0	0	0	0	0
Астраханская область	Частные; Очная	    выбыло по другим причинам / 16.0	0	0	0	0	0	0	0	0	0	0	0	0	0	28	28	0	0	0	0	0
Астраханская область	Частные; Очная	"    добровольно прекратили образовательные отношения
    (бросили учебу) / 10.0"	0	0	0	0	0	0	0	0	0	0	0	0	0	1	1	0	0	0	0	0
Астраханская область	Частные; Очная	"    отчислено:
         по неуспеваемости / 11.0"	0	0	0	0	0	0	0	0	0	0	0	0	0	1	1	0	0	0	0	0
Астраханская область	Частные; Очная	"    переведено в другие образовательные организации
    на программы того же уровня / 8.0"	0	0	0	0	0	0	0	0	0	0	0	0	0	14	14	0	0	0	0	0
Астраханская область	Частные; Очная	"    переведено из других образовательных организаций 
    с программ того же уровня / 3.0"	0	0	0	0	0	0	0	0	0	0	0	0	0	45	45	0	0	0	0	0
Астраханская область	Частные; Очная	    по болезни / 9.0	0	0	0	0	0	0	0	0	0	0	0	0	0	0	0	0	0	0	0	0
Астраханская область	Частные; Очная	    прибыло по другим причинам / 5.0	0	0	0	0	0	0	0	0	0	0	0	0	0	0	0	0	0	0	0	0
Астраханская область	Частные; Очная	Выбыло студентов - всего (сумма стр. 07-11, 13-15) / 6.0	0	0	0	0	0	0	0	0	0	0	0	0	0	93	93	0	0	0	1	1
Астраханская область	Частные; Очная	Прибыло студентов - всего (сумма стр. 02-05) / 1.0	0	0	0	0	0	0	0	0	0	0	0	0	0	63	63	0	0	0	0	0
Астраханская область	Частные; Очная	"Численность студентов на начало прошлого учебного года
(на 1 октября) / 17.0"	0	0	0	0	0	0	0	0	0	0	0	0	0	1199	1199	0	0	0	147	147
Белгородская область	Государственные, муниципальные (без учета организаций в ведении ФСИН); Заочная	            из стр. 11 - не прошли итоговую аттестацию / 12.0	0	0	0	0	0	0	0	0	0	0	0	0	0	0	0	0	0	0	0	0
Белгородская область	Государственные, муниципальные (без учета организаций в ведении ФСИН); Заочная	"            из стр. 11 – лица с ограниченными возможностями здоровья,
            инвалиды, дети-инвалиды / 13.0"	0	0	0	0	0	0	0	0	0	0	0	0	0	0	0	0	0	0	0	0
Белгородская область	Государственные, муниципальные (без учета организаций в ведении ФСИН); Заочная	         отчислено в виде меры дисциплинарного взыскания / 14.0	0	0	0	0	0	0	0	0	0	0	0	0	0	0	0	0	0	0	0	0
Белгородская область	Государственные, муниципальные (без учета организаций в ведении ФСИН); Заочная	         отчислено из-за просрочки оплаты обучения / 15.0	0	0	0	0	0	0	0	0	0	0	0	0	0	0	0	0	0	0	6	6
Белгородская область	Государственные, муниципальные (без учета организаций в ведении ФСИН); Заочная	"    в том числе:
    переведено на другие формы обучения данной
    организации на программы того же уровня / 7.0"	0	0	0	0	0	0	0	0	0	0	0	0	0	0	0	0	0	0	1	1
Белгородская область	Государственные, муниципальные (без учета организаций в ведении ФСИН); Заочная	"    в том числе:
    переведено с других форм обучения данной
    образовательной организации с программ того же уровня / 2.0"	0	0	0	0	0	0	0	0	0	0	0	0	0	0	0	1	0	0	5	6
Белгородская область	Государственные, муниципальные (без учета организаций в ведении ФСИН); Заочная	    восстановлены из числа ранее отчисленных / 4.0	0	0	0	0	0	0	0	0	0	0	0	0	0	0	0	3	0	0	1	4
Белгородская область	Государственные, муниципальные (без учета организаций в ведении ФСИН); Заочная	    выбыло по другим причинам / 16.0	0	0	0	0	0	0	0	0	0	0	0	0	0	0	0	4	0	0	0	4
Белгородская область	Государственные, муниципальные (без учета организаций в ведении ФСИН); Заочная	"    добровольно прекратили образовательные отношения
    (бросили учебу) / 10.0"	0	0	0	0	0	0	0	0	0	0	0	0	0	0	0	49	0	0	5	54
Белгородская область	Государственные, муниципальные (без учета организаций в ведении ФСИН); Заочная	"    отчислено:
         по неуспеваемости / 11.0"	0	0	0	0	0	0	0	0	0	0	0	0	0	0	0	18	0	0	8	26
Белгородская область	Государственные, муниципальные (без учета организаций в ведении ФСИН); Заочная	"    переведено в другие образовательные организации
    на программы того же уровня / 8.0"	0	0	0	0	0	0	0	0	0	0	0	0	0	0	0	5	0	0	0	5
Белгородская область	Государственные, муниципальные (без учета организаций в ведении ФСИН); Заочная	"    переведено из других образовательных организаций 
    с программ того же уровня / 3.0"	0	0	0	0	0	0	0	0	0	0	0	0	0	0	0	0	0	0	2	2
Белгородская область	Государственные, муниципальные (без учета организаций в ведении ФСИН); Заочная	    по болезни / 9.0	0	0	0	0	0	0	0	0	0	0	0	0	0	0	0	0	0	0	0	0
Белгородская область	Государственные, муниципальные (без учета организаций в ведении ФСИН); Заочная	    прибыло по другим причинам / 5.0	0	0	0	0	0	0	0	0	0	0	0	0	0	0	0	7	0	0	0	7
Белгородская область	Государственные, муниципальные (без учета организаций в ведении ФСИН); Заочная	Выбыло студентов - всего (сумма стр. 07-11, 13-15) / 6.0	0	0	0	0	0	0	0	0	0	0	0	0	0	0	0	76	0	0	20	96
Белгородская область	Государственные, муниципальные (без учета организаций в ведении ФСИН); Заочная	Прибыло студентов - всего (сумма стр. 02-05) / 1.0	0	0	0	0	0	0	0	0	0	0	0	0	0	0	0	11	0	0	8	19
Белгородская область	Государственные, муниципальные (без учета организаций в ведении ФСИН); Заочная	"Численность студентов на начало прошлого учебного года
(на 1 октября) / 17.0"	0	0	0	0	0	0	0	0	0	0	22	0	0	0	22	952	0	1	370	1323
Белгородская область	Государственные, муниципальные (без учета организаций в ведении ФСИН); Очная	            из стр. 11 - не прошли итоговую аттестацию / 12.0	7	0	0	0	7	0	0	0	0	0	2	0	0	0	2	0	0	0	0	0
Белгородская область	Государственные, муниципальные (без учета организаций в ведении ФСИН); Очная	"            из стр. 11 – лица с ограниченными возможностями здоровья,
            инвалиды, дети-инвалиды / 13.0"	0	0	0	0	0	0	0	0	0	0	0	0	0	0	0	0	0	0	0	0
Белгородская область	Государственные, муниципальные (без учета организаций в ведении ФСИН); Очная	         отчислено в виде меры дисциплинарного взыскания / 14.0	0	0	0	0	0	0	0	0	0	0	2	0	0	0	2	0	0	0	6	6
Белгородская область	Государственные, муниципальные (без учета организаций в ведении ФСИН); Очная	         отчислено из-за просрочки оплаты обучения / 15.0	0	0	0	0	0	0	0	0	0	0	0	0	0	8	8	0	0	0	3	3
Белгородская область	Государственные, муниципальные (без учета организаций в ведении ФСИН); Очная	"    в том числе:
    переведено на другие формы обучения данной
    организации на программы того же уровня / 7.0"	27	0	0	0	27	0	0	0	0	0	45	0	0	23	68	0	0	0	3	3
Белгородская область	Государственные, муниципальные (без учета организаций в ведении ФСИН); Очная	"    в том числе:
    переведено с других форм обучения данной
    образовательной организации с программ того же уровня / 2.0"	40	0	0	0	40	0	0	0	0	0	44	0	0	9	53	4	0	0	4	8
Белгородская область	Государственные, муниципальные (без учета организаций в ведении ФСИН); Очная	    восстановлены из числа ранее отчисленных / 4.0	17	0	0	0	17	0	0	0	0	0	46	0	4	29	79	3	0	0	7	10
Белгородская область	Государственные, муниципальные (без учета организаций в ведении ФСИН); Очная	    выбыло по другим причинам / 16.0	51	0	0	0	51	1	0	0	0	1	89	0	6	27	122	6	0	0	8	14
Белгородская область	Государственные, муниципальные (без учета организаций в ведении ФСИН); Очная	"    добровольно прекратили образовательные отношения
    (бросили учебу) / 10.0"	152	0	0	0	152	1	0	0	0	1	521	0	53	177	751	64	0	7	43	114
Белгородская область	Государственные, муниципальные (без учета организаций в ведении ФСИН); Очная	"    отчислено:
         по неуспеваемости / 11.0"	96	0	0	0	96	2	0	0	7	9	131	0	14	55	200	4	0	2	10	16
Белгородская область	Государственные, муниципальные (без учета организаций в ведении ФСИН); Очная	"    переведено в другие образовательные организации
    на программы того же уровня / 8.0"	58	0	0	0	58	0	0	0	0	0	246	0	26	120	392	3	0	0	6	9
Белгородская область	Государственные, муниципальные (без учета организаций в ведении ФСИН); Очная	"    переведено из других образовательных организаций 
    с программ того же уровня / 3.0"	56	0	0	0	56	0	0	0	0	0	155	0	8	77	240	2	0	0	0	2
Белгородская область	Государственные, муниципальные (без учета организаций в ведении ФСИН); Очная	    по болезни / 9.0	3	0	0	0	3	0	0	0	0	0	0	0	0	0	0	0	0	0	0	0
Белгородская область	Государственные, муниципальные (без учета организаций в ведении ФСИН); Очная	    прибыло по другим причинам / 5.0	74	0	0	0	74	6	0	0	0	6	65	0	22	14	101	2	0	7	3	12
Белгородская область	Государственные, муниципальные (без учета организаций в ведении ФСИН); Очная	Выбыло студентов - всего (сумма стр. 07-11, 13-15) / 6.0	387	0	0	0	387	4	0	0	7	11	1034	0	99	410	1543	77	0	9	79	165
Белгородская область	Государственные, муниципальные (без учета организаций в ведении ФСИН); Очная	Прибыло студентов - всего (сумма стр. 02-05) / 1.0	187	0	0	0	187	6	0	0	0	6	310	0	34	129	473	11	0	7	14	32
Белгородская область	Государственные, муниципальные (без учета организаций в ведении ФСИН); Очная	"Численность студентов на начало прошлого учебного года
(на 1 октября) / 17.0"	5252	0	0	0	5252	57	0	0	49	106	18070	0	3979	5811	27860	564	0	346	848	1758
Белгородская область	Очно-заочная; Государственные, муниципальные (без учета организаций в ведении ФСИН)	            из стр. 11 - не прошли итоговую аттестацию / 12.0	0	0	0	0	0	0	0	0	0	0	0	0	0	0	0	0	0	0	0	0
Белгородская область	Очно-заочная; Государственные, муниципальные (без учета организаций в ведении ФСИН)	"            из стр. 11 – лица с ограниченными возможностями здоровья,
            инвалиды, дети-инвалиды / 13.0"	0	0	0	0	0	0	0	0	0	0	0	0	0	0	0	0	0	0	1	1
Белгородская область	Очно-заочная; Государственные, муниципальные (без учета организаций в ведении ФСИН)	         отчислено в виде меры дисциплинарного взыскания / 14.0	0	0	0	0	0	0	0	0	0	0	0	0	0	0	0	0	0	0	0	0
Белгородская область	Очно-заочная; Государственные, муниципальные (без учета организаций в ведении ФСИН)	         отчислено из-за просрочки оплаты обучения / 15.0	0	0	0	0	0	0	0	0	0	0	0	0	0	0	0	0	0	0	11	11
Белгородская область	Очно-заочная; Государственные, муниципальные (без учета организаций в ведении ФСИН)	"    в том числе:
    переведено на другие формы обучения данной
    организации на программы того же уровня / 7.0"	2	0	0	0	2	0	0	0	0	0	0	0	0	0	0	0	0	0	3	3
Белгородская область	Очно-заочная; Государственные, муниципальные (без учета организаций в ведении ФСИН)	"    в том числе:
    переведено с других форм обучения данной
    образовательной организации с программ того же уровня / 2.0"	6	0	0	0	6	0	0	0	0	0	0	0	0	0	0	0	0	0	3	3
Белгородская область	Очно-заочная; Государственные, муниципальные (без учета организаций в ведении ФСИН)	    восстановлены из числа ранее отчисленных / 4.0	0	0	0	0	0	0	0	0	0	0	0	0	0	0	0	1	0	0	5	6
Белгородская область	Очно-заочная; Государственные, муниципальные (без учета организаций в ведении ФСИН)	    выбыло по другим причинам / 16.0	0	0	0	0	0	2	0	0	0	2	0	0	0	0	0	0	0	0	0	0
Белгородская область	Очно-заочная; Государственные, муниципальные (без учета организаций в ведении ФСИН)	"    добровольно прекратили образовательные отношения
    (бросили учебу) / 10.0"	6	0	0	0	6	11	0	0	0	11	2	0	0	0	2	6	0	0	27	33
Белгородская область	Очно-заочная; Государственные, муниципальные (без учета организаций в ведении ФСИН)	"    отчислено:
         по неуспеваемости / 11.0"	0	0	0	0	0	0	0	0	0	0	0	0	0	0	0	4	0	0	14	18
Белгородская область	Очно-заочная; Государственные, муниципальные (без учета организаций в ведении ФСИН)	"    переведено в другие образовательные организации
    на программы того же уровня / 8.0"	2	0	0	0	2	0	0	0	0	0	1	0	0	0	1	0	0	0	1	1
Белгородская область	Очно-заочная; Государственные, муниципальные (без учета организаций в ведении ФСИН)	"    переведено из других образовательных организаций 
    с программ того же уровня / 3.0"	1	0	0	0	1	0	0	0	0	0	1	0	0	0	1	0	0	0	3	3
Белгородская область	Очно-заочная; Государственные, муниципальные (без учета организаций в ведении ФСИН)	    по болезни / 9.0	0	0	0	0	0	0	0	0	0	0	0	0	0	0	0	0	0	0	0	0
Белгородская область	Очно-заочная; Государственные, муниципальные (без учета организаций в ведении ФСИН)	    прибыло по другим причинам / 5.0	11	0	0	0	11	0	0	0	0	0	0	0	0	0	0	2	0	0	0	2
Белгородская область	Очно-заочная; Государственные, муниципальные (без учета организаций в ведении ФСИН)	Выбыло студентов - всего (сумма стр. 07-11, 13-15) / 6.0	10	0	0	0	10	13	0	0	0	13	3	0	0	0	3	10	0	0	56	66
Белгородская область	Очно-заочная; Государственные, муниципальные (без учета организаций в ведении ФСИН)	Прибыло студентов - всего (сумма стр. 02-05) / 1.0	18	0	0	0	18	0	0	0	0	0	1	0	0	0	1	3	0	0	11	14
Белгородская область	Очно-заочная; Государственные, муниципальные (без учета организаций в ведении ФСИН)	"Численность студентов на начало прошлого учебного года
(на 1 октября) / 17.0"	122	0	0	0	122	64	0	0	0	64	40	0	0	2	42	97	0	0	661	758
Белгородская область	Частные; Заочная	            из стр. 11 - не прошли итоговую аттестацию / 12.0	0	0	0	0	0	0	0	0	0	0	0	0	0	0	0	0	0	0	0	0
Белгородская область	Частные; Заочная	"            из стр. 11 – лица с ограниченными возможностями здоровья,
            инвалиды, дети-инвалиды / 13.0"	0	0	0	0	0	0	0	0	0	0	0	0	0	0	0	0	0	0	0	0
Белгородская область	Частные; Заочная	         отчислено в виде меры дисциплинарного взыскания / 14.0	0	0	0	0	0	0	0	0	0	0	0	0	0	0	0	0	0	0	0	0
Белгородская область	Частные; Заочная	         отчислено из-за просрочки оплаты обучения / 15.0	0	0	0	0	0	0	0	0	0	0	0	0	0	2	2	0	0	0	0	0
Белгородская область	Частные; Заочная	"    в том числе:
    переведено на другие формы обучения данной
    организации на программы того же уровня / 7.0"	0	0	0	0	0	0	0	0	0	0	0	0	0	35	35	0	0	0	24	24
Белгородская область	Частные; Заочная	"    в том числе:
    переведено с других форм обучения данной
    образовательной организации с программ того же уровня / 2.0"	0	0	0	0	0	0	0	0	0	0	0	0	0	1	1	0	0	0	0	0
Белгородская область	Частные; Заочная	    восстановлены из числа ранее отчисленных / 4.0	0	0	0	0	0	0	0	0	0	0	0	0	0	0	0	0	0	0	0	0
Белгородская область	Частные; Заочная	    выбыло по другим причинам / 16.0	0	0	0	0	0	0	0	0	0	0	0	0	0	0	0	0	0	0	1	1
Белгородская область	Частные; Заочная	"    добровольно прекратили образовательные отношения
    (бросили учебу) / 10.0"	0	0	0	0	0	0	0	0	0	0	0	0	0	2	2	0	0	0	0	0
Белгородская область	Частные; Заочная	"    отчислено:
         по неуспеваемости / 11.0"	0	0	0	0	0	0	0	0	0	0	0	0	0	0	0	0	0	0	0	0
Белгородская область	Частные; Заочная	"    переведено в другие образовательные организации
    на программы того же уровня / 8.0"	0	0	0	0	0	0	0	0	0	0	0	0	0	0	0	0	0	0	0	0
Белгородская область	Частные; Заочная	"    переведено из других образовательных организаций 
    с программ того же уровня / 3.0"	0	0	0	0	0	0	0	0	0	0	0	0	0	1	1	0	0	0	0	0
Белгородская область	Частные; Заочная	    по болезни / 9.0	0	0	0	0	0	0	0	0	0	0	0	0	0	0	0	0	0	0	0	0
Белгородская область	Частные; Заочная	    прибыло по другим причинам / 5.0	0	0	0	0	0	0	0	0	0	0	0	0	0	0	0	0	0	0	0	0
Белгородская область	Частные; Заочная	Выбыло студентов - всего (сумма стр. 07-11, 13-15) / 6.0	0	0	0	0	0	0	0	0	0	0	0	0	0	39	39	0	0	0	25	25
Белгородская область	Частные; Заочная	Прибыло студентов - всего (сумма стр. 02-05) / 1.0	0	0	0	0	0	0	0	0	0	0	0	0	0	2	2	0	0	0	0	0
Белгородская область	Частные; Заочная	"Численность студентов на начало прошлого учебного года
(на 1 октября) / 17.0"	0	0	0	0	0	0	0	0	0	0	0	0	0	10	10	0	0	0	23	23
Белгородская область	Частные; Очная	            из стр. 11 - не прошли итоговую аттестацию / 12.0	0	0	0	0	0	0	0	0	0	0	0	0	0	0	0	0	0	0	0	0
Белгородская область	Частные; Очная	"            из стр. 11 – лица с ограниченными возможностями здоровья,
            инвалиды, дети-инвалиды / 13.0"	0	0	0	0	0	0	0	0	0	0	0	0	0	0	0	0	0	0	0	0
Белгородская область	Частные; Очная	         отчислено в виде меры дисциплинарного взыскания / 14.0	0	0	0	0	0	0	0	0	0	0	0	0	0	1	1	0	0	0	0	0
Белгородская область	Частные; Очная	         отчислено из-за просрочки оплаты обучения / 15.0	0	0	0	0	0	0	0	0	0	0	0	0	0	31	31	0	0	0	13	13
Белгородская область	Частные; Очная	"    в том числе:
    переведено на другие формы обучения данной
    организации на программы того же уровня / 7.0"	0	0	0	0	0	0	0	0	0	0	0	0	0	1	1	0	0	0	0	0
Белгородская область	Частные; Очная	"    в том числе:
    переведено с других форм обучения данной
    образовательной организации с программ того же уровня / 2.0"	0	0	0	0	0	0	0	0	0	0	0	0	0	35	35	0	0	0	24	24
Белгородская область	Частные; Очная	    восстановлены из числа ранее отчисленных / 4.0	0	0	0	0	0	0	0	0	0	0	0	0	0	19	19	0	0	0	3	3
Белгородская область	Частные; Очная	    выбыло по другим причинам / 16.0	0	0	0	0	0	0	0	0	0	0	0	0	0	8	8	0	0	0	1	1
Белгородская область	Частные; Очная	"    добровольно прекратили образовательные отношения
    (бросили учебу) / 10.0"	0	0	0	0	0	0	0	0	0	0	0	0	0	67	67	0	0	0	15	15
Белгородская область	Частные; Очная	"    отчислено:
         по неуспеваемости / 11.0"	0	0	0	0	0	0	0	0	0	0	0	0	0	8	8	0	0	0	5	5
Белгородская область	Частные; Очная	"    переведено в другие образовательные организации
    на программы того же уровня / 8.0"	0	0	0	0	0	0	0	0	0	0	0	0	0	43	43	0	0	0	31	31
Белгородская область	Частные; Очная	"    переведено из других образовательных организаций 
    с программ того же уровня / 3.0"	0	0	0	0	0	0	0	0	0	0	0	0	0	59	59	0	0	0	32	32
Белгородская область	Частные; Очная	    по болезни / 9.0	0	0	0	0	0	0	0	0	0	0	0	0	0	0	0	0	0	0	0	0
Белгородская область	Частные; Очная	    прибыло по другим причинам / 5.0	0	0	0	0	0	0	0	0	0	0	0	0	0	0	0	0	0	0	0	0
Белгородская область	Частные; Очная	Выбыло студентов - всего (сумма стр. 07-11, 13-15) / 6.0	0	0	0	0	0	0	0	0	0	0	0	0	0	159	159	0	0	0	65	65
Белгородская область	Частные; Очная	Прибыло студентов - всего (сумма стр. 02-05) / 1.0	0	0	0	0	0	0	0	0	0	0	0	0	0	113	113	0	0	0	59	59
Белгородская область	Частные; Очная	"Численность студентов на начало прошлого учебного года
(на 1 октября) / 17.0"	0	0	0	0	0	0	0	0	0	0	0	0	0	1751	1751	0	0	0	266	266
Брянская область	Государственные, муниципальные (без учета организаций в ведении ФСИН); Заочная	            из стр. 11 - не прошли итоговую аттестацию / 12.0	0	0	0	0	0	0	0	0	0	0	0	0	0	0	0	0	0	0	1	1
Брянская область	Государственные, муниципальные (без учета организаций в ведении ФСИН); Заочная	"            из стр. 11 – лица с ограниченными возможностями здоровья,
            инвалиды, дети-инвалиды / 13.0"	0	0	0	0	0	0	0	0	0	0	0	0	0	0	0	0	0	0	0	0
Брянская область	Государственные, муниципальные (без учета организаций в ведении ФСИН); Заочная	         отчислено в виде меры дисциплинарного взыскания / 14.0	0	0	0	0	0	0	0	0	0	0	0	0	0	0	0	0	0	0	0	0
Брянская область	Государственные, муниципальные (без учета организаций в ведении ФСИН); Заочная	         отчислено из-за просрочки оплаты обучения / 15.0	0	0	0	0	0	0	0	0	0	0	0	0	0	0	0	0	0	0	7	7
Брянская область	Государственные, муниципальные (без учета организаций в ведении ФСИН); Заочная	"    в том числе:
    переведено на другие формы обучения данной
    организации на программы того же уровня / 7.0"	0	0	0	0	0	0	0	0	0	0	0	0	0	1	1	1	0	1	0	2
Брянская область	Государственные, муниципальные (без учета организаций в ведении ФСИН); Заочная	"    в том числе:
    переведено с других форм обучения данной
    образовательной организации с программ того же уровня / 2.0"	0	0	0	0	0	0	0	0	0	0	0	0	0	11	11	2	0	0	8	10
Брянская область	Государственные, муниципальные (без учета организаций в ведении ФСИН); Заочная	    восстановлены из числа ранее отчисленных / 4.0	0	0	0	0	0	0	0	0	0	0	0	0	0	1	1	0	0	2	20	22
Брянская область	Государственные, муниципальные (без учета организаций в ведении ФСИН); Заочная	    выбыло по другим причинам / 16.0	0	0	0	0	0	0	0	0	0	0	0	0	0	0	0	12	0	1	10	23
Брянская область	Государственные, муниципальные (без учета организаций в ведении ФСИН); Заочная	"    добровольно прекратили образовательные отношения
    (бросили учебу) / 10.0"	0	0	0	0	0	0	0	0	0	0	0	0	9	6	15	3	0	64	29	96
Брянская область	Государственные, муниципальные (без учета организаций в ведении ФСИН); Заочная	"    отчислено:
         по неуспеваемости / 11.0"	0	0	0	0	0	0	0	0	0	0	0	0	0	2	2	1	0	3	15	19
Брянская область	Государственные, муниципальные (без учета организаций в ведении ФСИН); Заочная	"    переведено в другие образовательные организации
    на программы того же уровня / 8.0"	0	0	0	0	0	0	0	0	0	0	0	0	0	0	0	0	0	1	1	2
Брянская область	Государственные, муниципальные (без учета организаций в ведении ФСИН); Заочная	"    переведено из других образовательных организаций 
    с программ того же уровня / 3.0"	0	0	0	0	0	0	0	0	0	0	0	0	0	2	2	1	0	1	1	3
Брянская область	Государственные, муниципальные (без учета организаций в ведении ФСИН); Заочная	    по болезни / 9.0	0	0	0	0	0	0	0	0	0	0	0	0	0	0	0	0	0	0	0	0
Брянская область	Государственные, муниципальные (без учета организаций в ведении ФСИН); Заочная	    прибыло по другим причинам / 5.0	0	0	0	0	0	0	0	0	0	0	0	0	0	0	0	10	0	0	9	19
Брянская область	Государственные, муниципальные (без учета организаций в ведении ФСИН); Заочная	Выбыло студентов - всего (сумма стр. 07-11, 13-15) / 6.0	0	0	0	0	0	0	0	0	0	0	0	0	9	9	18	17	0	70	62	149
Брянская область	Государственные, муниципальные (без учета организаций в ведении ФСИН); Заочная	Прибыло студентов - всего (сумма стр. 02-05) / 1.0	0	0	0	0	0	0	0	0	0	0	0	0	0	14	14	13	0	3	38	54
Брянская область	Государственные, муниципальные (без учета организаций в ведении ФСИН); Заочная	"Численность студентов на начало прошлого учебного года
(на 1 октября) / 17.0"	0	0	0	0	0	0	0	0	0	0	0	0	68	90	158	235	0	170	691	1096
Брянская область	Государственные, муниципальные (без учета организаций в ведении ФСИН); Очная	            из стр. 11 - не прошли итоговую аттестацию / 12.0	10	0	0	0	10	0	0	0	0	0	5	0	3	2	10	0	0	0	0	0
Брянская область	Государственные, муниципальные (без учета организаций в ведении ФСИН); Очная	"            из стр. 11 – лица с ограниченными возможностями здоровья,
            инвалиды, дети-инвалиды / 13.0"	0	0	0	0	0	0	0	0	0	0	1	0	0	0	1	0	0	0	0	0
Брянская область	Государственные, муниципальные (без учета организаций в ведении ФСИН); Очная	         отчислено в виде меры дисциплинарного взыскания / 14.0	1	0	0	0	1	1	0	0	0	1	0	0	3	9	12	0	0	1	0	1
Брянская область	Государственные, муниципальные (без учета организаций в ведении ФСИН); Очная	         отчислено из-за просрочки оплаты обучения / 15.0	0	0	0	0	0	0	0	0	0	0	0	0	0	0	0	0	0	0	2	2
Брянская область	Государственные, муниципальные (без учета организаций в ведении ФСИН); Очная	"    в том числе:
    переведено на другие формы обучения данной
    организации на программы того же уровня / 7.0"	1	0	0	0	1	0	0	0	0	0	28	0	4	41	73	6	0	0	8	14
Брянская область	Государственные, муниципальные (без учета организаций в ведении ФСИН); Очная	"    в том числе:
    переведено с других форм обучения данной
    образовательной организации с программ того же уровня / 2.0"	3	0	0	0	3	0	0	0	0	0	17	0	5	2	24	3	0	0	1	4
Брянская область	Государственные, муниципальные (без учета организаций в ведении ФСИН); Очная	    восстановлены из числа ранее отчисленных / 4.0	13	0	0	6	19	0	0	0	0	0	28	0	11	32	71	1	0	0	5	6
Брянская область	Государственные, муниципальные (без учета организаций в ведении ФСИН); Очная	    выбыло по другим причинам / 16.0	44	0	0	0	44	1	0	0	0	1	81	0	12	25	118	3	0	0	1	4
Брянская область	Государственные, муниципальные (без учета организаций в ведении ФСИН); Очная	"    добровольно прекратили образовательные отношения
    (бросили учебу) / 10.0"	257	0	0	6	263	12	0	0	1	13	380	0	145	207	732	52	0	2	65	119
Брянская область	Государственные, муниципальные (без учета организаций в ведении ФСИН); Очная	"    отчислено:
         по неуспеваемости / 11.0"	72	0	0	7	79	1	0	0	0	1	126	0	30	50	206	15	0	0	9	24
Брянская область	Государственные, муниципальные (без учета организаций в ведении ФСИН); Очная	"    переведено в другие образовательные организации
    на программы того же уровня / 8.0"	29	0	0	3	32	0	0	0	0	0	104	0	36	56	196	4	0	1	11	16
Брянская область	Государственные, муниципальные (без учета организаций в ведении ФСИН); Очная	"    переведено из других образовательных организаций 
    с программ того же уровня / 3.0"	26	0	0	3	29	0	0	0	0	0	60	0	59	55	174	3	0	1	2	6
Брянская область	Государственные, муниципальные (без учета организаций в ведении ФСИН); Очная	    по болезни / 9.0	3	0	0	0	3	0	0	0	0	0	3	0	0	2	5	2	0	0	0	2
Брянская область	Государственные, муниципальные (без учета организаций в ведении ФСИН); Очная	    прибыло по другим причинам / 5.0	29	0	0	7	36	2	0	0	0	2	46	0	0	42	88	3	0	0	4	7
Брянская область	Государственные, муниципальные (без учета организаций в ведении ФСИН); Очная	Выбыло студентов - всего (сумма стр. 07-11, 13-15) / 6.0	407	0	0	16	423	15	0	0	1	16	722	0	230	390	1342	82	0	4	96	182
Брянская область	Государственные, муниципальные (без учета организаций в ведении ФСИН); Очная	Прибыло студентов - всего (сумма стр. 02-05) / 1.0	71	0	0	16	87	2	0	0	0	2	151	0	75	131	357	10	0	1	12	23
Брянская область	Государственные, муниципальные (без учета организаций в ведении ФСИН); Очная	"Численность студентов на начало прошлого учебного года
(на 1 октября) / 17.0"	4702	0	0	188	4890	88	0	0	1	89	10370	0	4105	3307	17782	820	0	50	882	1752
Брянская область	Очно-заочная; Государственные, муниципальные (без учета организаций в ведении ФСИН)	            из стр. 11 - не прошли итоговую аттестацию / 12.0	0	0	0	0	0	0	0	0	0	0	0	0	0	0	0	0	0	0	0	0
Брянская область	Очно-заочная; Государственные, муниципальные (без учета организаций в ведении ФСИН)	"            из стр. 11 – лица с ограниченными возможностями здоровья,
            инвалиды, дети-инвалиды / 13.0"	0	0	0	0	0	0	0	0	0	0	0	0	0	0	0	0	0	0	0	0
Брянская область	Очно-заочная; Государственные, муниципальные (без учета организаций в ведении ФСИН)	         отчислено в виде меры дисциплинарного взыскания / 14.0	0	0	0	0	0	0	0	0	0	0	0	0	0	0	0	0	0	0	0	0
Брянская область	Очно-заочная; Государственные, муниципальные (без учета организаций в ведении ФСИН)	         отчислено из-за просрочки оплаты обучения / 15.0	0	0	0	0	0	0	0	0	0	0	0	0	0	0	0	0	0	0	0	0
Брянская область	Очно-заочная; Государственные, муниципальные (без учета организаций в ведении ФСИН)	"    в том числе:
    переведено на другие формы обучения данной
    организации на программы того же уровня / 7.0"	0	0	0	0	0	0	0	0	0	0	0	0	0	0	0	0	0	0	0	0
Брянская область	Очно-заочная; Государственные, муниципальные (без учета организаций в ведении ФСИН)	"    в том числе:
    переведено с других форм обучения данной
    образовательной организации с программ того же уровня / 2.0"	0	0	0	0	0	0	0	0	0	0	0	0	0	0	0	0	0	0	0	0
Брянская область	Очно-заочная; Государственные, муниципальные (без учета организаций в ведении ФСИН)	    восстановлены из числа ранее отчисленных / 4.0	0	0	0	0	0	0	0	0	0	0	0	0	0	0	0	0	0	0	6	6
Брянская область	Очно-заочная; Государственные, муниципальные (без учета организаций в ведении ФСИН)	    выбыло по другим причинам / 16.0	0	0	0	0	0	0	0	0	0	0	0	0	0	0	0	0	0	0	3	3
Брянская область	Очно-заочная; Государственные, муниципальные (без учета организаций в ведении ФСИН)	"    добровольно прекратили образовательные отношения
    (бросили учебу) / 10.0"	0	0	0	0	0	0	0	0	0	0	0	0	0	0	0	3	0	0	30	33
Брянская область	Очно-заочная; Государственные, муниципальные (без учета организаций в ведении ФСИН)	"    отчислено:
         по неуспеваемости / 11.0"	0	0	0	0	0	0	0	0	0	0	0	0	0	0	0	2	0	0	1	3
Брянская область	Очно-заочная; Государственные, муниципальные (без учета организаций в ведении ФСИН)	"    переведено в другие образовательные организации
    на программы того же уровня / 8.0"	0	0	0	0	0	0	0	0	0	0	0	0	0	0	0	0	0	0	1	1
Брянская область	Очно-заочная; Государственные, муниципальные (без учета организаций в ведении ФСИН)	"    переведено из других образовательных организаций 
    с программ того же уровня / 3.0"	0	0	0	0	0	0	0	0	0	0	0	0	0	0	0	1	0	0	2	3
Брянская область	Очно-заочная; Государственные, муниципальные (без учета организаций в ведении ФСИН)	    по болезни / 9.0	0	0	0	0	0	0	0	0	0	0	0	0	0	0	0	0	0	0	0	0
Брянская область	Очно-заочная; Государственные, муниципальные (без учета организаций в ведении ФСИН)	    прибыло по другим причинам / 5.0	0	0	0	0	0	0	0	0	0	0	0	0	0	0	0	1	0	0	14	15
Брянская область	Очно-заочная; Государственные, муниципальные (без учета организаций в ведении ФСИН)	Выбыло студентов - всего (сумма стр. 07-11, 13-15) / 6.0	0	0	0	0	0	0	0	0	0	0	0	0	0	0	0	5	0	0	35	40
Брянская область	Очно-заочная; Государственные, муниципальные (без учета организаций в ведении ФСИН)	Прибыло студентов - всего (сумма стр. 02-05) / 1.0	0	0	0	0	0	0	0	0	0	0	0	0	0	0	0	2	0	0	22	24
Брянская область	Очно-заочная; Государственные, муниципальные (без учета организаций в ведении ФСИН)	"Численность студентов на начало прошлого учебного года
(на 1 октября) / 17.0"	0	0	0	0	0	0	0	0	0	0	0	0	0	0	0	44	0	0	887	931
Брянская область	Частные; Заочная	            из стр. 11 - не прошли итоговую аттестацию / 12.0	0	0	0	0	0	0	0	0	0	0	0	0	0	1	1	0	0	0	0	0
Брянская область	Частные; Заочная	"            из стр. 11 – лица с ограниченными возможностями здоровья,
            инвалиды, дети-инвалиды / 13.0"	0	0	0	0	0	0	0	0	0	0	0	0	0	0	0	0	0	0	0	0
Брянская область	Частные; Заочная	         отчислено в виде меры дисциплинарного взыскания / 14.0	0	0	0	0	0	0	0	0	0	0	0	0	0	0	0	0	0	0	0	0
Брянская область	Частные; Заочная	         отчислено из-за просрочки оплаты обучения / 15.0	0	0	0	0	0	0	0	0	0	0	0	0	0	0	0	0	0	0	0	0
Брянская область	Частные; Заочная	"    в том числе:
    переведено на другие формы обучения данной
    организации на программы того же уровня / 7.0"	0	0	0	0	0	0	0	0	0	0	0	0	0	0	0	0	0	0	0	0
Брянская область	Частные; Заочная	"    в том числе:
    переведено с других форм обучения данной
    образовательной организации с программ того же уровня / 2.0"	0	0	0	0	0	0	0	0	0	0	0	0	0	9	9	0	0	0	17	17
Брянская область	Частные; Заочная	    восстановлены из числа ранее отчисленных / 4.0	0	0	0	0	0	0	0	0	0	0	0	0	0	2	2	0	0	0	4	4
Брянская область	Частные; Заочная	    выбыло по другим причинам / 16.0	0	0	0	0	0	0	0	0	0	0	0	0	0	1	1	0	0	0	0	0
Брянская область	Частные; Заочная	"    добровольно прекратили образовательные отношения
    (бросили учебу) / 10.0"	0	0	0	0	0	0	0	0	0	0	0	0	0	8	8	0	0	0	13	13
Брянская область	Частные; Заочная	"    отчислено:
         по неуспеваемости / 11.0"	0	0	0	0	0	0	0	0	0	0	0	0	0	3	3	0	0	0	1	1
Брянская область	Частные; Заочная	"    переведено в другие образовательные организации
    на программы того же уровня / 8.0"	0	0	0	0	0	0	0	0	0	0	0	0	0	0	0	0	0	0	0	0
Брянская область	Частные; Заочная	"    переведено из других образовательных организаций 
    с программ того же уровня / 3.0"	0	0	0	0	0	0	0	0	0	0	0	0	0	0	0	0	0	0	4	4
Брянская область	Частные; Заочная	    по болезни / 9.0	0	0	0	0	0	0	0	0	0	0	0	0	0	0	0	0	0	0	1	1
Брянская область	Частные; Заочная	    прибыло по другим причинам / 5.0	0	0	0	0	0	0	0	0	0	0	0	0	0	0	0	0	0	0	3	3
Брянская область	Частные; Заочная	Выбыло студентов - всего (сумма стр. 07-11, 13-15) / 6.0	0	0	0	0	0	0	0	0	0	0	0	0	0	12	12	0	0	0	15	15
Брянская область	Частные; Заочная	Прибыло студентов - всего (сумма стр. 02-05) / 1.0	0	0	0	0	0	0	0	0	0	0	0	0	0	11	11	0	0	0	28	28
Брянская область	Частные; Заочная	"Численность студентов на начало прошлого учебного года
(на 1 октября) / 17.0"	0	0	0	0	0	0	0	0	0	0	0	0	0	73	73	0	0	0	105	105
Брянская область	Частные; Очная	            из стр. 11 - не прошли итоговую аттестацию / 12.0	0	0	0	0	0	0	0	0	0	0	0	0	0	0	0	0	0	0	0	0
Брянская область	Частные; Очная	"            из стр. 11 – лица с ограниченными возможностями здоровья,
            инвалиды, дети-инвалиды / 13.0"	0	0	0	0	0	0	0	0	0	0	0	0	0	0	0	0	0	0	0	0
Брянская область	Частные; Очная	         отчислено в виде меры дисциплинарного взыскания / 14.0	0	0	0	0	0	0	0	0	0	0	0	0	0	2	2	0	0	0	0	0
Брянская область	Частные; Очная	         отчислено из-за просрочки оплаты обучения / 15.0	0	0	0	0	0	0	0	0	0	0	0	0	0	1	1	0	0	0	0	0
Брянская область	Частные; Очная	"    в том числе:
    переведено на другие формы обучения данной
    организации на программы того же уровня / 7.0"	0	0	0	0	0	0	0	0	2	2	0	0	0	24	24	0	0	0	1	1
Брянская область	Частные; Очная	"    в том числе:
    переведено с других форм обучения данной
    образовательной организации с программ того же уровня / 2.0"	0	0	0	0	0	0	0	0	0	0	0	0	0	1	1	0	0	0	0	0
Брянская область	Частные; Очная	    восстановлены из числа ранее отчисленных / 4.0	0	0	0	0	0	0	0	0	0	0	0	0	0	8	8	0	0	0	2	2
Брянская область	Частные; Очная	    выбыло по другим причинам / 16.0	0	0	0	1	1	0	0	0	0	0	0	0	0	35	35	0	0	0	6	6
Брянская область	Частные; Очная	"    добровольно прекратили образовательные отношения
    (бросили учебу) / 10.0"	0	0	0	1	1	0	0	0	0	0	0	0	0	30	30	0	0	0	2	2
Брянская область	Частные; Очная	"    отчислено:
         по неуспеваемости / 11.0"	0	0	0	0	0	0	0	0	0	0	0	0	0	20	20	0	0	0	2	2
Брянская область	Частные; Очная	"    переведено в другие образовательные организации
    на программы того же уровня / 8.0"	0	0	0	0	0	0	0	0	0	0	0	0	0	8	8	0	0	0	0	0
Брянская область	Частные; Очная	"    переведено из других образовательных организаций 
    с программ того же уровня / 3.0"	0	0	0	0	0	0	0	0	0	0	0	0	0	5	5	0	0	0	4	4
Брянская область	Частные; Очная	    по болезни / 9.0	0	0	0	0	0	0	0	0	0	0	0	0	0	0	0	0	0	0	0	0
Брянская область	Частные; Очная	    прибыло по другим причинам / 5.0	0	0	0	8	8	0	0	0	0	0	0	0	0	8	8	0	0	0	0	0
Брянская область	Частные; Очная	Выбыло студентов - всего (сумма стр. 07-11, 13-15) / 6.0	0	0	0	2	2	0	0	0	2	2	0	0	0	120	120	0	0	0	11	11
Брянская область	Частные; Очная	Прибыло студентов - всего (сумма стр. 02-05) / 1.0	0	0	0	8	8	0	0	0	0	0	0	0	0	22	22	0	0	0	6	6
Брянская область	Частные; Очная	"Численность студентов на начало прошлого учебного года
(на 1 октября) / 17.0"	0	0	0	2	2	0	0	0	0	0	0	0	0	643	643	0	0	0	129	129
Брянская область	Частные; Очно-заочная	            из стр. 11 - не прошли итоговую аттестацию / 12.0	0	0	0	0	0	0	0	0	0	0	0	0	0	0	0	0	0	0	0	0
Брянская область	Частные; Очно-заочная	"            из стр. 11 – лица с ограниченными возможностями здоровья,
            инвалиды, дети-инвалиды / 13.0"	0	0	0	0	0	0	0	0	0	0	0	0	0	0	0	0	0	0	0	0
Брянская область	Частные; Очно-заочная	         отчислено в виде меры дисциплинарного взыскания / 14.0	0	0	0	0	0	0	0	0	0	0	0	0	0	0	0	0	0	0	0	0
Брянская область	Частные; Очно-заочная	         отчислено из-за просрочки оплаты обучения / 15.0	0	0	0	0	0	0	0	0	0	0	0	0	0	0	0	0	0	0	0	0
Брянская область	Частные; Очно-заочная	"    в том числе:
    переведено на другие формы обучения данной
    организации на программы того же уровня / 7.0"	0	0	0	0	0	0	0	0	0	0	0	0	0	0	0	0	0	0	0	0
Брянская область	Частные; Очно-заочная	"    в том числе:
    переведено с других форм обучения данной
    образовательной организации с программ того же уровня / 2.0"	0	0	0	0	0	0	0	0	2	2	0	0	0	0	0	0	0	0	0	0
Брянская область	Частные; Очно-заочная	    восстановлены из числа ранее отчисленных / 4.0	0	0	0	0	0	0	0	0	0	0	0	0	0	0	0	0	0	0	0	0
Брянская область	Частные; Очно-заочная	    выбыло по другим причинам / 16.0	0	0	0	0	0	0	0	0	0	0	0	0	0	0	0	0	0	0	0	0
Брянская область	Частные; Очно-заочная	"    добровольно прекратили образовательные отношения
    (бросили учебу) / 10.0"	0	0	0	0	0	0	0	0	5	5	0	0	0	0	0	0	0	0	0	0
Брянская область	Частные; Очно-заочная	"    отчислено:
         по неуспеваемости / 11.0"	0	0	0	0	0	0	0	0	9	9	0	0	0	0	0	0	0	0	0	0
Брянская область	Частные; Очно-заочная	"    переведено в другие образовательные организации
    на программы того же уровня / 8.0"	0	0	0	0	0	0	0	0	0	0	0	0	0	0	0	0	0	0	0	0
Брянская область	Частные; Очно-заочная	"    переведено из других образовательных организаций 
    с программ того же уровня / 3.0"	0	0	0	0	0	0	0	0	0	0	0	0	0	0	0	0	0	0	0	0
Брянская область	Частные; Очно-заочная	    по болезни / 9.0	0	0	0	0	0	0	0	0	0	0	0	0	0	0	0	0	0	0	0	0
Брянская область	Частные; Очно-заочная	    прибыло по другим причинам / 5.0	0	0	0	0	0	0	0	0	0	0	0	0	0	0	0	0	0	0	0	0
Брянская область	Частные; Очно-заочная	Выбыло студентов - всего (сумма стр. 07-11, 13-15) / 6.0	0	0	0	0	0	0	0	0	14	14	0	0	0	0	0	0	0	0	0	0
Брянская область	Частные; Очно-заочная	Прибыло студентов - всего (сумма стр. 02-05) / 1.0	0	0	0	0	0	0	0	0	2	2	0	0	0	0	0	0	0	0	0	0
Брянская область	Частные; Очно-заочная	"Численность студентов на начало прошлого учебного года
(на 1 октября) / 17.0"	0	0	0	1	1	0	0	0	10	10	0	0	0	0	0	0	0	0	0	0
Владимирская область	Государственные, муниципальные (без учета организаций в ведении ФСИН); Заочная	            из стр. 11 - не прошли итоговую аттестацию / 12.0	0	0	0	0	0	0	0	0	0	0	0	0	0	0	0	0	0	0	0	0
Владимирская область	Государственные, муниципальные (без учета организаций в ведении ФСИН); Заочная	"            из стр. 11 – лица с ограниченными возможностями здоровья,
            инвалиды, дети-инвалиды / 13.0"	0	0	0	0	0	0	0	0	0	0	0	0	0	0	0	0	0	0	0	0
Владимирская область	Государственные, муниципальные (без учета организаций в ведении ФСИН); Заочная	         отчислено в виде меры дисциплинарного взыскания / 14.0	0	0	0	0	0	0	0	0	0	0	0	0	0	0	0	0	0	0	0	0
Владимирская область	Государственные, муниципальные (без учета организаций в ведении ФСИН); Заочная	         отчислено из-за просрочки оплаты обучения / 15.0	0	0	0	0	0	0	0	0	0	0	0	0	0	0	0	0	0	0	6	6
Владимирская область	Государственные, муниципальные (без учета организаций в ведении ФСИН); Заочная	"    в том числе:
    переведено на другие формы обучения данной
    организации на программы того же уровня / 7.0"	0	0	0	0	0	0	0	0	0	0	0	0	0	0	0	2	0	0	10	12
Владимирская область	Государственные, муниципальные (без учета организаций в ведении ФСИН); Заочная	"    в том числе:
    переведено с других форм обучения данной
    образовательной организации с программ того же уровня / 2.0"	0	0	0	0	0	0	0	0	0	0	0	0	0	0	0	38	0	0	42	80
Владимирская область	Государственные, муниципальные (без учета организаций в ведении ФСИН); Заочная	    восстановлены из числа ранее отчисленных / 4.0	0	0	0	0	0	0	0	0	0	0	0	0	0	0	0	19	0	0	15	34
Владимирская область	Государственные, муниципальные (без учета организаций в ведении ФСИН); Заочная	    выбыло по другим причинам / 16.0	0	0	0	0	0	0	0	0	0	0	0	0	0	0	0	22	0	0	15	37
Владимирская область	Государственные, муниципальные (без учета организаций в ведении ФСИН); Заочная	"    добровольно прекратили образовательные отношения
    (бросили учебу) / 10.0"	0	0	0	0	0	0	0	0	0	0	10	0	0	0	10	71	0	0	28	99
Владимирская область	Государственные, муниципальные (без учета организаций в ведении ФСИН); Заочная	"    отчислено:
         по неуспеваемости / 11.0"	0	0	0	0	0	0	0	0	0	0	0	0	0	0	0	49	0	0	9	58
Владимирская область	Государственные, муниципальные (без учета организаций в ведении ФСИН); Заочная	"    переведено в другие образовательные организации
    на программы того же уровня / 8.0"	0	0	0	0	0	0	0	0	0	0	0	0	0	0	0	1	0	0	0	1
Владимирская область	Государственные, муниципальные (без учета организаций в ведении ФСИН); Заочная	"    переведено из других образовательных организаций 
    с программ того же уровня / 3.0"	0	0	0	0	0	0	0	0	0	0	1	0	0	0	1	12	0	0	4	16
Владимирская область	Государственные, муниципальные (без учета организаций в ведении ФСИН); Заочная	    по болезни / 9.0	0	0	0	0	0	0	0	0	0	0	0	0	0	0	0	0	0	0	8	8
Владимирская область	Государственные, муниципальные (без учета организаций в ведении ФСИН); Заочная	    прибыло по другим причинам / 5.0	0	0	0	0	0	0	0	0	0	0	0	0	0	0	0	9	0	0	29	38
Владимирская область	Государственные, муниципальные (без учета организаций в ведении ФСИН); Заочная	Выбыло студентов - всего (сумма стр. 07-11, 13-15) / 6.0	0	0	0	0	0	0	0	0	0	0	10	0	0	0	10	145	0	0	76	221
Владимирская область	Государственные, муниципальные (без учета организаций в ведении ФСИН); Заочная	Прибыло студентов - всего (сумма стр. 02-05) / 1.0	0	0	0	0	0	0	0	0	0	0	1	0	0	0	1	78	0	0	90	168
Владимирская область	Государственные, муниципальные (без учета организаций в ведении ФСИН); Заочная	"Численность студентов на начало прошлого учебного года
(на 1 октября) / 17.0"	0	0	0	0	0	0	0	0	0	0	56	0	0	0	56	1150	0	0	566	1716
Владимирская область	Государственные, муниципальные (без учета организаций в ведении ФСИН); Очная	            из стр. 11 - не прошли итоговую аттестацию / 12.0	0	0	0	0	0	0	0	0	0	0	1	0	0	5	6	0	0	0	3	3
Владимирская область	Государственные, муниципальные (без учета организаций в ведении ФСИН); Очная	"            из стр. 11 – лица с ограниченными возможностями здоровья,
            инвалиды, дети-инвалиды / 13.0"	0	0	0	0	0	0	0	0	0	0	0	0	0	0	0	0	0	0	0	0
Владимирская область	Государственные, муниципальные (без учета организаций в ведении ФСИН); Очная	         отчислено в виде меры дисциплинарного взыскания / 14.0	4	0	0	0	4	0	0	0	0	0	4	0	0	0	4	0	0	0	0	0
Владимирская область	Государственные, муниципальные (без учета организаций в ведении ФСИН); Очная	         отчислено из-за просрочки оплаты обучения / 15.0	0	0	0	1	1	0	0	0	0	0	0	0	0	47	47	0	0	0	13	13
Владимирская область	Государственные, муниципальные (без учета организаций в ведении ФСИН); Очная	"    в том числе:
    переведено на другие формы обучения данной
    организации на программы того же уровня / 7.0"	13	0	0	1	14	0	0	0	0	0	71	0	1	127	199	1	0	0	11	12
Владимирская область	Государственные, муниципальные (без учета организаций в ведении ФСИН); Очная	"    в том числе:
    переведено с других форм обучения данной
    образовательной организации с программ того же уровня / 2.0"	25	0	0	1	26	0	0	0	0	0	50	0	11	19	80	1	0	0	0	1
Владимирская область	Государственные, муниципальные (без учета организаций в ведении ФСИН); Очная	    восстановлены из числа ранее отчисленных / 4.0	13	0	0	1	14	0	0	0	0	0	46	0	12	81	139	3	0	0	15	18
Владимирская область	Государственные, муниципальные (без учета организаций в ведении ФСИН); Очная	    выбыло по другим причинам / 16.0	159	0	0	15	174	1	0	0	0	1	158	0	31	78	267	34	0	0	16	50
Владимирская область	Государственные, муниципальные (без учета организаций в ведении ФСИН); Очная	"    добровольно прекратили образовательные отношения
    (бросили учебу) / 10.0"	218	0	0	5	223	8	0	0	0	8	321	0	51	173	545	51	0	0	79	130
Владимирская область	Государственные, муниципальные (без учета организаций в ведении ФСИН); Очная	"    отчислено:
         по неуспеваемости / 11.0"	97	0	0	1	98	0	0	0	0	0	123	0	25	127	275	11	0	0	45	56
Владимирская область	Государственные, муниципальные (без учета организаций в ведении ФСИН); Очная	"    переведено в другие образовательные организации
    на программы того же уровня / 8.0"	50	0	0	5	55	0	0	0	0	0	124	0	1	114	239	15	0	0	8	23
Владимирская область	Государственные, муниципальные (без учета организаций в ведении ФСИН); Очная	"    переведено из других образовательных организаций 
    с программ того же уровня / 3.0"	78	0	0	0	78	0	0	0	0	0	85	0	16	70	171	1	0	0	6	7
Владимирская область	Государственные, муниципальные (без учета организаций в ведении ФСИН); Очная	    по болезни / 9.0	7	0	0	0	7	0	0	0	0	0	2	0	0	25	27	0	0	0	0	0
Владимирская область	Государственные, муниципальные (без учета организаций в ведении ФСИН); Очная	    прибыло по другим причинам / 5.0	120	0	0	4	124	0	0	0	0	0	56	0	27	41	124	8	0	0	9	17
Владимирская область	Государственные, муниципальные (без учета организаций в ведении ФСИН); Очная	Выбыло студентов - всего (сумма стр. 07-11, 13-15) / 6.0	548	0	0	28	576	9	0	0	0	9	803	0	109	691	1603	112	0	0	172	284
Владимирская область	Государственные, муниципальные (без учета организаций в ведении ФСИН); Очная	Прибыло студентов - всего (сумма стр. 02-05) / 1.0	236	0	0	6	242	0	0	0	0	0	237	0	66	211	514	13	0	0	30	43
Владимирская область	Государственные, муниципальные (без учета организаций в ведении ФСИН); Очная	"Численность студентов на начало прошлого учебного года
(на 1 октября) / 17.0"	6422	0	0	216	6638	42	0	0	0	42	11831	0	1740	6290	19861	983	0	11	931	1925
Владимирская область	Очно-заочная; Государственные, муниципальные (без учета организаций в ведении ФСИН)	            из стр. 11 - не прошли итоговую аттестацию / 12.0	0	0	0	0	0	0	0	0	0	0	0	0	0	0	0	0	0	0	0	0
Владимирская область	Очно-заочная; Государственные, муниципальные (без учета организаций в ведении ФСИН)	"            из стр. 11 – лица с ограниченными возможностями здоровья,
            инвалиды, дети-инвалиды / 13.0"	0	0	0	0	0	0	0	0	0	0	0	0	0	0	0	0	0	0	0	0
Владимирская область	Очно-заочная; Государственные, муниципальные (без учета организаций в ведении ФСИН)	         отчислено в виде меры дисциплинарного взыскания / 14.0	0	0	0	0	0	0	0	0	0	0	0	0	0	0	0	0	0	0	0	0
Владимирская область	Очно-заочная; Государственные, муниципальные (без учета организаций в ведении ФСИН)	         отчислено из-за просрочки оплаты обучения / 15.0	0	0	0	0	0	0	0	0	0	0	0	0	0	0	0	0	0	0	2	2
Владимирская область	Очно-заочная; Государственные, муниципальные (без учета организаций в ведении ФСИН)	"    в том числе:
    переведено на другие формы обучения данной
    организации на программы того же уровня / 7.0"	0	0	0	0	0	0	0	0	0	0	0	0	0	0	0	0	0	0	0	0
Владимирская область	Очно-заочная; Государственные, муниципальные (без учета организаций в ведении ФСИН)	"    в том числе:
    переведено с других форм обучения данной
    образовательной организации с программ того же уровня / 2.0"	0	0	0	0	0	0	0	0	0	0	0	0	0	0	0	0	0	0	2	2
Владимирская область	Очно-заочная; Государственные, муниципальные (без учета организаций в ведении ФСИН)	    восстановлены из числа ранее отчисленных / 4.0	0	0	0	0	0	0	0	0	0	0	0	0	0	0	0	0	0	0	7	7
Владимирская область	Очно-заочная; Государственные, муниципальные (без учета организаций в ведении ФСИН)	    выбыло по другим причинам / 16.0	0	0	0	0	0	0	0	0	0	0	0	0	0	0	0	0	0	0	12	12
Владимирская область	Очно-заочная; Государственные, муниципальные (без учета организаций в ведении ФСИН)	"    добровольно прекратили образовательные отношения
    (бросили учебу) / 10.0"	0	0	0	0	0	0	0	0	0	0	0	0	0	0	0	0	0	0	21	21
Владимирская область	Очно-заочная; Государственные, муниципальные (без учета организаций в ведении ФСИН)	"    отчислено:
         по неуспеваемости / 11.0"	0	0	0	0	0	0	0	0	0	0	0	0	0	0	0	0	0	0	6	6
Владимирская область	Очно-заочная; Государственные, муниципальные (без учета организаций в ведении ФСИН)	"    переведено в другие образовательные организации
    на программы того же уровня / 8.0"	0	0	0	0	0	0	0	0	0	0	0	0	0	0	0	0	0	0	0	0
Владимирская область	Очно-заочная; Государственные, муниципальные (без учета организаций в ведении ФСИН)	"    переведено из других образовательных организаций 
    с программ того же уровня / 3.0"	0	0	0	0	0	0	0	0	0	0	0	0	0	0	0	0	0	0	1	1
Владимирская область	Очно-заочная; Государственные, муниципальные (без учета организаций в ведении ФСИН)	    по болезни / 9.0	0	0	0	0	0	0	0	0	0	0	0	0	0	0	0	0	0	0	0	0
Владимирская область	Очно-заочная; Государственные, муниципальные (без учета организаций в ведении ФСИН)	    прибыло по другим причинам / 5.0	0	0	0	0	0	0	0	0	0	0	0	0	0	0	0	0	0	0	4	4
Владимирская область	Очно-заочная; Государственные, муниципальные (без учета организаций в ведении ФСИН)	Выбыло студентов - всего (сумма стр. 07-11, 13-15) / 6.0	0	0	0	0	0	0	0	0	0	0	0	0	0	0	0	0	0	0	41	41
Владимирская область	Очно-заочная; Государственные, муниципальные (без учета организаций в ведении ФСИН)	Прибыло студентов - всего (сумма стр. 02-05) / 1.0	0	0	0	0	0	0	0	0	0	0	0	0	0	0	0	0	0	0	14	14
Владимирская область	Очно-заочная; Государственные, муниципальные (без учета организаций в ведении ФСИН)	"Численность студентов на начало прошлого учебного года
(на 1 октября) / 17.0"	0	0	0	0	0	0	0	0	0	0	0	0	0	0	0	0	0	0	432	432
Владимирская область	Частные; Заочная	            из стр. 11 - не прошли итоговую аттестацию / 12.0	0	0	0	0	0	0	0	0	0	0	0	0	0	0	0	0	0	0	0	0
Владимирская область	Частные; Заочная	"            из стр. 11 – лица с ограниченными возможностями здоровья,
            инвалиды, дети-инвалиды / 13.0"	0	0	0	0	0	0	0	0	0	0	0	0	0	0	0	0	0	0	0	0
Владимирская область	Частные; Заочная	         отчислено в виде меры дисциплинарного взыскания / 14.0	0	0	0	0	0	0	0	0	0	0	0	0	0	0	0	0	0	0	0	0
Владимирская область	Частные; Заочная	         отчислено из-за просрочки оплаты обучения / 15.0	0	0	0	0	0	0	0	0	0	0	0	0	0	0	0	0	0	0	2	2
Владимирская область	Частные; Заочная	"    в том числе:
    переведено на другие формы обучения данной
    организации на программы того же уровня / 7.0"	0	0	0	0	0	0	0	0	0	0	0	0	0	0	0	0	0	0	0	0
Владимирская область	Частные; Заочная	"    в том числе:
    переведено с других форм обучения данной
    образовательной организации с программ того же уровня / 2.0"	0	0	0	0	0	0	0	0	0	0	0	0	0	0	0	2	0	0	1	3
Владимирская область	Частные; Заочная	    восстановлены из числа ранее отчисленных / 4.0	0	0	0	0	0	0	0	0	0	0	0	0	0	0	0	0	0	0	0	0
Владимирская область	Частные; Заочная	    выбыло по другим причинам / 16.0	0	0	0	0	0	0	0	0	0	0	0	0	0	7	7	5	0	0	17	22
Владимирская область	Частные; Заочная	"    добровольно прекратили образовательные отношения
    (бросили учебу) / 10.0"	0	0	0	0	0	0	0	0	0	0	0	0	0	0	0	2	0	0	7	9
Владимирская область	Частные; Заочная	"    отчислено:
         по неуспеваемости / 11.0"	0	0	0	0	0	0	0	0	0	0	0	0	0	0	0	8	0	0	4	12
Владимирская область	Частные; Заочная	"    переведено в другие образовательные организации
    на программы того же уровня / 8.0"	0	0	0	0	0	0	0	0	0	0	0	0	0	0	0	0	0	0	1	1
Владимирская область	Частные; Заочная	"    переведено из других образовательных организаций 
    с программ того же уровня / 3.0"	0	0	0	0	0	0	0	0	0	0	0	0	0	0	0	0	0	0	1	1
Владимирская область	Частные; Заочная	    по болезни / 9.0	0	0	0	0	0	0	0	0	0	0	0	0	0	0	0	0	0	0	0	0
Владимирская область	Частные; Заочная	    прибыло по другим причинам / 5.0	0	0	0	0	0	0	0	0	0	0	0	0	0	9	9	0	0	0	1	1
Владимирская область	Частные; Заочная	Выбыло студентов - всего (сумма стр. 07-11, 13-15) / 6.0	0	0	0	0	0	0	0	0	0	0	0	0	0	7	7	15	0	0	31	46
Владимирская область	Частные; Заочная	Прибыло студентов - всего (сумма стр. 02-05) / 1.0	0	0	0	0	0	0	0	0	0	0	0	0	0	9	9	2	0	0	3	5
Владимирская область	Частные; Заочная	"Численность студентов на начало прошлого учебного года
(на 1 октября) / 17.0"	0	0	0	0	0	0	0	0	0	0	0	0	0	44	44	49	0	0	139	188
Владимирская область	Частные; Очная	            из стр. 11 - не прошли итоговую аттестацию / 12.0	0	0	0	0	0	0	0	0	0	0	0	0	0	0	0	0	0	0	0	0
Владимирская область	Частные; Очная	"            из стр. 11 – лица с ограниченными возможностями здоровья,
            инвалиды, дети-инвалиды / 13.0"	0	0	0	0	0	0	0	0	0	0	0	0	0	0	0	0	0	0	0	0
Владимирская область	Частные; Очная	         отчислено в виде меры дисциплинарного взыскания / 14.0	0	0	0	0	0	0	0	0	0	0	0	0	0	0	0	0	0	0	0	0
Владимирская область	Частные; Очная	         отчислено из-за просрочки оплаты обучения / 15.0	0	0	0	0	0	0	0	0	0	0	0	0	0	9	9	0	0	0	3	3
Владимирская область	Частные; Очная	"    в том числе:
    переведено на другие формы обучения данной
    организации на программы того же уровня / 7.0"	0	0	0	0	0	0	0	0	0	0	3	0	0	11	14	0	0	0	1	1
Владимирская область	Частные; Очная	"    в том числе:
    переведено с других форм обучения данной
    образовательной организации с программ того же уровня / 2.0"	0	0	0	0	0	0	0	0	0	0	0	0	0	0	0	0	0	0	0	0
Владимирская область	Частные; Очная	    восстановлены из числа ранее отчисленных / 4.0	0	0	0	0	0	0	0	0	0	0	0	0	0	3	3	0	0	0	1	1
Владимирская область	Частные; Очная	    выбыло по другим причинам / 16.0	0	0	0	0	0	0	0	0	0	0	6	0	0	32	38	0	0	0	7	7
Владимирская область	Частные; Очная	"    добровольно прекратили образовательные отношения
    (бросили учебу) / 10.0"	0	0	0	0	0	0	0	0	0	0	0	0	0	5	5	0	0	0	1	1
Владимирская область	Частные; Очная	"    отчислено:
         по неуспеваемости / 11.0"	0	0	0	0	0	0	0	0	0	0	2	0	0	19	21	0	0	0	0	0
Владимирская область	Частные; Очная	"    переведено в другие образовательные организации
    на программы того же уровня / 8.0"	0	0	0	0	0	0	0	0	0	0	3	0	0	13	16	0	0	0	2	2
Владимирская область	Частные; Очная	"    переведено из других образовательных организаций 
    с программ того же уровня / 3.0"	0	0	0	0	0	0	0	0	0	0	0	0	0	16	16	0	0	0	2	2
Владимирская область	Частные; Очная	    по болезни / 9.0	0	0	0	0	0	0	0	0	0	0	0	0	0	0	0	0	0	0	0	0
Владимирская область	Частные; Очная	    прибыло по другим причинам / 5.0	0	0	0	0	0	0	0	0	0	0	5	0	0	6	11	0	0	0	11	11
Владимирская область	Частные; Очная	Выбыло студентов - всего (сумма стр. 07-11, 13-15) / 6.0	0	0	0	0	0	0	0	0	0	0	14	0	0	89	103	0	0	0	14	14
Владимирская область	Частные; Очная	Прибыло студентов - всего (сумма стр. 02-05) / 1.0	0	0	0	0	0	0	0	0	0	0	5	0	0	25	30	0	0	0	14	14
Владимирская область	Частные; Очная	"Численность студентов на начало прошлого учебного года
(на 1 октября) / 17.0"	0	0	0	0	0	0	0	0	0	0	191	0	0	1077	1268	0	0	0	128	128
Владимирская область	Частные; Очно-заочная	            из стр. 11 - не прошли итоговую аттестацию / 12.0	0	0	0	0	0	0	0	0	0	0	0	0	0	0	0	0	0	0	0	0
Владимирская область	Частные; Очно-заочная	"            из стр. 11 – лица с ограниченными возможностями здоровья,
            инвалиды, дети-инвалиды / 13.0"	0	0	0	0	0	0	0	0	0	0	0	0	0	0	0	0	0	0	0	0
Владимирская область	Частные; Очно-заочная	         отчислено в виде меры дисциплинарного взыскания / 14.0	0	0	0	0	0	0	0	0	0	0	0	0	0	0	0	0	0	0	0	0
Владимирская область	Частные; Очно-заочная	         отчислено из-за просрочки оплаты обучения / 15.0	0	0	0	0	0	0	0	0	0	0	0	0	0	0	0	0	0	0	0	0
Владимирская область	Частные; Очно-заочная	"    в том числе:
    переведено на другие формы обучения данной
    организации на программы того же уровня / 7.0"	0	0	0	0	0	0	0	0	0	0	0	0	0	0	0	0	0	0	0	0
Владимирская область	Частные; Очно-заочная	"    в том числе:
    переведено с других форм обучения данной
    образовательной организации с программ того же уровня / 2.0"	0	0	0	0	0	0	0	0	0	0	0	0	0	0	0	0	0	0	0	0
Владимирская область	Частные; Очно-заочная	    восстановлены из числа ранее отчисленных / 4.0	0	0	0	0	0	0	0	0	0	0	0	0	0	0	0	0	0	0	0	0
Владимирская область	Частные; Очно-заочная	    выбыло по другим причинам / 16.0	0	0	0	0	0	0	0	0	0	0	0	0	0	0	0	0	0	0	4	4
Владимирская область	Частные; Очно-заочная	"    добровольно прекратили образовательные отношения
    (бросили учебу) / 10.0"	0	0	0	0	0	0	0	0	0	0	0	0	0	0	0	0	0	0	0	0
Владимирская область	Частные; Очно-заочная	"    отчислено:
         по неуспеваемости / 11.0"	0	0	0	0	0	0	0	0	0	0	0	0	0	0	0	0	0	0	0	0
Владимирская область	Частные; Очно-заочная	"    переведено в другие образовательные организации
    на программы того же уровня / 8.0"	0	0	0	0	0	0	0	0	0	0	0	0	0	0	0	0	0	0	0	0
Владимирская область	Частные; Очно-заочная	"    переведено из других образовательных организаций 
    с программ того же уровня / 3.0"	0	0	0	0	0	0	0	0	0	0	0	0	0	0	0	0	0	0	0	0
Владимирская область	Частные; Очно-заочная	    по болезни / 9.0	0	0	0	0	0	0	0	0	0	0	0	0	0	0	0	0	0	0	0	0
Владимирская область	Частные; Очно-заочная	    прибыло по другим причинам / 5.0	0	0	0	0	0	0	0	0	0	0	0	0	0	0	0	0	0	0	2	2
Владимирская область	Частные; Очно-заочная	Выбыло студентов - всего (сумма стр. 07-11, 13-15) / 6.0	0	0	0	0	0	0	0	0	0	0	0	0	0	0	0	0	0	0	4	4
Владимирская область	Частные; Очно-заочная	Прибыло студентов - всего (сумма стр. 02-05) / 1.0	0	0	0	0	0	0	0	0	0	0	0	0	0	0	0	0	0	0	2	2
Владимирская область	Частные; Очно-заочная	"Численность студентов на начало прошлого учебного года
(на 1 октября) / 17.0"	0	0	0	0	0	0	0	0	0	0	0	0	0	0	0	0	0	0	36	36
Волгоградская область	Государственные, муниципальные (без учета организаций в ведении ФСИН); Заочная	            из стр. 11 - не прошли итоговую аттестацию / 12.0	0	0	0	0	0	0	0	0	0	0	0	0	0	2	2	10	0	0	3	13
Волгоградская область	Государственные, муниципальные (без учета организаций в ведении ФСИН); Заочная	"            из стр. 11 – лица с ограниченными возможностями здоровья,
            инвалиды, дети-инвалиды / 13.0"	0	0	0	0	0	0	0	0	0	0	0	0	0	1	1	0	0	0	0	0
Волгоградская область	Государственные, муниципальные (без учета организаций в ведении ФСИН); Заочная	         отчислено в виде меры дисциплинарного взыскания / 14.0	0	0	0	0	0	0	0	0	0	0	0	0	0	0	0	0	0	0	8	8
Волгоградская область	Государственные, муниципальные (без учета организаций в ведении ФСИН); Заочная	         отчислено из-за просрочки оплаты обучения / 15.0	0	0	0	0	0	0	0	0	0	0	0	0	0	69	69	0	0	0	74	74
Волгоградская область	Государственные, муниципальные (без учета организаций в ведении ФСИН); Заочная	"    в том числе:
    переведено на другие формы обучения данной
    организации на программы того же уровня / 7.0"	0	0	0	0	0	0	0	0	0	0	0	0	0	11	11	0	0	0	16	16
Волгоградская область	Государственные, муниципальные (без учета организаций в ведении ФСИН); Заочная	"    в том числе:
    переведено с других форм обучения данной
    образовательной организации с программ того же уровня / 2.0"	0	0	0	0	0	0	0	0	0	0	0	0	0	138	138	2	0	3	165	170
Волгоградская область	Государственные, муниципальные (без учета организаций в ведении ФСИН); Заочная	    восстановлены из числа ранее отчисленных / 4.0	0	0	0	0	0	0	0	0	0	0	0	0	0	64	64	0	0	0	85	85
Волгоградская область	Государственные, муниципальные (без учета организаций в ведении ФСИН); Заочная	    выбыло по другим причинам / 16.0	0	0	0	0	0	0	0	0	0	0	0	0	0	56	56	0	0	10	52	62
Волгоградская область	Государственные, муниципальные (без учета организаций в ведении ФСИН); Заочная	"    добровольно прекратили образовательные отношения
    (бросили учебу) / 10.0"	0	0	0	0	0	0	0	0	0	0	0	0	0	81	81	19	0	8	161	188
Волгоградская область	Государственные, муниципальные (без учета организаций в ведении ФСИН); Заочная	"    отчислено:
         по неуспеваемости / 11.0"	0	0	0	0	0	0	0	0	0	0	0	0	0	138	138	10	0	0	155	165
Волгоградская область	Государственные, муниципальные (без учета организаций в ведении ФСИН); Заочная	"    переведено в другие образовательные организации
    на программы того же уровня / 8.0"	0	0	0	0	0	0	0	0	0	0	0	0	0	3	3	0	0	0	5	5
Волгоградская область	Государственные, муниципальные (без учета организаций в ведении ФСИН); Заочная	"    переведено из других образовательных организаций 
    с программ того же уровня / 3.0"	0	0	0	0	0	0	0	0	0	0	0	0	0	13	13	1	0	0	30	31
Волгоградская область	Государственные, муниципальные (без учета организаций в ведении ФСИН); Заочная	    по болезни / 9.0	0	0	0	0	0	0	0	0	0	0	0	0	0	0	0	0	0	0	1	1
Волгоградская область	Государственные, муниципальные (без учета организаций в ведении ФСИН); Заочная	    прибыло по другим причинам / 5.0	0	0	0	0	0	0	0	0	0	0	0	0	0	4	4	0	0	0	78	78
Волгоградская область	Государственные, муниципальные (без учета организаций в ведении ФСИН); Заочная	Выбыло студентов - всего (сумма стр. 07-11, 13-15) / 6.0	0	0	0	0	0	0	0	0	0	0	0	0	0	358	358	29	0	18	472	519
Волгоградская область	Государственные, муниципальные (без учета организаций в ведении ФСИН); Заочная	Прибыло студентов - всего (сумма стр. 02-05) / 1.0	0	0	0	0	0	0	0	0	0	0	0	0	0	219	219	3	0	3	358	364
Волгоградская область	Государственные, муниципальные (без учета организаций в ведении ФСИН); Заочная	"Численность студентов на начало прошлого учебного года
(на 1 октября) / 17.0"	0	0	0	0	0	0	0	0	0	0	0	0	0	1300	1300	218	0	203	2805	3226
Волгоградская область	Государственные, муниципальные (без учета организаций в ведении ФСИН); Очная	            из стр. 11 - не прошли итоговую аттестацию / 12.0	13	0	0	0	13	0	0	0	0	0	10	0	1	6	17	0	0	0	1	1
Волгоградская область	Государственные, муниципальные (без учета организаций в ведении ФСИН); Очная	"            из стр. 11 – лица с ограниченными возможностями здоровья,
            инвалиды, дети-инвалиды / 13.0"	2	0	0	0	2	0	0	0	0	0	1	0	5	1	7	0	0	0	0	0
Волгоградская область	Государственные, муниципальные (без учета организаций в ведении ФСИН); Очная	         отчислено в виде меры дисциплинарного взыскания / 14.0	0	0	0	0	0	0	0	0	0	0	10	0	0	2	12	2	0	0	0	2
Волгоградская область	Государственные, муниципальные (без учета организаций в ведении ФСИН); Очная	         отчислено из-за просрочки оплаты обучения / 15.0	0	0	0	1	1	0	0	0	0	0	0	0	0	61	61	0	0	0	24	24
Волгоградская область	Государственные, муниципальные (без учета организаций в ведении ФСИН); Очная	"    в том числе:
    переведено на другие формы обучения данной
    организации на программы того же уровня / 7.0"	7	0	16	5	28	1	0	0	0	1	134	1	28	235	398	9	0	0	28	37
Волгоградская область	Государственные, муниципальные (без учета организаций в ведении ФСИН); Очная	"    в том числе:
    переведено с других форм обучения данной
    образовательной организации с программ того же уровня / 2.0"	22	0	0	0	22	1	0	0	0	1	62	0	6	68	136	1	0	0	23	24
Волгоградская область	Государственные, муниципальные (без учета организаций в ведении ФСИН); Очная	    восстановлены из числа ранее отчисленных / 4.0	25	0	0	7	32	0	0	0	0	0	119	0	12	125	256	7	0	0	37	44
Волгоградская область	Государственные, муниципальные (без учета организаций в ведении ФСИН); Очная	    выбыло по другим причинам / 16.0	126	0	0	7	133	1	0	0	0	1	214	114	15	157	500	12	0	5	29	46
Волгоградская область	Государственные, муниципальные (без учета организаций в ведении ФСИН); Очная	"    добровольно прекратили образовательные отношения
    (бросили учебу) / 10.0"	292	0	0	16	308	2	0	0	1	3	1225	7	63	671	1966	120	0	32	157	309
Волгоградская область	Государственные, муниципальные (без учета организаций в ведении ФСИН); Очная	"    отчислено:
         по неуспеваемости / 11.0"	169	0	0	18	187	1	0	0	0	1	272	0	38	164	474	14	0	13	56	83
Волгоградская область	Государственные, муниципальные (без учета организаций в ведении ФСИН); Очная	"    переведено в другие образовательные организации
    на программы того же уровня / 8.0"	47	0	0	4	51	0	0	0	0	0	243	1	10	165	419	8	0	1	15	24
Волгоградская область	Государственные, муниципальные (без учета организаций в ведении ФСИН); Очная	"    переведено из других образовательных организаций 
    с программ того же уровня / 3.0"	56	0	0	8	64	0	0	0	0	0	162	0	28	119	309	5	0	2	16	23
Волгоградская область	Государственные, муниципальные (без учета организаций в ведении ФСИН); Очная	    по болезни / 9.0	4	0	0	0	4	0	0	0	0	0	3	0	0	2	5	0	0	0	0	0
Волгоградская область	Государственные, муниципальные (без учета организаций в ведении ФСИН); Очная	    прибыло по другим причинам / 5.0	42	0	0	9	51	0	0	0	0	0	229	3	13	78	323	5	0	0	17	22
Волгоградская область	Государственные, муниципальные (без учета организаций в ведении ФСИН); Очная	Выбыло студентов - всего (сумма стр. 07-11, 13-15) / 6.0	645	0	16	51	712	5	0	0	1	6	2101	123	154	1457	3835	165	0	51	309	525
Волгоградская область	Государственные, муниципальные (без учета организаций в ведении ФСИН); Очная	Прибыло студентов - всего (сумма стр. 02-05) / 1.0	145	0	0	24	169	1	0	0	0	1	572	3	59	390	1024	18	0	2	93	113
Волгоградская область	Государственные, муниципальные (без учета организаций в ведении ФСИН); Очная	"Численность студентов на начало прошлого учебного года
(на 1 октября) / 17.0"	6975	0	120	463	7558	50	0	0	15	65	23090	113	2782	12520	38505	1750	38	478	2492	4758
Волгоградская область	Очно-заочная; Государственные, муниципальные (без учета организаций в ведении ФСИН)	            из стр. 11 - не прошли итоговую аттестацию / 12.0	0	0	0	0	0	0	0	0	0	0	0	0	0	0	0	0	0	0	0	0
Волгоградская область	Очно-заочная; Государственные, муниципальные (без учета организаций в ведении ФСИН)	"            из стр. 11 – лица с ограниченными возможностями здоровья,
            инвалиды, дети-инвалиды / 13.0"	0	0	0	0	0	0	0	0	0	0	0	0	0	0	0	0	0	0	0	0
Волгоградская область	Очно-заочная; Государственные, муниципальные (без учета организаций в ведении ФСИН)	         отчислено в виде меры дисциплинарного взыскания / 14.0	0	0	0	0	0	0	0	0	0	0	0	0	0	0	0	0	0	0	0	0
Волгоградская область	Очно-заочная; Государственные, муниципальные (без учета организаций в ведении ФСИН)	         отчислено из-за просрочки оплаты обучения / 15.0	0	0	0	0	0	0	0	0	0	0	0	0	0	0	0	0	0	0	22	22
Волгоградская область	Очно-заочная; Государственные, муниципальные (без учета организаций в ведении ФСИН)	"    в том числе:
    переведено на другие формы обучения данной
    организации на программы того же уровня / 7.0"	0	0	0	0	0	0	0	0	0	0	0	0	0	0	0	1	0	0	0	1
Волгоградская область	Очно-заочная; Государственные, муниципальные (без учета организаций в ведении ФСИН)	"    в том числе:
    переведено с других форм обучения данной
    образовательной организации с программ того же уровня / 2.0"	0	0	0	0	0	0	0	0	0	0	0	0	0	4	4	2	0	0	0	2
Волгоградская область	Очно-заочная; Государственные, муниципальные (без учета организаций в ведении ФСИН)	    восстановлены из числа ранее отчисленных / 4.0	0	0	0	0	0	0	0	0	0	0	0	0	0	0	0	3	0	0	3	6
Волгоградская область	Очно-заочная; Государственные, муниципальные (без учета организаций в ведении ФСИН)	    выбыло по другим причинам / 16.0	0	0	0	0	0	0	0	0	0	0	0	0	0	6	6	0	0	0	34	34
Волгоградская область	Очно-заочная; Государственные, муниципальные (без учета организаций в ведении ФСИН)	"    добровольно прекратили образовательные отношения
    (бросили учебу) / 10.0"	0	0	0	0	0	0	0	0	0	0	0	0	0	0	0	27	0	0	43	70
Волгоградская область	Очно-заочная; Государственные, муниципальные (без учета организаций в ведении ФСИН)	"    отчислено:
         по неуспеваемости / 11.0"	0	0	0	0	0	0	0	0	0	0	0	0	0	0	0	5	0	0	24	29
Волгоградская область	Очно-заочная; Государственные, муниципальные (без учета организаций в ведении ФСИН)	"    переведено в другие образовательные организации
    на программы того же уровня / 8.0"	0	0	0	0	0	0	0	0	0	0	0	0	0	0	0	1	0	0	1	2
Волгоградская область	Очно-заочная; Государственные, муниципальные (без учета организаций в ведении ФСИН)	"    переведено из других образовательных организаций 
    с программ того же уровня / 3.0"	0	0	0	0	0	0	0	0	0	0	0	0	0	0	0	1	0	0	22	23
Волгоградская область	Очно-заочная; Государственные, муниципальные (без учета организаций в ведении ФСИН)	    по болезни / 9.0	0	0	0	0	0	0	0	0	0	0	0	0	0	0	0	0	0	0	0	0
Волгоградская область	Очно-заочная; Государственные, муниципальные (без учета организаций в ведении ФСИН)	    прибыло по другим причинам / 5.0	0	0	0	0	0	0	0	0	0	0	0	0	0	0	0	0	0	0	16	16
Волгоградская область	Очно-заочная; Государственные, муниципальные (без учета организаций в ведении ФСИН)	Выбыло студентов - всего (сумма стр. 07-11, 13-15) / 6.0	0	0	0	0	0	0	0	0	0	0	0	0	0	6	6	34	0	0	124	158
Волгоградская область	Очно-заочная; Государственные, муниципальные (без учета организаций в ведении ФСИН)	Прибыло студентов - всего (сумма стр. 02-05) / 1.0	0	0	0	0	0	0	0	0	0	0	0	0	0	4	4	6	0	0	41	47
Волгоградская область	Очно-заочная; Государственные, муниципальные (без учета организаций в ведении ФСИН)	"Численность студентов на начало прошлого учебного года
(на 1 октября) / 17.0"	0	0	0	0	0	0	0	0	0	0	0	0	0	46	46	381	0	0	1623	2004
Волгоградская область	Частные; Заочная	            из стр. 11 - не прошли итоговую аттестацию / 12.0	0	0	0	0	0	0	0	0	0	0	0	0	0	0	0	0	0	0	0	0
Волгоградская область	Частные; Заочная	"            из стр. 11 – лица с ограниченными возможностями здоровья,
            инвалиды, дети-инвалиды / 13.0"	0	0	0	0	0	0	0	0	0	0	0	0	0	0	0	0	0	0	0	0
Волгоградская область	Частные; Заочная	         отчислено в виде меры дисциплинарного взыскания / 14.0	0	0	0	0	0	0	0	0	0	0	0	0	0	0	0	0	0	0	0	0
Волгоградская область	Частные; Заочная	         отчислено из-за просрочки оплаты обучения / 15.0	0	0	0	0	0	0	0	0	0	0	0	0	0	30	30	0	0	0	7	7
Волгоградская область	Частные; Заочная	"    в том числе:
    переведено на другие формы обучения данной
    организации на программы того же уровня / 7.0"	0	0	0	0	0	0	0	0	0	0	0	0	0	9	9	0	0	0	3	3
Волгоградская область	Частные; Заочная	"    в том числе:
    переведено с других форм обучения данной
    образовательной организации с программ того же уровня / 2.0"	0	0	0	0	0	0	0	0	0	0	0	0	0	61	61	0	0	0	24	24
Волгоградская область	Частные; Заочная	    восстановлены из числа ранее отчисленных / 4.0	0	0	0	0	0	0	0	0	0	0	0	0	0	7	7	0	0	0	20	20
Волгоградская область	Частные; Заочная	    выбыло по другим причинам / 16.0	0	0	0	0	0	0	0	0	0	0	0	0	0	5	5	0	0	0	12	12
Волгоградская область	Частные; Заочная	"    добровольно прекратили образовательные отношения
    (бросили учебу) / 10.0"	0	0	0	0	0	0	0	0	0	0	0	0	0	30	30	0	0	0	37	37
Волгоградская область	Частные; Заочная	"    отчислено:
         по неуспеваемости / 11.0"	0	0	0	0	0	0	0	0	0	0	0	0	0	11	11	0	0	0	21	21
Волгоградская область	Частные; Заочная	"    переведено в другие образовательные организации
    на программы того же уровня / 8.0"	0	0	0	0	0	0	0	0	0	0	0	0	0	19	19	0	0	0	15	15
Волгоградская область	Частные; Заочная	"    переведено из других образовательных организаций 
    с программ того же уровня / 3.0"	0	0	0	0	0	0	0	0	0	0	0	0	0	9	9	0	0	0	2	2
Волгоградская область	Частные; Заочная	    по болезни / 9.0	0	0	0	0	0	0	0	0	0	0	0	0	0	0	0	0	0	0	0	0
Волгоградская область	Частные; Заочная	    прибыло по другим причинам / 5.0	0	0	0	0	0	0	0	0	0	0	0	0	0	8	8	0	0	0	10	10
Волгоградская область	Частные; Заочная	Выбыло студентов - всего (сумма стр. 07-11, 13-15) / 6.0	0	0	0	0	0	0	0	0	0	0	0	0	0	104	104	0	0	0	95	95
Волгоградская область	Частные; Заочная	Прибыло студентов - всего (сумма стр. 02-05) / 1.0	0	0	0	0	0	0	0	0	0	0	0	0	0	85	85	0	0	0	56	56
Волгоградская область	Частные; Заочная	"Численность студентов на начало прошлого учебного года
(на 1 октября) / 17.0"	0	0	0	0	0	0	0	0	0	0	0	0	0	290	290	0	0	0	583	583
Волгоградская область	Частные; Очная	            из стр. 11 - не прошли итоговую аттестацию / 12.0	0	0	0	0	0	0	0	0	0	0	0	0	0	0	0	0	0	0	0	0
Волгоградская область	Частные; Очная	"            из стр. 11 – лица с ограниченными возможностями здоровья,
            инвалиды, дети-инвалиды / 13.0"	0	0	0	0	0	0	0	0	0	0	0	0	0	0	0	0	0	0	0	0
Волгоградская область	Частные; Очная	         отчислено в виде меры дисциплинарного взыскания / 14.0	0	0	0	0	0	0	0	0	0	0	0	0	0	0	0	0	0	0	0	0
Волгоградская область	Частные; Очная	         отчислено из-за просрочки оплаты обучения / 15.0	0	0	0	0	0	0	0	0	0	0	0	0	0	23	23	0	0	0	5	5
Волгоградская область	Частные; Очная	"    в том числе:
    переведено на другие формы обучения данной
    организации на программы того же уровня / 7.0"	0	0	0	0	0	0	0	0	0	0	0	0	0	85	85	0	0	0	47	47
Волгоградская область	Частные; Очная	"    в том числе:
    переведено с других форм обучения данной
    образовательной организации с программ того же уровня / 2.0"	0	0	0	0	0	0	0	0	0	0	0	0	0	10	10	0	0	0	7	7
Волгоградская область	Частные; Очная	    восстановлены из числа ранее отчисленных / 4.0	0	0	0	0	0	0	0	0	0	0	0	1	0	19	20	0	0	0	5	5
Волгоградская область	Частные; Очная	    выбыло по другим причинам / 16.0	0	0	0	0	0	0	0	0	0	0	0	0	0	23	23	0	0	0	3	3
Волгоградская область	Частные; Очная	"    добровольно прекратили образовательные отношения
    (бросили учебу) / 10.0"	0	0	0	0	0	0	0	0	0	0	0	4	0	112	116	0	0	0	35	35
Волгоградская область	Частные; Очная	"    отчислено:
         по неуспеваемости / 11.0"	0	0	0	0	0	0	0	0	0	0	0	2	0	24	26	0	0	0	9	9
Волгоградская область	Частные; Очная	"    переведено в другие образовательные организации
    на программы того же уровня / 8.0"	0	0	0	0	0	0	0	0	0	0	0	1	0	52	53	0	0	0	37	37
Волгоградская область	Частные; Очная	"    переведено из других образовательных организаций 
    с программ того же уровня / 3.0"	0	0	0	0	0	0	0	0	0	0	0	0	0	74	74	0	0	0	9	9
Волгоградская область	Частные; Очная	    по болезни / 9.0	0	0	0	0	0	0	0	0	0	0	0	0	0	1	1	0	0	0	1	1
Волгоградская область	Частные; Очная	    прибыло по другим причинам / 5.0	0	0	0	0	0	0	0	0	0	0	0	0	0	7	7	0	0	0	21	21
Волгоградская область	Частные; Очная	Выбыло студентов - всего (сумма стр. 07-11, 13-15) / 6.0	0	0	0	0	0	0	0	0	0	0	0	7	0	320	327	0	0	0	137	137
Волгоградская область	Частные; Очная	Прибыло студентов - всего (сумма стр. 02-05) / 1.0	0	0	0	0	0	0	0	0	0	0	0	1	0	110	111	0	0	0	42	42
Волгоградская область	Частные; Очная	"Численность студентов на начало прошлого учебного года
(на 1 октября) / 17.0"	0	0	0	0	0	0	0	0	0	0	0	123	0	3131	3254	0	0	0	748	748
Волгоградская область	Частные; Очно-заочная	            из стр. 11 - не прошли итоговую аттестацию / 12.0	0	0	0	0	0	0	0	0	0	0	0	0	0	0	0	0	0	0	0	0
Волгоградская область	Частные; Очно-заочная	"            из стр. 11 – лица с ограниченными возможностями здоровья,
            инвалиды, дети-инвалиды / 13.0"	0	0	0	0	0	0	0	0	0	0	0	0	0	0	0	0	0	0	0	0
Волгоградская область	Частные; Очно-заочная	         отчислено в виде меры дисциплинарного взыскания / 14.0	0	0	0	0	0	0	0	0	0	0	0	0	0	0	0	0	0	0	0	0
Волгоградская область	Частные; Очно-заочная	         отчислено из-за просрочки оплаты обучения / 15.0	0	0	0	0	0	0	0	0	0	0	0	0	0	0	0	0	0	0	0	0
Волгоградская область	Частные; Очно-заочная	"    в том числе:
    переведено на другие формы обучения данной
    организации на программы того же уровня / 7.0"	0	0	0	0	0	0	0	0	0	0	0	0	0	0	0	0	0	0	1	1
Волгоградская область	Частные; Очно-заочная	"    в том числе:
    переведено с других форм обучения данной
    образовательной организации с программ того же уровня / 2.0"	0	0	0	0	0	0	0	0	0	0	0	0	0	0	0	0	0	0	33	33
Волгоградская область	Частные; Очно-заочная	    восстановлены из числа ранее отчисленных / 4.0	0	0	0	0	0	0	0	0	0	0	0	0	0	0	0	0	0	0	0	0
Волгоградская область	Частные; Очно-заочная	    выбыло по другим причинам / 16.0	0	0	0	0	0	0	0	0	0	0	0	0	0	0	0	0	0	0	0	0
Волгоградская область	Частные; Очно-заочная	"    добровольно прекратили образовательные отношения
    (бросили учебу) / 10.0"	0	0	0	0	0	0	0	0	1	1	0	0	0	0	0	0	0	0	5	5
Волгоградская область	Частные; Очно-заочная	"    отчислено:
         по неуспеваемости / 11.0"	0	0	0	0	0	0	0	0	0	0	0	0	0	0	0	0	0	0	0	0
Волгоградская область	Частные; Очно-заочная	"    переведено в другие образовательные организации
    на программы того же уровня / 8.0"	0	0	0	0	0	0	0	0	0	0	0	0	0	0	0	0	0	0	0	0
Волгоградская область	Частные; Очно-заочная	"    переведено из других образовательных организаций 
    с программ того же уровня / 3.0"	0	0	0	0	0	0	0	0	0	0	0	0	0	0	0	0	0	0	0	0
Волгоградская область	Частные; Очно-заочная	    по болезни / 9.0	0	0	0	0	0	0	0	0	0	0	0	0	0	0	0	0	0	0	0	0
Волгоградская область	Частные; Очно-заочная	    прибыло по другим причинам / 5.0	0	0	0	0	0	0	0	0	2	2	0	0	0	0	0	0	0	0	0	0
Волгоградская область	Частные; Очно-заочная	Выбыло студентов - всего (сумма стр. 07-11, 13-15) / 6.0	0	0	0	0	0	0	0	0	1	1	0	0	0	0	0	0	0	0	6	6
Волгоградская область	Частные; Очно-заочная	Прибыло студентов - всего (сумма стр. 02-05) / 1.0	0	0	0	0	0	0	0	0	2	2	0	0	0	0	0	0	0	0	33	33
Волгоградская область	Частные; Очно-заочная	"Численность студентов на начало прошлого учебного года
(на 1 октября) / 17.0"	0	0	0	0	0	0	0	0	24	24	0	0	0	0	0	0	0	0	0	0
Вологодская область	Государственные, муниципальные (без учета организаций в ведении ФСИН); Заочная	            из стр. 11 - не прошли итоговую аттестацию / 12.0	0	0	0	0	0	0	0	0	0	0	0	0	0	0	0	0	0	0	0	0
Вологодская область	Государственные, муниципальные (без учета организаций в ведении ФСИН); Заочная	"            из стр. 11 – лица с ограниченными возможностями здоровья,
            инвалиды, дети-инвалиды / 13.0"	0	0	0	0	0	0	0	0	0	0	0	0	0	0	0	0	0	0	0	0
Вологодская область	Государственные, муниципальные (без учета организаций в ведении ФСИН); Заочная	         отчислено в виде меры дисциплинарного взыскания / 14.0	0	0	0	0	0	0	0	0	0	0	0	0	0	0	0	0	0	0	0	0
Вологодская область	Государственные, муниципальные (без учета организаций в ведении ФСИН); Заочная	         отчислено из-за просрочки оплаты обучения / 15.0	0	0	0	0	0	0	0	0	0	0	0	0	0	26	26	0	0	0	19	19
Вологодская область	Государственные, муниципальные (без учета организаций в ведении ФСИН); Заочная	"    в том числе:
    переведено на другие формы обучения данной
    организации на программы того же уровня / 7.0"	0	0	0	0	0	0	0	0	0	0	2	0	0	2	4	1	0	0	7	8
Вологодская область	Государственные, муниципальные (без учета организаций в ведении ФСИН); Заочная	"    в том числе:
    переведено с других форм обучения данной
    образовательной организации с программ того же уровня / 2.0"	0	0	0	0	0	0	0	0	0	0	23	0	0	6	29	1	0	7	1	9
Вологодская область	Государственные, муниципальные (без учета организаций в ведении ФСИН); Заочная	    восстановлены из числа ранее отчисленных / 4.0	0	0	0	0	0	0	0	0	0	0	2	0	0	24	26	2	0	0	15	17
Вологодская область	Государственные, муниципальные (без учета организаций в ведении ФСИН); Заочная	    выбыло по другим причинам / 16.0	0	0	0	0	0	0	0	0	0	0	7	0	0	1	8	32	0	7	9	48
Вологодская область	Государственные, муниципальные (без учета организаций в ведении ФСИН); Заочная	"    добровольно прекратили образовательные отношения
    (бросили учебу) / 10.0"	0	0	0	0	0	0	0	0	0	0	63	0	0	12	75	45	0	4	24	73
Вологодская область	Государственные, муниципальные (без учета организаций в ведении ФСИН); Заочная	"    отчислено:
         по неуспеваемости / 11.0"	0	0	0	0	0	0	0	0	0	0	19	0	0	22	41	22	0	6	30	58
Вологодская область	Государственные, муниципальные (без учета организаций в ведении ФСИН); Заочная	"    переведено в другие образовательные организации
    на программы того же уровня / 8.0"	0	0	0	0	0	0	0	0	0	0	2	0	0	0	2	0	0	0	0	0
Вологодская область	Государственные, муниципальные (без учета организаций в ведении ФСИН); Заочная	"    переведено из других образовательных организаций 
    с программ того же уровня / 3.0"	0	0	0	0	0	0	0	0	0	0	2	0	0	1	3	2	0	0	0	2
Вологодская область	Государственные, муниципальные (без учета организаций в ведении ФСИН); Заочная	    по болезни / 9.0	0	0	0	0	0	0	0	0	0	0	0	0	0	0	0	0	0	0	0	0
Вологодская область	Государственные, муниципальные (без учета организаций в ведении ФСИН); Заочная	    прибыло по другим причинам / 5.0	0	0	0	0	0	0	0	0	0	0	26	0	0	0	26	9	0	0	7	16
Вологодская область	Государственные, муниципальные (без учета организаций в ведении ФСИН); Заочная	Выбыло студентов - всего (сумма стр. 07-11, 13-15) / 6.0	0	0	0	0	0	0	0	0	0	0	93	0	0	63	156	100	0	17	89	206
Вологодская область	Государственные, муниципальные (без учета организаций в ведении ФСИН); Заочная	Прибыло студентов - всего (сумма стр. 02-05) / 1.0	0	0	0	0	0	0	0	0	0	0	53	0	0	31	84	14	0	7	23	44
Вологодская область	Государственные, муниципальные (без учета организаций в ведении ФСИН); Заочная	"Численность студентов на начало прошлого учебного года
(на 1 октября) / 17.0"	0	0	0	0	0	0	0	0	0	0	730	0	0	300	1030	642	0	165	434	1241
Вологодская область	Государственные, муниципальные (без учета организаций в ведении ФСИН); Очная	            из стр. 11 - не прошли итоговую аттестацию / 12.0	2	0	0	0	2	0	0	0	0	0	11	0	0	0	11	2	0	0	0	2
Вологодская область	Государственные, муниципальные (без учета организаций в ведении ФСИН); Очная	"            из стр. 11 – лица с ограниченными возможностями здоровья,
            инвалиды, дети-инвалиды / 13.0"	0	0	0	0	0	0	0	0	0	0	2	0	0	0	2	0	0	0	0	0
Вологодская область	Государственные, муниципальные (без учета организаций в ведении ФСИН); Очная	         отчислено в виде меры дисциплинарного взыскания / 14.0	11	0	0	0	11	0	0	0	0	0	10	0	2	2	14	1	0	0	0	1
Вологодская область	Государственные, муниципальные (без учета организаций в ведении ФСИН); Очная	         отчислено из-за просрочки оплаты обучения / 15.0	0	0	0	2	2	0	0	0	0	0	0	0	0	19	19	0	0	0	4	4
Вологодская область	Государственные, муниципальные (без учета организаций в ведении ФСИН); Очная	"    в том числе:
    переведено на другие формы обучения данной
    организации на программы того же уровня / 7.0"	13	0	0	3	16	0	0	0	0	0	46	0	0	35	81	6	0	0	8	14
Вологодская область	Государственные, муниципальные (без учета организаций в ведении ФСИН); Очная	"    в том числе:
    переведено с других форм обучения данной
    образовательной организации с программ того же уровня / 2.0"	15	0	1	0	16	0	0	0	0	0	36	0	7	3	46	10	0	0	1	11
Вологодская область	Государственные, муниципальные (без учета организаций в ведении ФСИН); Очная	    восстановлены из числа ранее отчисленных / 4.0	18	0	0	1	19	0	0	0	0	0	43	0	4	10	57	3	0	0	4	7
Вологодская область	Государственные, муниципальные (без учета организаций в ведении ФСИН); Очная	    выбыло по другим причинам / 16.0	67	0	0	8	75	0	0	0	0	0	166	0	3	107	276	22	0	0	9	31
Вологодская область	Государственные, муниципальные (без учета организаций в ведении ФСИН); Очная	"    добровольно прекратили образовательные отношения
    (бросили учебу) / 10.0"	291	0	3	18	312	0	0	0	0	0	649	0	59	121	829	84	0	3	10	97
Вологодская область	Государственные, муниципальные (без учета организаций в ведении ФСИН); Очная	"    отчислено:
         по неуспеваемости / 11.0"	86	0	0	2	88	0	0	0	0	0	171	0	25	19	215	11	0	0	3	14
Вологодская область	Государственные, муниципальные (без учета организаций в ведении ФСИН); Очная	"    переведено в другие образовательные организации
    на программы того же уровня / 8.0"	56	0	0	1	57	0	0	0	0	0	147	0	17	41	205	8	0	0	2	10
Вологодская область	Государственные, муниципальные (без учета организаций в ведении ФСИН); Очная	"    переведено из других образовательных организаций 
    с программ того же уровня / 3.0"	67	0	0	1	68	0	0	0	0	0	136	0	11	19	166	3	0	0	3	6
Вологодская область	Государственные, муниципальные (без учета организаций в ведении ФСИН); Очная	    по болезни / 9.0	0	0	0	0	0	0	0	0	0	0	0	0	0	0	0	1	0	0	0	1
Вологодская область	Государственные, муниципальные (без учета организаций в ведении ФСИН); Очная	    прибыло по другим причинам / 5.0	33	0	0	4	37	0	0	0	0	0	128	0	5	25	158	12	0	0	6	18
Вологодская область	Государственные, муниципальные (без учета организаций в ведении ФСИН); Очная	Выбыло студентов - всего (сумма стр. 07-11, 13-15) / 6.0	524	0	3	34	561	0	0	0	0	0	1189	0	106	344	1639	133	0	3	36	172
Вологодская область	Государственные, муниципальные (без учета организаций в ведении ФСИН); Очная	Прибыло студентов - всего (сумма стр. 02-05) / 1.0	133	0	1	6	140	0	0	0	0	0	343	0	27	57	427	28	0	0	14	42
Вологодская область	Государственные, муниципальные (без учета организаций в ведении ФСИН); Очная	"Численность студентов на начало прошлого учебного года
(на 1 октября) / 17.0"	5598	0	79	270	5947	0	0	0	0	0	16340	0	1746	2280	20366	1197	0	20	274	1491
Вологодская область	Очно-заочная; Государственные, муниципальные (без учета организаций в ведении ФСИН)	            из стр. 11 - не прошли итоговую аттестацию / 12.0	0	0	0	0	0	0	0	0	0	0	0	0	0	0	0	0	0	0	0	0
Вологодская область	Очно-заочная; Государственные, муниципальные (без учета организаций в ведении ФСИН)	"            из стр. 11 – лица с ограниченными возможностями здоровья,
            инвалиды, дети-инвалиды / 13.0"	0	0	0	0	0	0	0	0	0	0	0	0	0	0	0	0	0	0	0	0
Вологодская область	Очно-заочная; Государственные, муниципальные (без учета организаций в ведении ФСИН)	         отчислено в виде меры дисциплинарного взыскания / 14.0	0	0	0	0	0	0	0	0	0	0	0	0	0	0	0	0	0	0	0	0
Вологодская область	Очно-заочная; Государственные, муниципальные (без учета организаций в ведении ФСИН)	         отчислено из-за просрочки оплаты обучения / 15.0	0	0	0	0	0	0	0	0	0	0	0	0	0	0	0	0	0	0	12	12
Вологодская область	Очно-заочная; Государственные, муниципальные (без учета организаций в ведении ФСИН)	"    в том числе:
    переведено на другие формы обучения данной
    организации на программы того же уровня / 7.0"	0	0	0	0	0	0	0	0	0	0	0	0	0	0	0	0	0	0	2	2
Вологодская область	Очно-заочная; Государственные, муниципальные (без учета организаций в ведении ФСИН)	"    в том числе:
    переведено с других форм обучения данной
    образовательной организации с программ того же уровня / 2.0"	0	0	0	0	0	0	0	0	0	0	0	0	0	0	0	3	0	0	2	5
Вологодская область	Очно-заочная; Государственные, муниципальные (без учета организаций в ведении ФСИН)	    восстановлены из числа ранее отчисленных / 4.0	0	0	0	0	0	0	0	0	0	0	0	0	0	0	0	0	0	0	4	4
Вологодская область	Очно-заочная; Государственные, муниципальные (без учета организаций в ведении ФСИН)	    выбыло по другим причинам / 16.0	0	0	0	0	0	0	0	0	0	0	0	0	0	0	0	1	0	0	1	2
Вологодская область	Очно-заочная; Государственные, муниципальные (без учета организаций в ведении ФСИН)	"    добровольно прекратили образовательные отношения
    (бросили учебу) / 10.0"	0	0	0	0	0	0	0	0	0	0	0	0	0	0	0	14	0	0	15	29
Вологодская область	Очно-заочная; Государственные, муниципальные (без учета организаций в ведении ФСИН)	"    отчислено:
         по неуспеваемости / 11.0"	0	0	0	0	0	0	0	0	0	0	0	0	0	0	0	6	0	0	2	8
Вологодская область	Очно-заочная; Государственные, муниципальные (без учета организаций в ведении ФСИН)	"    переведено в другие образовательные организации
    на программы того же уровня / 8.0"	0	0	0	0	0	0	0	0	0	0	0	0	0	0	0	0	0	0	0	0
Вологодская область	Очно-заочная; Государственные, муниципальные (без учета организаций в ведении ФСИН)	"    переведено из других образовательных организаций 
    с программ того же уровня / 3.0"	0	0	0	0	0	0	0	0	0	0	0	0	0	0	0	0	0	0	0	0
Вологодская область	Очно-заочная; Государственные, муниципальные (без учета организаций в ведении ФСИН)	    по болезни / 9.0	0	0	0	0	0	0	0	0	0	0	0	0	0	0	0	0	0	0	0	0
Вологодская область	Очно-заочная; Государственные, муниципальные (без учета организаций в ведении ФСИН)	    прибыло по другим причинам / 5.0	0	0	0	0	0	0	0	0	3	3	0	0	0	0	0	1	0	0	15	16
Вологодская область	Очно-заочная; Государственные, муниципальные (без учета организаций в ведении ФСИН)	Выбыло студентов - всего (сумма стр. 07-11, 13-15) / 6.0	0	0	0	0	0	0	0	0	0	0	0	0	0	0	0	21	0	0	32	53
Вологодская область	Очно-заочная; Государственные, муниципальные (без учета организаций в ведении ФСИН)	Прибыло студентов - всего (сумма стр. 02-05) / 1.0	0	0	0	0	0	0	0	0	3	3	0	0	0	0	0	4	0	0	21	25
Вологодская область	Очно-заочная; Государственные, муниципальные (без учета организаций в ведении ФСИН)	"Численность студентов на начало прошлого учебного года
(на 1 октября) / 17.0"	0	0	0	0	0	25	0	0	2	27	0	0	0	0	0	215	0	0	263	478
Вологодская область	Частные; Заочная	            из стр. 11 - не прошли итоговую аттестацию / 12.0	0	0	0	0	0	0	0	0	0	0	0	0	0	0	0	0	0	0	0	0
Вологодская область	Частные; Заочная	"            из стр. 11 – лица с ограниченными возможностями здоровья,
            инвалиды, дети-инвалиды / 13.0"	0	0	0	0	0	0	0	0	0	0	0	0	0	0	0	0	0	0	0	0
Вологодская область	Частные; Заочная	         отчислено в виде меры дисциплинарного взыскания / 14.0	0	0	0	0	0	0	0	0	0	0	0	0	0	0	0	0	0	0	0	0
Вологодская область	Частные; Заочная	         отчислено из-за просрочки оплаты обучения / 15.0	0	0	0	0	0	0	0	0	0	0	0	0	0	3	3	0	0	0	0	0
Вологодская область	Частные; Заочная	"    в том числе:
    переведено на другие формы обучения данной
    организации на программы того же уровня / 7.0"	0	0	0	0	0	0	0	0	0	0	0	0	0	4	4	0	0	0	1	1
Вологодская область	Частные; Заочная	"    в том числе:
    переведено с других форм обучения данной
    образовательной организации с программ того же уровня / 2.0"	0	0	0	0	0	0	0	0	0	0	0	0	0	15	15	0	0	0	4	4
Вологодская область	Частные; Заочная	    восстановлены из числа ранее отчисленных / 4.0	0	0	0	0	0	0	0	0	0	0	0	0	0	11	11	0	0	0	4	4
Вологодская область	Частные; Заочная	    выбыло по другим причинам / 16.0	0	0	0	0	0	0	0	0	0	0	0	0	0	1	1	0	0	0	4	4
Вологодская область	Частные; Заочная	"    добровольно прекратили образовательные отношения
    (бросили учебу) / 10.0"	0	0	0	0	0	0	0	0	0	0	0	0	0	35	35	0	0	0	15	15
Вологодская область	Частные; Заочная	"    отчислено:
         по неуспеваемости / 11.0"	0	0	0	0	0	0	0	0	0	0	0	0	0	12	12	0	0	0	3	3
Вологодская область	Частные; Заочная	"    переведено в другие образовательные организации
    на программы того же уровня / 8.0"	0	0	0	0	0	0	0	0	0	0	0	0	0	1	1	0	0	0	0	0
Вологодская область	Частные; Заочная	"    переведено из других образовательных организаций 
    с программ того же уровня / 3.0"	0	0	0	0	0	0	0	0	0	0	0	0	0	6	6	0	0	0	0	0
Вологодская область	Частные; Заочная	    по болезни / 9.0	0	0	0	0	0	0	0	0	0	0	0	0	0	0	0	0	0	0	0	0
Вологодская область	Частные; Заочная	    прибыло по другим причинам / 5.0	0	0	0	0	0	0	0	0	0	0	0	0	0	7	7	0	0	0	6	6
Вологодская область	Частные; Заочная	Выбыло студентов - всего (сумма стр. 07-11, 13-15) / 6.0	0	0	0	0	0	0	0	0	0	0	0	0	0	56	56	0	0	0	23	23
Вологодская область	Частные; Заочная	Прибыло студентов - всего (сумма стр. 02-05) / 1.0	0	0	0	0	0	0	0	0	0	0	0	0	0	39	39	0	0	0	14	14
Вологодская область	Частные; Заочная	"Численность студентов на начало прошлого учебного года
(на 1 октября) / 17.0"	0	0	0	0	0	0	0	0	0	0	0	0	0	192	192	0	0	0	105	105
Вологодская область	Частные; Очная	            из стр. 11 - не прошли итоговую аттестацию / 12.0	0	0	0	0	0	0	0	0	0	0	0	0	0	0	0	0	0	0	0	0
Вологодская область	Частные; Очная	"            из стр. 11 – лица с ограниченными возможностями здоровья,
            инвалиды, дети-инвалиды / 13.0"	0	0	0	0	0	0	0	0	0	0	0	0	0	0	0	0	0	0	0	0
Вологодская область	Частные; Очная	         отчислено в виде меры дисциплинарного взыскания / 14.0	0	0	0	0	0	0	0	0	0	0	0	0	0	0	0	0	0	0	0	0
Вологодская область	Частные; Очная	         отчислено из-за просрочки оплаты обучения / 15.0	0	0	0	0	0	0	0	0	0	0	0	0	0	4	4	0	0	0	0	0
Вологодская область	Частные; Очная	"    в том числе:
    переведено на другие формы обучения данной
    организации на программы того же уровня / 7.0"	0	0	0	0	0	0	0	0	0	0	3	0	0	13	16	0	0	0	3	3
Вологодская область	Частные; Очная	"    в том числе:
    переведено с других форм обучения данной
    образовательной организации с программ того же уровня / 2.0"	0	0	0	0	0	0	0	0	0	0	0	0	0	4	4	0	0	0	1	1
Вологодская область	Частные; Очная	    восстановлены из числа ранее отчисленных / 4.0	0	0	0	0	0	0	0	0	0	0	0	0	0	6	6	0	0	0	1	1
Вологодская область	Частные; Очная	    выбыло по другим причинам / 16.0	0	0	0	0	0	0	0	0	0	0	0	0	0	10	10	0	0	0	1	1
Вологодская область	Частные; Очная	"    добровольно прекратили образовательные отношения
    (бросили учебу) / 10.0"	0	0	0	0	0	0	0	0	0	0	17	0	0	25	42	0	0	0	6	6
Вологодская область	Частные; Очная	"    отчислено:
         по неуспеваемости / 11.0"	0	0	0	0	0	0	0	0	0	0	1	0	0	6	7	0	0	0	0	0
Вологодская область	Частные; Очная	"    переведено в другие образовательные организации
    на программы того же уровня / 8.0"	0	0	0	0	0	0	0	0	0	0	1	0	0	13	14	0	0	0	0	0
Вологодская область	Частные; Очная	"    переведено из других образовательных организаций 
    с программ того же уровня / 3.0"	0	0	0	0	0	0	0	0	0	0	0	0	0	6	6	0	0	0	0	0
Вологодская область	Частные; Очная	    по болезни / 9.0	0	0	0	0	0	0	0	0	0	0	0	0	0	0	0	0	0	0	0	0
Вологодская область	Частные; Очная	    прибыло по другим причинам / 5.0	0	0	0	0	0	0	0	0	0	0	0	0	0	0	0	0	0	0	1	1
Вологодская область	Частные; Очная	Выбыло студентов - всего (сумма стр. 07-11, 13-15) / 6.0	0	0	0	0	0	0	0	0	0	0	22	0	0	71	93	0	0	0	10	10
Вологодская область	Частные; Очная	Прибыло студентов - всего (сумма стр. 02-05) / 1.0	0	0	0	0	0	0	0	0	0	0	0	0	0	16	16	0	0	0	3	3
Вологодская область	Частные; Очная	"Численность студентов на начало прошлого учебного года
(на 1 октября) / 17.0"	0	0	0	0	0	0	0	0	0	0	216	0	0	648	864	0	0	0	106	106
Воронежская область	Государственные, муниципальные (без учета организаций в ведении ФСИН); Заочная	            из стр. 11 - не прошли итоговую аттестацию / 12.0	0	0	0	0	0	0	0	0	0	0	0	0	0	0	0	0	0	0	1	1
Воронежская область	Государственные, муниципальные (без учета организаций в ведении ФСИН); Заочная	"            из стр. 11 – лица с ограниченными возможностями здоровья,
            инвалиды, дети-инвалиды / 13.0"	0	0	0	0	0	0	0	0	0	0	0	0	0	0	0	0	0	0	0	0
Воронежская область	Государственные, муниципальные (без учета организаций в ведении ФСИН); Заочная	         отчислено в виде меры дисциплинарного взыскания / 14.0	0	0	0	0	0	0	0	0	0	0	0	0	0	0	0	0	0	0	0	0
Воронежская область	Государственные, муниципальные (без учета организаций в ведении ФСИН); Заочная	         отчислено из-за просрочки оплаты обучения / 15.0	0	0	0	0	0	0	0	0	0	0	0	0	0	37	37	0	0	0	51	51
Воронежская область	Государственные, муниципальные (без учета организаций в ведении ФСИН); Заочная	"    в том числе:
    переведено на другие формы обучения данной
    организации на программы того же уровня / 7.0"	0	0	0	0	0	0	0	0	0	0	0	0	0	13	13	0	0	4	18	22
Воронежская область	Государственные, муниципальные (без учета организаций в ведении ФСИН); Заочная	"    в том числе:
    переведено с других форм обучения данной
    образовательной организации с программ того же уровня / 2.0"	0	0	0	0	0	0	0	0	0	0	0	0	2	57	59	0	0	3	60	63
Воронежская область	Государственные, муниципальные (без учета организаций в ведении ФСИН); Заочная	    восстановлены из числа ранее отчисленных / 4.0	0	0	0	0	0	0	0	0	0	0	0	0	0	9	9	0	0	1	22	23
Воронежская область	Государственные, муниципальные (без учета организаций в ведении ФСИН); Заочная	    выбыло по другим причинам / 16.0	0	0	0	0	0	0	0	0	0	0	0	0	0	12	12	0	0	3	44	47
Воронежская область	Государственные, муниципальные (без учета организаций в ведении ФСИН); Заочная	"    добровольно прекратили образовательные отношения
    (бросили учебу) / 10.0"	0	0	0	0	0	0	0	0	0	0	0	0	0	51	51	8	0	10	68	86
Воронежская область	Государственные, муниципальные (без учета организаций в ведении ФСИН); Заочная	"    отчислено:
         по неуспеваемости / 11.0"	0	0	0	0	0	0	0	0	0	0	0	0	0	11	11	0	0	0	21	21
Воронежская область	Государственные, муниципальные (без учета организаций в ведении ФСИН); Заочная	"    переведено в другие образовательные организации
    на программы того же уровня / 8.0"	0	0	0	0	0	0	0	0	0	0	0	0	0	2	2	0	0	1	2	3
Воронежская область	Государственные, муниципальные (без учета организаций в ведении ФСИН); Заочная	"    переведено из других образовательных организаций 
    с программ того же уровня / 3.0"	0	0	0	0	0	0	0	0	0	0	0	0	0	14	14	0	0	2	16	18
Воронежская область	Государственные, муниципальные (без учета организаций в ведении ФСИН); Заочная	    по болезни / 9.0	0	0	0	0	0	0	0	0	0	0	0	0	1	0	1	0	0	12	6	18
Воронежская область	Государственные, муниципальные (без учета организаций в ведении ФСИН); Заочная	    прибыло по другим причинам / 5.0	0	0	0	0	0	0	0	0	0	0	0	0	0	29	29	0	0	3	21	24
Воронежская область	Государственные, муниципальные (без учета организаций в ведении ФСИН); Заочная	Выбыло студентов - всего (сумма стр. 07-11, 13-15) / 6.0	0	0	0	0	0	0	0	0	0	0	0	0	1	126	127	8	0	30	210	248
Воронежская область	Государственные, муниципальные (без учета организаций в ведении ФСИН); Заочная	Прибыло студентов - всего (сумма стр. 02-05) / 1.0	0	0	0	0	0	0	0	0	0	0	0	0	2	109	111	0	0	9	119	128
Воронежская область	Государственные, муниципальные (без учета организаций в ведении ФСИН); Заочная	"Численность студентов на начало прошлого учебного года
(на 1 октября) / 17.0"	0	0	0	0	0	0	0	0	0	0	0	0	2	512	514	94	0	223	1006	1323
Воронежская область	Государственные, муниципальные (без учета организаций в ведении ФСИН); Очная	            из стр. 11 - не прошли итоговую аттестацию / 12.0	0	0	0	0	0	0	0	0	1	1	6	0	0	2	8	0	0	0	0	0
Воронежская область	Государственные, муниципальные (без учета организаций в ведении ФСИН); Очная	"            из стр. 11 – лица с ограниченными возможностями здоровья,
            инвалиды, дети-инвалиды / 13.0"	0	0	0	0	0	0	0	0	0	0	2	0	0	1	3	0	0	0	0	0
Воронежская область	Государственные, муниципальные (без учета организаций в ведении ФСИН); Очная	         отчислено в виде меры дисциплинарного взыскания / 14.0	0	0	0	0	0	0	0	0	0	0	4	0	0	0	4	1	0	0	0	1
Воронежская область	Государственные, муниципальные (без учета организаций в ведении ФСИН); Очная	         отчислено из-за просрочки оплаты обучения / 15.0	0	0	0	1	1	0	0	0	38	38	0	0	0	50	50	0	0	0	16	16
Воронежская область	Государственные, муниципальные (без учета организаций в ведении ФСИН); Очная	"    в том числе:
    переведено на другие формы обучения данной
    организации на программы того же уровня / 7.0"	94	0	0	0	94	0	0	0	7	7	97	0	11	140	248	31	0	0	18	49
Воронежская область	Государственные, муниципальные (без учета организаций в ведении ФСИН); Очная	"    в том числе:
    переведено с других форм обучения данной
    образовательной организации с программ того же уровня / 2.0"	24	0	0	2	26	0	0	0	15	15	45	0	22	19	86	12	0	2	23	37
Воронежская область	Государственные, муниципальные (без учета организаций в ведении ФСИН); Очная	    восстановлены из числа ранее отчисленных / 4.0	22	0	0	0	22	0	0	0	0	0	101	0	25	95	221	23	0	0	37	60
Воронежская область	Государственные, муниципальные (без учета организаций в ведении ФСИН); Очная	    выбыло по другим причинам / 16.0	222	0	0	0	222	7	0	0	5	12	159	0	15	85	259	13	0	0	19	32
Воронежская область	Государственные, муниципальные (без учета организаций в ведении ФСИН); Очная	"    добровольно прекратили образовательные отношения
    (бросили учебу) / 10.0"	315	0	0	3	318	8	0	0	13	21	1077	0	203	404	1684	108	0	5	120	233
Воронежская область	Государственные, муниципальные (без учета организаций в ведении ФСИН); Очная	"    отчислено:
         по неуспеваемости / 11.0"	71	0	0	0	71	4	0	0	8	12	176	0	39	256	471	33	0	7	92	132
Воронежская область	Государственные, муниципальные (без учета организаций в ведении ФСИН); Очная	"    переведено в другие образовательные организации
    на программы того же уровня / 8.0"	24	0	0	0	24	0	0	0	9	9	238	0	45	129	412	6	0	0	20	26
Воронежская область	Государственные, муниципальные (без учета организаций в ведении ФСИН); Очная	"    переведено из других образовательных организаций 
    с программ того же уровня / 3.0"	86	0	0	2	88	0	0	0	2	2	150	0	33	77	260	26	0	1	16	43
Воронежская область	Государственные, муниципальные (без учета организаций в ведении ФСИН); Очная	    по болезни / 9.0	5	0	0	0	5	0	0	0	11	11	0	0	0	6	6	0	0	0	0	0
Воронежская область	Государственные, муниципальные (без учета организаций в ведении ФСИН); Очная	    прибыло по другим причинам / 5.0	70	0	0	0	70	9	0	0	6	15	179	0	28	48	255	5	0	11	13	29
Воронежская область	Государственные, муниципальные (без учета организаций в ведении ФСИН); Очная	Выбыло студентов - всего (сумма стр. 07-11, 13-15) / 6.0	731	0	0	4	735	19	0	0	91	110	1751	0	313	1070	3134	192	0	12	285	489
Воронежская область	Государственные, муниципальные (без учета организаций в ведении ФСИН); Очная	Прибыло студентов - всего (сумма стр. 02-05) / 1.0	202	0	0	4	206	9	0	0	23	32	475	0	108	239	822	66	0	14	89	169
Воронежская область	Государственные, муниципальные (без учета организаций в ведении ФСИН); Очная	"Численность студентов на начало прошлого учебного года
(на 1 октября) / 17.0"	6251	0	0	140	6391	112	0	0	561	673	18894	0	5507	9354	33755	1608	0	166	1927	3701
Воронежская область	Очно-заочная; Государственные, муниципальные (без учета организаций в ведении ФСИН)	            из стр. 11 - не прошли итоговую аттестацию / 12.0	0	0	0	0	0	0	0	0	1	1	0	0	0	0	0	0	0	0	0	0
Воронежская область	Очно-заочная; Государственные, муниципальные (без учета организаций в ведении ФСИН)	"            из стр. 11 – лица с ограниченными возможностями здоровья,
            инвалиды, дети-инвалиды / 13.0"	0	0	0	0	0	0	0	0	0	0	0	0	0	0	0	0	0	0	0	0
Воронежская область	Очно-заочная; Государственные, муниципальные (без учета организаций в ведении ФСИН)	         отчислено в виде меры дисциплинарного взыскания / 14.0	0	0	0	0	0	0	0	0	0	0	0	0	0	0	0	0	0	0	0	0
Воронежская область	Очно-заочная; Государственные, муниципальные (без учета организаций в ведении ФСИН)	         отчислено из-за просрочки оплаты обучения / 15.0	0	0	0	0	0	0	0	0	38	38	0	0	0	0	0	0	0	0	3	3
Воронежская область	Очно-заочная; Государственные, муниципальные (без учета организаций в ведении ФСИН)	"    в том числе:
    переведено на другие формы обучения данной
    организации на программы того же уровня / 7.0"	0	0	0	0	0	0	0	0	15	15	0	0	0	0	0	0	0	0	0	0
Воронежская область	Очно-заочная; Государственные, муниципальные (без учета организаций в ведении ФСИН)	"    в том числе:
    переведено с других форм обучения данной
    образовательной организации с программ того же уровня / 2.0"	0	0	0	0	0	0	0	0	5	5	0	0	0	0	0	0	0	0	0	0
Воронежская область	Очно-заочная; Государственные, муниципальные (без учета организаций в ведении ФСИН)	    восстановлены из числа ранее отчисленных / 4.0	0	0	0	0	0	0	0	0	5	5	0	0	0	0	0	1	0	0	0	1
Воронежская область	Очно-заочная; Государственные, муниципальные (без учета организаций в ведении ФСИН)	    выбыло по другим причинам / 16.0	0	0	0	0	0	0	0	0	20	20	0	0	0	0	0	0	0	0	6	6
Воронежская область	Очно-заочная; Государственные, муниципальные (без учета организаций в ведении ФСИН)	"    добровольно прекратили образовательные отношения
    (бросили учебу) / 10.0"	0	0	0	0	0	0	0	0	6	6	0	0	0	0	0	3	0	0	3	6
Воронежская область	Очно-заочная; Государственные, муниципальные (без учета организаций в ведении ФСИН)	"    отчислено:
         по неуспеваемости / 11.0"	0	0	0	0	0	0	0	0	34	34	0	0	0	0	0	7	0	0	1	8
Воронежская область	Очно-заочная; Государственные, муниципальные (без учета организаций в ведении ФСИН)	"    переведено в другие образовательные организации
    на программы того же уровня / 8.0"	0	0	0	0	0	0	0	0	0	0	0	0	0	0	0	0	0	0	2	2
Воронежская область	Очно-заочная; Государственные, муниципальные (без учета организаций в ведении ФСИН)	"    переведено из других образовательных организаций 
    с программ того же уровня / 3.0"	0	0	0	0	0	0	0	0	0	0	0	0	0	0	0	0	0	0	0	0
Воронежская область	Очно-заочная; Государственные, муниципальные (без учета организаций в ведении ФСИН)	    по болезни / 9.0	0	0	0	0	0	0	0	0	0	0	0	0	0	0	0	0	0	0	0	0
Воронежская область	Очно-заочная; Государственные, муниципальные (без учета организаций в ведении ФСИН)	    прибыло по другим причинам / 5.0	0	0	0	0	0	0	0	0	1	1	0	0	0	0	0	0	0	0	0	0
Воронежская область	Очно-заочная; Государственные, муниципальные (без учета организаций в ведении ФСИН)	Выбыло студентов - всего (сумма стр. 07-11, 13-15) / 6.0	0	0	0	0	0	0	0	0	113	113	0	0	0	0	0	10	0	0	15	25
Воронежская область	Очно-заочная; Государственные, муниципальные (без учета организаций в ведении ФСИН)	Прибыло студентов - всего (сумма стр. 02-05) / 1.0	0	0	0	0	0	0	0	0	11	11	0	0	0	0	0	1	0	0	0	1
Воронежская область	Очно-заочная; Государственные, муниципальные (без учета организаций в ведении ФСИН)	"Численность студентов на начало прошлого учебного года
(на 1 октября) / 17.0"	0	0	0	0	0	0	0	0	171	171	0	0	0	0	0	39	0	0	118	157
Воронежская область	Частные; Заочная	            из стр. 11 - не прошли итоговую аттестацию / 12.0	0	0	0	0	0	0	0	0	0	0	0	0	0	0	0	0	0	0	0	0
Воронежская область	Частные; Заочная	"            из стр. 11 – лица с ограниченными возможностями здоровья,
            инвалиды, дети-инвалиды / 13.0"	0	0	0	0	0	0	0	0	0	0	0	0	0	0	0	0	0	0	0	0
Воронежская область	Частные; Заочная	         отчислено в виде меры дисциплинарного взыскания / 14.0	0	0	0	0	0	0	0	0	0	0	0	0	0	0	0	0	0	0	0	0
Воронежская область	Частные; Заочная	         отчислено из-за просрочки оплаты обучения / 15.0	0	0	0	0	0	0	0	0	0	0	0	0	0	83	83	0	0	0	37	37
Воронежская область	Частные; Заочная	"    в том числе:
    переведено на другие формы обучения данной
    организации на программы того же уровня / 7.0"	0	0	0	0	0	0	0	0	0	0	0	0	0	17	17	0	0	0	6	6
Воронежская область	Частные; Заочная	"    в том числе:
    переведено с других форм обучения данной
    образовательной организации с программ того же уровня / 2.0"	0	0	0	0	0	0	0	0	0	0	0	0	0	48	48	0	0	0	8	8
Воронежская область	Частные; Заочная	    восстановлены из числа ранее отчисленных / 4.0	0	0	0	0	0	0	0	0	0	0	0	0	0	17	17	0	0	0	9	9
Воронежская область	Частные; Заочная	    выбыло по другим причинам / 16.0	0	0	0	0	0	0	0	0	0	0	0	0	0	2	2	0	0	0	16	16
Воронежская область	Частные; Заочная	"    добровольно прекратили образовательные отношения
    (бросили учебу) / 10.0"	0	0	0	0	0	0	0	0	0	0	0	0	0	27	27	0	0	0	5	5
Воронежская область	Частные; Заочная	"    отчислено:
         по неуспеваемости / 11.0"	0	0	0	0	0	0	0	0	0	0	0	0	0	27	27	0	0	0	11	11
Воронежская область	Частные; Заочная	"    переведено в другие образовательные организации
    на программы того же уровня / 8.0"	0	0	0	0	0	0	0	0	0	0	0	0	0	6	6	0	0	0	1	1
Воронежская область	Частные; Заочная	"    переведено из других образовательных организаций 
    с программ того же уровня / 3.0"	0	0	0	0	0	0	0	0	0	0	0	0	0	16	16	0	0	0	7	7
Воронежская область	Частные; Заочная	    по болезни / 9.0	0	0	0	0	0	0	0	0	0	0	0	0	0	0	0	0	0	0	0	0
Воронежская область	Частные; Заочная	    прибыло по другим причинам / 5.0	0	0	0	0	0	0	0	0	0	0	0	0	0	8	8	0	0	0	21	21
Воронежская область	Частные; Заочная	Выбыло студентов - всего (сумма стр. 07-11, 13-15) / 6.0	0	0	0	0	0	0	0	0	0	0	0	0	0	162	162	0	0	0	76	76
Воронежская область	Частные; Заочная	Прибыло студентов - всего (сумма стр. 02-05) / 1.0	0	0	0	0	0	0	0	0	0	0	0	0	0	89	89	0	0	0	45	45
Воронежская область	Частные; Заочная	"Численность студентов на начало прошлого учебного года
(на 1 октября) / 17.0"	0	0	0	0	0	0	0	0	0	0	0	0	0	810	810	0	0	0	499	499
Воронежская область	Частные; Очная	            из стр. 11 - не прошли итоговую аттестацию / 12.0	0	0	0	0	0	0	0	0	0	0	0	0	0	1	1	0	0	0	0	0
Воронежская область	Частные; Очная	"            из стр. 11 – лица с ограниченными возможностями здоровья,
            инвалиды, дети-инвалиды / 13.0"	0	0	0	0	0	0	0	0	0	0	0	0	0	0	0	0	0	0	0	0
Воронежская область	Частные; Очная	         отчислено в виде меры дисциплинарного взыскания / 14.0	0	0	0	0	0	0	0	0	0	0	0	0	0	1	1	0	0	0	0	0
Воронежская область	Частные; Очная	         отчислено из-за просрочки оплаты обучения / 15.0	0	0	0	0	0	0	0	0	0	0	0	0	0	18	18	0	0	0	9	9
Воронежская область	Частные; Очная	"    в том числе:
    переведено на другие формы обучения данной
    организации на программы того же уровня / 7.0"	0	0	0	0	0	0	0	0	0	0	0	0	0	51	51	0	0	0	12	12
Воронежская область	Частные; Очная	"    в том числе:
    переведено с других форм обучения данной
    образовательной организации с программ того же уровня / 2.0"	0	0	0	0	0	0	0	0	0	0	0	0	0	20	20	0	0	0	9	9
Воронежская область	Частные; Очная	    восстановлены из числа ранее отчисленных / 4.0	0	0	0	0	0	0	0	0	1	1	0	0	0	28	28	0	0	0	14	14
Воронежская область	Частные; Очная	    выбыло по другим причинам / 16.0	0	0	0	0	0	0	0	0	0	0	0	0	0	48	48	0	0	0	20	20
Воронежская область	Частные; Очная	"    добровольно прекратили образовательные отношения
    (бросили учебу) / 10.0"	0	0	0	0	0	0	0	0	2	2	0	0	0	81	81	0	0	0	24	24
Воронежская область	Частные; Очная	"    отчислено:
         по неуспеваемости / 11.0"	0	0	0	0	0	0	0	0	4	4	0	0	0	111	111	0	0	0	28	28
Воронежская область	Частные; Очная	"    переведено в другие образовательные организации
    на программы того же уровня / 8.0"	0	0	0	0	0	0	0	0	1	1	0	0	0	48	48	0	0	0	7	7
Воронежская область	Частные; Очная	"    переведено из других образовательных организаций 
    с программ того же уровня / 3.0"	0	0	0	0	0	0	0	0	0	0	0	0	0	74	74	0	0	0	19	19
Воронежская область	Частные; Очная	    по болезни / 9.0	0	0	0	0	0	0	0	0	0	0	0	0	0	0	0	0	0	0	0	0
Воронежская область	Частные; Очная	    прибыло по другим причинам / 5.0	0	0	0	0	0	0	0	0	0	0	0	0	0	41	41	0	0	0	25	25
Воронежская область	Частные; Очная	Выбыло студентов - всего (сумма стр. 07-11, 13-15) / 6.0	0	0	0	0	0	0	0	0	7	7	0	0	0	358	358	0	0	0	100	100
Воронежская область	Частные; Очная	Прибыло студентов - всего (сумма стр. 02-05) / 1.0	0	0	0	0	0	0	0	0	1	1	0	0	0	163	163	0	0	0	67	67
Воронежская область	Частные; Очная	"Численность студентов на начало прошлого учебного года
(на 1 октября) / 17.0"	0	0	0	0	0	0	0	0	60	60	175	997	0	2254	3426	0	0	0	635	635
Воронежская область	Частные; Очно-заочная	            из стр. 11 - не прошли итоговую аттестацию / 12.0	0	0	0	0	0	0	0	0	0	0	0	0	0	0	0	0	0	0	0	0
Воронежская область	Частные; Очно-заочная	"            из стр. 11 – лица с ограниченными возможностями здоровья,
            инвалиды, дети-инвалиды / 13.0"	0	0	0	0	0	0	0	0	0	0	0	0	0	0	0	0	0	0	0	0
Воронежская область	Частные; Очно-заочная	         отчислено в виде меры дисциплинарного взыскания / 14.0	0	0	0	0	0	0	0	0	0	0	0	0	0	0	0	0	0	0	0	0
Воронежская область	Частные; Очно-заочная	         отчислено из-за просрочки оплаты обучения / 15.0	0	0	0	0	0	0	0	0	0	0	0	0	0	0	0	0	0	0	0	0
Воронежская область	Частные; Очно-заочная	"    в том числе:
    переведено на другие формы обучения данной
    организации на программы того же уровня / 7.0"	0	0	0	0	0	0	0	0	0	0	0	0	0	3	3	0	0	0	0	0
Воронежская область	Частные; Очно-заочная	"    в том числе:
    переведено с других форм обучения данной
    образовательной организации с программ того же уровня / 2.0"	0	0	0	0	0	0	0	0	0	0	0	0	0	1	1	0	0	0	2	2
Воронежская область	Частные; Очно-заочная	    восстановлены из числа ранее отчисленных / 4.0	0	0	0	0	0	0	0	0	0	0	0	0	0	0	0	0	0	0	0	0
Воронежская область	Частные; Очно-заочная	    выбыло по другим причинам / 16.0	0	0	0	0	0	0	0	0	0	0	0	0	0	0	0	0	0	0	0	0
Воронежская область	Частные; Очно-заочная	"    добровольно прекратили образовательные отношения
    (бросили учебу) / 10.0"	0	0	0	0	0	0	0	0	0	0	0	0	0	0	0	0	0	0	2	2
Воронежская область	Частные; Очно-заочная	"    отчислено:
         по неуспеваемости / 11.0"	0	0	0	0	0	0	0	0	0	0	0	0	0	4	4	0	0	0	20	20
Воронежская область	Частные; Очно-заочная	"    переведено в другие образовательные организации
    на программы того же уровня / 8.0"	0	0	0	0	0	0	0	0	0	0	0	0	0	0	0	0	0	0	1	1
Воронежская область	Частные; Очно-заочная	"    переведено из других образовательных организаций 
    с программ того же уровня / 3.0"	0	0	0	0	0	0	0	0	0	0	0	0	0	0	0	0	0	0	0	0
Воронежская область	Частные; Очно-заочная	    по болезни / 9.0	0	0	0	0	0	0	0	0	0	0	0	0	0	4	4	0	0	0	0	0
Воронежская область	Частные; Очно-заочная	    прибыло по другим причинам / 5.0	0	0	0	0	0	0	0	0	0	0	0	0	0	0	0	0	0	0	0	0
Воронежская область	Частные; Очно-заочная	Выбыло студентов - всего (сумма стр. 07-11, 13-15) / 6.0	0	0	0	0	0	0	0	0	0	0	0	0	0	11	11	0	0	0	23	23
Воронежская область	Частные; Очно-заочная	Прибыло студентов - всего (сумма стр. 02-05) / 1.0	0	0	0	0	0	0	0	0	0	0	0	0	0	1	1	0	0	0	2	2
Воронежская область	Частные; Очно-заочная	"Численность студентов на начало прошлого учебного года
(на 1 октября) / 17.0"	0	0	0	0	0	0	0	0	0	0	0	0	0	5	5	0	0	0	8	8
Еврейская автономная область	Государственные, муниципальные (без учета организаций в ведении ФСИН); Заочная	            из стр. 11 - не прошли итоговую аттестацию / 12.0	0	0	0	0	0	0	0	0	0	0	0	0	0	0	0	0	0	0	0	0
Еврейская автономная область	Государственные, муниципальные (без учета организаций в ведении ФСИН); Заочная	"            из стр. 11 – лица с ограниченными возможностями здоровья,
            инвалиды, дети-инвалиды / 13.0"	0	0	0	0	0	0	0	0	0	0	0	0	0	0	0	0	0	0	0	0
Еврейская автономная область	Государственные, муниципальные (без учета организаций в ведении ФСИН); Заочная	         отчислено в виде меры дисциплинарного взыскания / 14.0	0	0	0	0	0	0	0	0	0	0	0	0	0	0	0	0	0	0	0	0
Еврейская автономная область	Государственные, муниципальные (без учета организаций в ведении ФСИН); Заочная	         отчислено из-за просрочки оплаты обучения / 15.0	0	0	0	0	0	0	0	0	0	0	0	0	0	0	0	0	0	0	0	0
Еврейская автономная область	Государственные, муниципальные (без учета организаций в ведении ФСИН); Заочная	"    в том числе:
    переведено на другие формы обучения данной
    организации на программы того же уровня / 7.0"	0	0	0	0	0	0	0	0	0	0	0	0	0	0	0	0	0	0	0	0
Еврейская автономная область	Государственные, муниципальные (без учета организаций в ведении ФСИН); Заочная	"    в том числе:
    переведено с других форм обучения данной
    образовательной организации с программ того же уровня / 2.0"	0	0	0	0	0	0	0	0	0	0	0	0	0	9	9	2	0	0	10	12
Еврейская автономная область	Государственные, муниципальные (без учета организаций в ведении ФСИН); Заочная	    восстановлены из числа ранее отчисленных / 4.0	0	0	0	0	0	0	0	0	0	0	0	0	0	3	3	2	0	0	6	8
Еврейская автономная область	Государственные, муниципальные (без учета организаций в ведении ФСИН); Заочная	    выбыло по другим причинам / 16.0	0	0	0	0	0	0	0	0	0	0	0	0	0	0	0	0	0	0	1	1
Еврейская автономная область	Государственные, муниципальные (без учета организаций в ведении ФСИН); Заочная	"    добровольно прекратили образовательные отношения
    (бросили учебу) / 10.0"	0	0	0	0	0	0	0	0	0	0	0	0	0	16	16	16	0	0	12	28
Еврейская автономная область	Государственные, муниципальные (без учета организаций в ведении ФСИН); Заочная	"    отчислено:
         по неуспеваемости / 11.0"	0	0	0	0	0	0	0	0	0	0	0	0	0	18	18	5	0	0	10	15
Еврейская автономная область	Государственные, муниципальные (без учета организаций в ведении ФСИН); Заочная	"    переведено в другие образовательные организации
    на программы того же уровня / 8.0"	0	0	0	0	0	0	0	0	0	0	0	0	0	0	0	0	0	0	0	0
Еврейская автономная область	Государственные, муниципальные (без учета организаций в ведении ФСИН); Заочная	"    переведено из других образовательных организаций 
    с программ того же уровня / 3.0"	0	0	0	0	0	0	0	0	0	0	0	0	0	0	0	0	0	0	1	1
Еврейская автономная область	Государственные, муниципальные (без учета организаций в ведении ФСИН); Заочная	    по болезни / 9.0	0	0	0	0	0	0	0	0	0	0	0	0	0	0	0	0	0	0	0	0
Еврейская автономная область	Государственные, муниципальные (без учета организаций в ведении ФСИН); Заочная	    прибыло по другим причинам / 5.0	0	0	0	0	0	0	0	0	0	0	0	0	0	18	18	1	0	0	13	14
Еврейская автономная область	Государственные, муниципальные (без учета организаций в ведении ФСИН); Заочная	Выбыло студентов - всего (сумма стр. 07-11, 13-15) / 6.0	0	0	0	0	0	0	0	0	0	0	0	0	0	34	34	21	0	0	23	44
Еврейская автономная область	Государственные, муниципальные (без учета организаций в ведении ФСИН); Заочная	Прибыло студентов - всего (сумма стр. 02-05) / 1.0	0	0	0	0	0	0	0	0	0	0	0	0	0	30	30	5	0	0	30	35
Еврейская автономная область	Государственные, муниципальные (без учета организаций в ведении ФСИН); Заочная	"Численность студентов на начало прошлого учебного года
(на 1 октября) / 17.0"	0	0	0	0	0	0	0	0	0	0	0	0	0	121	121	183	0	0	158	341
Еврейская автономная область	Государственные, муниципальные (без учета организаций в ведении ФСИН); Очная	            из стр. 11 - не прошли итоговую аттестацию / 12.0	2	0	0	0	2	0	0	0	0	0	1	0	0	0	1	0	0	0	0	0
Еврейская автономная область	Государственные, муниципальные (без учета организаций в ведении ФСИН); Очная	"            из стр. 11 – лица с ограниченными возможностями здоровья,
            инвалиды, дети-инвалиды / 13.0"	0	0	0	0	0	0	0	0	0	0	0	0	0	0	0	0	0	0	0	0
Еврейская автономная область	Государственные, муниципальные (без учета организаций в ведении ФСИН); Очная	         отчислено в виде меры дисциплинарного взыскания / 14.0	1	0	0	0	1	0	0	0	0	0	0	0	0	0	0	0	0	0	0	0
Еврейская автономная область	Государственные, муниципальные (без учета организаций в ведении ФСИН); Очная	         отчислено из-за просрочки оплаты обучения / 15.0	0	0	0	0	0	0	0	0	0	0	0	0	0	0	0	0	0	0	1	1
Еврейская автономная область	Государственные, муниципальные (без учета организаций в ведении ФСИН); Очная	"    в том числе:
    переведено на другие формы обучения данной
    организации на программы того же уровня / 7.0"	0	0	0	0	0	0	0	0	0	0	6	0	1	17	24	0	0	0	1	1
Еврейская автономная область	Государственные, муниципальные (без учета организаций в ведении ФСИН); Очная	"    в том числе:
    переведено с других форм обучения данной
    образовательной организации с программ того же уровня / 2.0"	0	0	0	0	0	0	0	0	0	0	0	0	0	0	0	0	0	0	0	0
Еврейская автономная область	Государственные, муниципальные (без учета организаций в ведении ФСИН); Очная	    восстановлены из числа ранее отчисленных / 4.0	7	0	0	0	7	0	0	0	0	0	6	0	0	1	7	4	0	0	0	4
Еврейская автономная область	Государственные, муниципальные (без учета организаций в ведении ФСИН); Очная	    выбыло по другим причинам / 16.0	17	0	0	0	17	0	0	0	0	0	10	0	2	1	13	1	0	1	1	3
Еврейская автономная область	Государственные, муниципальные (без учета организаций в ведении ФСИН); Очная	"    добровольно прекратили образовательные отношения
    (бросили учебу) / 10.0"	78	0	0	0	78	0	0	0	0	0	56	0	3	10	69	36	0	0	2	38
Еврейская автономная область	Государственные, муниципальные (без учета организаций в ведении ФСИН); Очная	"    отчислено:
         по неуспеваемости / 11.0"	52	0	0	0	52	0	0	0	0	0	14	0	57	31	102	3	0	0	13	16
Еврейская автономная область	Государственные, муниципальные (без учета организаций в ведении ФСИН); Очная	"    переведено в другие образовательные организации
    на программы того же уровня / 8.0"	5	0	0	0	5	0	0	0	0	0	1	0	10	5	16	4	0	0	0	4
Еврейская автономная область	Государственные, муниципальные (без учета организаций в ведении ФСИН); Очная	"    переведено из других образовательных организаций 
    с программ того же уровня / 3.0"	7	0	0	0	7	0	0	0	0	0	5	0	1	2	8	0	0	0	0	0
Еврейская автономная область	Государственные, муниципальные (без учета организаций в ведении ФСИН); Очная	    по болезни / 9.0	0	0	0	0	0	0	0	0	0	0	0	0	0	0	0	0	0	0	0	0
Еврейская автономная область	Государственные, муниципальные (без учета организаций в ведении ФСИН); Очная	    прибыло по другим причинам / 5.0	12	0	0	0	12	0	0	0	0	0	0	0	0	0	0	3	0	0	0	3
Еврейская автономная область	Государственные, муниципальные (без учета организаций в ведении ФСИН); Очная	Выбыло студентов - всего (сумма стр. 07-11, 13-15) / 6.0	153	0	0	0	153	0	0	0	0	0	87	0	73	64	224	44	0	1	18	63
Еврейская автономная область	Государственные, муниципальные (без учета организаций в ведении ФСИН); Очная	Прибыло студентов - всего (сумма стр. 02-05) / 1.0	26	0	0	0	26	0	0	0	0	0	11	0	1	3	15	7	0	0	0	7
Еврейская автономная область	Государственные, муниципальные (без учета организаций в ведении ФСИН); Очная	"Численность студентов на начало прошлого учебного года
(на 1 октября) / 17.0"	944	0	2	0	946	0	0	0	0	0	406	0	406	209	1021	353	0	0	136	489
Забайкальский край	Государственные, муниципальные (без учета организаций в ведении ФСИН); Заочная	            из стр. 11 - не прошли итоговую аттестацию / 12.0	0	0	0	0	0	0	0	0	0	0	0	0	0	0	0	0	0	0	1	1
Забайкальский край	Государственные, муниципальные (без учета организаций в ведении ФСИН); Заочная	"            из стр. 11 – лица с ограниченными возможностями здоровья,
            инвалиды, дети-инвалиды / 13.0"	0	0	0	0	0	0	0	0	0	0	0	0	0	0	0	0	0	0	0	0
Забайкальский край	Государственные, муниципальные (без учета организаций в ведении ФСИН); Заочная	         отчислено в виде меры дисциплинарного взыскания / 14.0	0	0	0	0	0	0	0	0	0	0	0	0	0	0	0	0	0	0	0	0
Забайкальский край	Государственные, муниципальные (без учета организаций в ведении ФСИН); Заочная	         отчислено из-за просрочки оплаты обучения / 15.0	0	0	0	0	0	0	0	0	0	0	0	0	0	60	60	0	0	0	52	52
Забайкальский край	Государственные, муниципальные (без учета организаций в ведении ФСИН); Заочная	"    в том числе:
    переведено на другие формы обучения данной
    организации на программы того же уровня / 7.0"	0	0	0	0	0	0	0	0	0	0	2	0	0	11	13	1	0	0	6	7
Забайкальский край	Государственные, муниципальные (без учета организаций в ведении ФСИН); Заочная	"    в том числе:
    переведено с других форм обучения данной
    образовательной организации с программ того же уровня / 2.0"	0	0	0	0	0	0	0	0	0	0	9	0	0	116	125	12	0	0	114	126
Забайкальский край	Государственные, муниципальные (без учета организаций в ведении ФСИН); Заочная	    восстановлены из числа ранее отчисленных / 4.0	0	0	0	0	0	0	0	0	0	0	9	0	0	31	40	11	0	0	58	69
Забайкальский край	Государственные, муниципальные (без учета организаций в ведении ФСИН); Заочная	    выбыло по другим причинам / 16.0	0	0	0	0	0	0	0	0	0	0	16	0	0	91	107	63	0	1	156	220
Забайкальский край	Государственные, муниципальные (без учета организаций в ведении ФСИН); Заочная	"    добровольно прекратили образовательные отношения
    (бросили учебу) / 10.0"	0	0	0	0	0	0	0	0	0	0	15	0	1	86	102	27	0	22	149	198
Забайкальский край	Государственные, муниципальные (без учета организаций в ведении ФСИН); Заочная	"    отчислено:
         по неуспеваемости / 11.0"	0	0	0	0	0	0	0	0	0	0	18	0	0	59	77	40	0	12	121	173
Забайкальский край	Государственные, муниципальные (без учета организаций в ведении ФСИН); Заочная	"    переведено в другие образовательные организации
    на программы того же уровня / 8.0"	0	0	0	0	0	0	0	0	0	0	2	0	0	7	9	2	0	1	12	15
Забайкальский край	Государственные, муниципальные (без учета организаций в ведении ФСИН); Заочная	"    переведено из других образовательных организаций 
    с программ того же уровня / 3.0"	0	0	0	0	0	0	0	0	0	0	0	0	0	9	9	5	0	0	40	45
Забайкальский край	Государственные, муниципальные (без учета организаций в ведении ФСИН); Заочная	    по болезни / 9.0	0	0	0	0	0	0	0	0	0	0	4	0	0	1	5	1	0	0	5	6
Забайкальский край	Государственные, муниципальные (без учета организаций в ведении ФСИН); Заочная	    прибыло по другим причинам / 5.0	0	0	0	0	0	0	0	0	0	0	0	0	8	18	26	2	0	14	60	76
Забайкальский край	Государственные, муниципальные (без учета организаций в ведении ФСИН); Заочная	Выбыло студентов - всего (сумма стр. 07-11, 13-15) / 6.0	0	0	0	0	0	0	0	0	0	0	57	0	1	315	373	134	0	36	501	671
Забайкальский край	Государственные, муниципальные (без учета организаций в ведении ФСИН); Заочная	Прибыло студентов - всего (сумма стр. 02-05) / 1.0	0	0	0	0	0	0	0	0	0	0	18	0	8	174	200	30	0	14	272	316
Забайкальский край	Государственные, муниципальные (без учета организаций в ведении ФСИН); Заочная	"Численность студентов на начало прошлого учебного года
(на 1 октября) / 17.0"	0	0	0	0	0	0	0	0	0	0	297	0	17	930	1244	1122	0	444	3100	4666
Забайкальский край	Государственные, муниципальные (без учета организаций в ведении ФСИН); Очная	            из стр. 11 - не прошли итоговую аттестацию / 12.0	2	0	0	0	2	0	0	0	0	0	8	0	0	3	11	0	0	0	0	0
Забайкальский край	Государственные, муниципальные (без учета организаций в ведении ФСИН); Очная	"            из стр. 11 – лица с ограниченными возможностями здоровья,
            инвалиды, дети-инвалиды / 13.0"	0	0	0	0	0	0	0	0	0	0	1	0	0	0	1	0	0	0	0	0
Забайкальский край	Государственные, муниципальные (без учета организаций в ведении ФСИН); Очная	         отчислено в виде меры дисциплинарного взыскания / 14.0	2	0	0	0	2	0	0	0	0	0	16	0	0	2	18	1	0	0	1	2
Забайкальский край	Государственные, муниципальные (без учета организаций в ведении ФСИН); Очная	         отчислено из-за просрочки оплаты обучения / 15.0	0	0	0	0	0	0	0	0	0	0	0	0	0	18	18	0	0	0	8	8
Забайкальский край	Государственные, муниципальные (без учета организаций в ведении ФСИН); Очная	"    в том числе:
    переведено на другие формы обучения данной
    организации на программы того же уровня / 7.0"	4	0	0	9	13	0	0	0	0	0	85	0	3	194	282	14	0	1	34	49
Забайкальский край	Государственные, муниципальные (без учета организаций в ведении ФСИН); Очная	"    в том числе:
    переведено с других форм обучения данной
    образовательной организации с программ того же уровня / 2.0"	35	0	0	4	39	0	0	0	0	0	39	0	1	35	75	10	0	0	82	92
Забайкальский край	Государственные, муниципальные (без учета организаций в ведении ФСИН); Очная	    восстановлены из числа ранее отчисленных / 4.0	34	0	0	1	35	0	0	0	0	0	42	0	0	60	102	20	0	0	22	42
Забайкальский край	Государственные, муниципальные (без учета организаций в ведении ФСИН); Очная	    выбыло по другим причинам / 16.0	350	0	0	100	450	2	0	0	0	2	367	0	7	230	604	94	0	3	98	195
Забайкальский край	Государственные, муниципальные (без учета организаций в ведении ФСИН); Очная	"    добровольно прекратили образовательные отношения
    (бросили учебу) / 10.0"	178	0	0	10	188	1	0	0	0	1	231	0	60	298	589	45	0	15	119	179
Забайкальский край	Государственные, муниципальные (без учета организаций в ведении ФСИН); Очная	"    отчислено:
         по неуспеваемости / 11.0"	150	0	0	10	160	5	0	0	0	5	82	0	9	83	174	17	0	2	30	49
Забайкальский край	Государственные, муниципальные (без учета организаций в ведении ФСИН); Очная	"    переведено в другие образовательные организации
    на программы того же уровня / 8.0"	39	0	0	6	45	0	0	0	0	0	92	0	8	100	200	10	0	2	23	35
Забайкальский край	Государственные, муниципальные (без учета организаций в ведении ФСИН); Очная	"    переведено из других образовательных организаций 
    с программ того же уровня / 3.0"	46	0	0	1	47	0	0	0	0	0	53	0	1	50	104	8	0	0	6	14
Забайкальский край	Государственные, муниципальные (без учета организаций в ведении ФСИН); Очная	    по болезни / 9.0	18	0	0	0	18	0	0	0	0	0	1	0	0	4	5	0	0	0	10	10
Забайкальский край	Государственные, муниципальные (без учета организаций в ведении ФСИН); Очная	    прибыло по другим причинам / 5.0	70	0	0	40	110	0	0	0	0	0	196	0	24	160	380	58	0	21	8	87
Забайкальский край	Государственные, муниципальные (без учета организаций в ведении ФСИН); Очная	Выбыло студентов - всего (сумма стр. 07-11, 13-15) / 6.0	741	0	0	135	876	8	0	0	0	8	874	0	87	929	1890	181	0	23	323	527
Забайкальский край	Государственные, муниципальные (без учета организаций в ведении ФСИН); Очная	Прибыло студентов - всего (сумма стр. 02-05) / 1.0	185	0	0	46	231	0	0	0	0	0	330	0	26	305	661	96	0	21	118	235
Забайкальский край	Государственные, муниципальные (без учета организаций в ведении ФСИН); Очная	"Численность студентов на начало прошлого учебного года
(на 1 октября) / 17.0"	5689	0	0	691	6380	103	0	0	6	109	6371	0	1108	5042	12521	1573	0	149	1562	3284
Забайкальский край	Очно-заочная; Государственные, муниципальные (без учета организаций в ведении ФСИН)	            из стр. 11 - не прошли итоговую аттестацию / 12.0	0	0	0	0	0	0	0	0	0	0	0	0	0	0	0	0	0	0	0	0
Забайкальский край	Очно-заочная; Государственные, муниципальные (без учета организаций в ведении ФСИН)	"            из стр. 11 – лица с ограниченными возможностями здоровья,
            инвалиды, дети-инвалиды / 13.0"	0	0	0	0	0	0	0	0	0	0	0	0	0	0	0	0	0	0	0	0
Забайкальский край	Очно-заочная; Государственные, муниципальные (без учета организаций в ведении ФСИН)	         отчислено в виде меры дисциплинарного взыскания / 14.0	0	0	0	0	0	0	0	0	0	0	0	0	0	0	0	0	0	0	0	0
Забайкальский край	Очно-заочная; Государственные, муниципальные (без учета организаций в ведении ФСИН)	         отчислено из-за просрочки оплаты обучения / 15.0	0	0	0	0	0	0	0	0	0	0	0	0	0	0	0	0	0	0	0	0
Забайкальский край	Очно-заочная; Государственные, муниципальные (без учета организаций в ведении ФСИН)	"    в том числе:
    переведено на другие формы обучения данной
    организации на программы того же уровня / 7.0"	0	0	0	0	0	0	0	0	0	0	0	0	0	79	79	0	0	0	0	0
Забайкальский край	Очно-заочная; Государственные, муниципальные (без учета организаций в ведении ФСИН)	"    в том числе:
    переведено с других форм обучения данной
    образовательной организации с программ того же уровня / 2.0"	0	0	0	0	0	0	0	0	0	0	0	0	0	0	0	0	0	0	0	0
Забайкальский край	Очно-заочная; Государственные, муниципальные (без учета организаций в ведении ФСИН)	    восстановлены из числа ранее отчисленных / 4.0	0	0	0	0	0	0	0	0	0	0	0	0	0	0	0	6	0	0	2	8
Забайкальский край	Очно-заочная; Государственные, муниципальные (без учета организаций в ведении ФСИН)	    выбыло по другим причинам / 16.0	0	0	0	0	0	0	0	0	0	0	0	0	0	0	0	74	0	0	13	87
Забайкальский край	Очно-заочная; Государственные, муниципальные (без учета организаций в ведении ФСИН)	"    добровольно прекратили образовательные отношения
    (бросили учебу) / 10.0"	0	0	0	0	0	0	0	0	0	0	0	0	0	2	2	1	0	0	15	16
Забайкальский край	Очно-заочная; Государственные, муниципальные (без учета организаций в ведении ФСИН)	"    отчислено:
         по неуспеваемости / 11.0"	0	0	0	0	0	0	0	0	0	0	0	0	0	0	0	2	0	0	0	2
Забайкальский край	Очно-заочная; Государственные, муниципальные (без учета организаций в ведении ФСИН)	"    переведено в другие образовательные организации
    на программы того же уровня / 8.0"	0	0	0	0	0	0	0	0	0	0	0	0	0	0	0	0	0	0	0	0
Забайкальский край	Очно-заочная; Государственные, муниципальные (без учета организаций в ведении ФСИН)	"    переведено из других образовательных организаций 
    с программ того же уровня / 3.0"	0	0	0	0	0	0	0	0	0	0	0	0	0	0	0	0	0	0	0	0
Забайкальский край	Очно-заочная; Государственные, муниципальные (без учета организаций в ведении ФСИН)	    по болезни / 9.0	0	0	0	0	0	0	0	0	0	0	0	0	0	1	1	0	0	0	1	1
Забайкальский край	Очно-заочная; Государственные, муниципальные (без учета организаций в ведении ФСИН)	    прибыло по другим причинам / 5.0	0	0	0	0	0	0	0	0	0	0	0	0	0	3	3	25	0	0	15	40
Забайкальский край	Очно-заочная; Государственные, муниципальные (без учета организаций в ведении ФСИН)	Выбыло студентов - всего (сумма стр. 07-11, 13-15) / 6.0	0	0	0	0	0	0	0	0	0	0	0	0	0	82	82	77	0	0	29	106
Забайкальский край	Очно-заочная; Государственные, муниципальные (без учета организаций в ведении ФСИН)	Прибыло студентов - всего (сумма стр. 02-05) / 1.0	0	0	0	0	0	0	0	0	0	0	0	0	0	3	3	31	0	0	17	48
Забайкальский край	Очно-заочная; Государственные, муниципальные (без учета организаций в ведении ФСИН)	"Численность студентов на начало прошлого учебного года
(на 1 октября) / 17.0"	0	0	0	0	0	0	0	0	0	0	0	0	0	121	121	304	0	0	152	456
Забайкальский край	Частные; Заочная	            из стр. 11 - не прошли итоговую аттестацию / 12.0	0	0	0	0	0	0	0	0	0	0	0	0	0	0	0	0	0	0	0	0
Забайкальский край	Частные; Заочная	"            из стр. 11 – лица с ограниченными возможностями здоровья,
            инвалиды, дети-инвалиды / 13.0"	0	0	0	0	0	0	0	0	0	0	0	0	0	0	0	0	0	0	0	0
Забайкальский край	Частные; Заочная	         отчислено в виде меры дисциплинарного взыскания / 14.0	0	0	0	0	0	0	0	0	0	0	0	0	0	0	0	0	0	0	0	0
Забайкальский край	Частные; Заочная	         отчислено из-за просрочки оплаты обучения / 15.0	0	0	0	0	0	0	0	0	0	0	0	0	0	0	0	0	0	0	0	0
Забайкальский край	Частные; Заочная	"    в том числе:
    переведено на другие формы обучения данной
    организации на программы того же уровня / 7.0"	0	0	0	0	0	0	0	0	0	0	0	0	0	0	0	0	0	0	0	0
Забайкальский край	Частные; Заочная	"    в том числе:
    переведено с других форм обучения данной
    образовательной организации с программ того же уровня / 2.0"	0	0	0	0	0	0	0	0	0	0	0	0	0	2	2	0	0	0	0	0
Забайкальский край	Частные; Заочная	    восстановлены из числа ранее отчисленных / 4.0	0	0	0	0	0	0	0	0	0	0	0	0	0	15	15	0	0	0	15	15
Забайкальский край	Частные; Заочная	    выбыло по другим причинам / 16.0	0	0	0	0	0	0	0	0	0	0	0	0	0	6	6	0	0	0	14	14
Забайкальский край	Частные; Заочная	"    добровольно прекратили образовательные отношения
    (бросили учебу) / 10.0"	0	0	0	0	0	0	0	0	0	0	0	0	0	0	0	0	0	0	0	0
Забайкальский край	Частные; Заочная	"    отчислено:
         по неуспеваемости / 11.0"	0	0	0	0	0	0	0	0	0	0	0	0	0	1	1	0	0	0	6	6
Забайкальский край	Частные; Заочная	"    переведено в другие образовательные организации
    на программы того же уровня / 8.0"	0	0	0	0	0	0	0	0	0	0	0	0	0	0	0	0	0	0	0	0
Забайкальский край	Частные; Заочная	"    переведено из других образовательных организаций 
    с программ того же уровня / 3.0"	0	0	0	0	0	0	0	0	0	0	0	0	0	0	0	0	0	0	0	0
Забайкальский край	Частные; Заочная	    по болезни / 9.0	0	0	0	0	0	0	0	0	0	0	0	0	0	0	0	0	0	0	0	0
Забайкальский край	Частные; Заочная	    прибыло по другим причинам / 5.0	0	0	0	0	0	0	0	0	0	0	0	0	0	0	0	0	0	0	0	0
Забайкальский край	Частные; Заочная	Выбыло студентов - всего (сумма стр. 07-11, 13-15) / 6.0	0	0	0	0	0	0	0	0	0	0	0	0	0	7	7	0	0	0	20	20
Забайкальский край	Частные; Заочная	Прибыло студентов - всего (сумма стр. 02-05) / 1.0	0	0	0	0	0	0	0	0	0	0	0	0	0	17	17	0	0	0	15	15
Забайкальский край	Частные; Заочная	"Численность студентов на начало прошлого учебного года
(на 1 октября) / 17.0"	0	0	0	0	0	0	0	0	0	0	0	0	0	82	82	22	0	0	68	90
Забайкальский край	Частные; Очная	            из стр. 11 - не прошли итоговую аттестацию / 12.0	0	0	0	0	0	0	0	0	0	0	0	0	0	0	0	0	0	0	0	0
Забайкальский край	Частные; Очная	"            из стр. 11 – лица с ограниченными возможностями здоровья,
            инвалиды, дети-инвалиды / 13.0"	0	0	0	0	0	0	0	0	0	0	0	0	0	0	0	0	0	0	0	0
Забайкальский край	Частные; Очная	         отчислено в виде меры дисциплинарного взыскания / 14.0	0	0	0	0	0	0	0	0	0	0	0	0	0	0	0	0	0	0	0	0
Забайкальский край	Частные; Очная	         отчислено из-за просрочки оплаты обучения / 15.0	0	0	0	0	0	0	0	0	0	0	0	0	0	91	91	0	0	0	18	18
Забайкальский край	Частные; Очная	"    в том числе:
    переведено на другие формы обучения данной
    организации на программы того же уровня / 7.0"	0	0	0	0	0	0	0	0	0	0	0	0	0	4	4	0	0	0	0	0
Забайкальский край	Частные; Очная	"    в том числе:
    переведено с других форм обучения данной
    образовательной организации с программ того же уровня / 2.0"	0	0	0	0	0	0	0	0	0	0	0	0	0	8	8	0	0	0	4	4
Забайкальский край	Частные; Очная	    восстановлены из числа ранее отчисленных / 4.0	0	0	0	0	0	0	0	0	0	0	0	0	0	33	33	0	0	0	9	9
Забайкальский край	Частные; Очная	    выбыло по другим причинам / 16.0	0	0	0	0	0	0	0	0	0	0	0	0	0	5	5	0	0	0	0	0
Забайкальский край	Частные; Очная	"    добровольно прекратили образовательные отношения
    (бросили учебу) / 10.0"	0	0	0	0	0	0	0	0	0	0	0	0	0	13	13	0	0	0	2	2
Забайкальский край	Частные; Очная	"    отчислено:
         по неуспеваемости / 11.0"	0	0	0	0	0	0	0	0	0	0	0	0	0	29	29	0	0	0	14	14
Забайкальский край	Частные; Очная	"    переведено в другие образовательные организации
    на программы того же уровня / 8.0"	0	0	0	0	0	0	0	0	0	0	0	0	0	9	9	0	0	0	0	0
Забайкальский край	Частные; Очная	"    переведено из других образовательных организаций 
    с программ того же уровня / 3.0"	0	0	0	0	0	0	0	0	0	0	0	0	0	7	7	0	0	0	3	3
Забайкальский край	Частные; Очная	    по болезни / 9.0	0	0	0	0	0	0	0	0	0	0	0	0	0	0	0	0	0	0	0	0
Забайкальский край	Частные; Очная	    прибыло по другим причинам / 5.0	0	0	0	0	0	0	0	0	0	0	0	0	0	6	6	0	0	0	2	2
Забайкальский край	Частные; Очная	Выбыло студентов - всего (сумма стр. 07-11, 13-15) / 6.0	0	0	0	0	0	0	0	0	0	0	0	0	0	151	151	0	0	0	34	34
Забайкальский край	Частные; Очная	Прибыло студентов - всего (сумма стр. 02-05) / 1.0	0	0	0	0	0	0	0	0	0	0	0	0	0	54	54	0	0	0	18	18
Забайкальский край	Частные; Очная	"Численность студентов на начало прошлого учебного года
(на 1 октября) / 17.0"	0	0	0	0	0	0	0	0	0	0	48	0	0	776	824	0	0	0	145	145
Ивановская область	Государственные, муниципальные (без учета организаций в ведении ФСИН); Заочная	            из стр. 11 - не прошли итоговую аттестацию / 12.0	0	0	0	0	0	0	0	0	0	0	0	0	0	0	0	5	0	0	0	5
Ивановская область	Государственные, муниципальные (без учета организаций в ведении ФСИН); Заочная	"            из стр. 11 – лица с ограниченными возможностями здоровья,
            инвалиды, дети-инвалиды / 13.0"	0	0	0	0	0	0	0	0	0	0	0	0	0	0	0	0	0	0	0	0
Ивановская область	Государственные, муниципальные (без учета организаций в ведении ФСИН); Заочная	         отчислено в виде меры дисциплинарного взыскания / 14.0	0	0	0	0	0	0	0	0	0	0	0	0	0	0	0	0	0	0	0	0
Ивановская область	Государственные, муниципальные (без учета организаций в ведении ФСИН); Заочная	         отчислено из-за просрочки оплаты обучения / 15.0	0	0	0	0	0	0	0	0	0	0	0	0	0	0	0	0	0	0	11	11
Ивановская область	Государственные, муниципальные (без учета организаций в ведении ФСИН); Заочная	"    в том числе:
    переведено на другие формы обучения данной
    организации на программы того же уровня / 7.0"	0	0	0	0	0	0	0	0	0	0	0	0	0	0	0	1	0	0	0	1
Ивановская область	Государственные, муниципальные (без учета организаций в ведении ФСИН); Заочная	"    в том числе:
    переведено с других форм обучения данной
    образовательной организации с программ того же уровня / 2.0"	0	0	0	0	0	0	0	0	0	0	0	0	0	0	0	2	0	0	1	3
Ивановская область	Государственные, муниципальные (без учета организаций в ведении ФСИН); Заочная	    восстановлены из числа ранее отчисленных / 4.0	0	0	0	0	0	0	0	0	0	0	0	0	0	0	0	0	0	0	0	0
Ивановская область	Государственные, муниципальные (без учета организаций в ведении ФСИН); Заочная	    выбыло по другим причинам / 16.0	0	0	0	0	0	0	0	0	0	0	0	0	0	1	1	19	0	0	1	20
Ивановская область	Государственные, муниципальные (без учета организаций в ведении ФСИН); Заочная	"    добровольно прекратили образовательные отношения
    (бросили учебу) / 10.0"	0	0	0	0	0	0	0	0	0	0	0	0	0	0	0	24	0	0	7	31
Ивановская область	Государственные, муниципальные (без учета организаций в ведении ФСИН); Заочная	"    отчислено:
         по неуспеваемости / 11.0"	0	0	0	0	0	0	0	0	0	0	0	0	0	0	0	13	0	0	1	14
Ивановская область	Государственные, муниципальные (без учета организаций в ведении ФСИН); Заочная	"    переведено в другие образовательные организации
    на программы того же уровня / 8.0"	0	0	0	0	0	0	0	0	0	0	0	0	0	0	0	1	0	0	0	1
Ивановская область	Государственные, муниципальные (без учета организаций в ведении ФСИН); Заочная	"    переведено из других образовательных организаций 
    с программ того же уровня / 3.0"	0	0	0	0	0	0	0	0	0	0	0	0	0	0	0	0	0	0	0	0
Ивановская область	Государственные, муниципальные (без учета организаций в ведении ФСИН); Заочная	    по болезни / 9.0	0	0	0	0	0	0	0	0	0	0	0	0	0	0	0	0	0	0	0	0
Ивановская область	Государственные, муниципальные (без учета организаций в ведении ФСИН); Заочная	    прибыло по другим причинам / 5.0	0	0	0	0	0	0	0	0	0	0	0	0	0	0	0	30	0	0	0	30
Ивановская область	Государственные, муниципальные (без учета организаций в ведении ФСИН); Заочная	Выбыло студентов - всего (сумма стр. 07-11, 13-15) / 6.0	0	0	0	0	0	0	0	0	0	0	0	0	0	1	1	58	0	0	20	78
Ивановская область	Государственные, муниципальные (без учета организаций в ведении ФСИН); Заочная	Прибыло студентов - всего (сумма стр. 02-05) / 1.0	0	0	0	0	0	0	0	0	0	0	0	0	0	0	0	32	0	0	1	33
Ивановская область	Государственные, муниципальные (без учета организаций в ведении ФСИН); Заочная	"Численность студентов на начало прошлого учебного года
(на 1 октября) / 17.0"	0	0	0	0	0	0	0	0	0	0	0	0	0	5	5	675	0	15	137	827
Ивановская область	Государственные, муниципальные (без учета организаций в ведении ФСИН); Очная	            из стр. 11 - не прошли итоговую аттестацию / 12.0	9	0	0	0	9	0	0	0	0	0	32	0	0	4	36	1	0	0	0	1
Ивановская область	Государственные, муниципальные (без учета организаций в ведении ФСИН); Очная	"            из стр. 11 – лица с ограниченными возможностями здоровья,
            инвалиды, дети-инвалиды / 13.0"	0	0	0	0	0	0	0	0	0	0	0	0	3	0	3	0	0	0	0	0
Ивановская область	Государственные, муниципальные (без учета организаций в ведении ФСИН); Очная	         отчислено в виде меры дисциплинарного взыскания / 14.0	1	0	0	0	1	0	0	0	0	0	0	0	0	0	0	0	0	0	0	0
Ивановская область	Государственные, муниципальные (без учета организаций в ведении ФСИН); Очная	         отчислено из-за просрочки оплаты обучения / 15.0	0	0	0	0	0	0	0	0	0	0	0	0	0	23	23	0	0	0	6	6
Ивановская область	Государственные, муниципальные (без учета организаций в ведении ФСИН); Очная	"    в том числе:
    переведено на другие формы обучения данной
    организации на программы того же уровня / 7.0"	9	0	0	9	18	0	0	0	0	0	11	1	0	5	17	0	0	0	0	0
Ивановская область	Государственные, муниципальные (без учета организаций в ведении ФСИН); Очная	"    в том числе:
    переведено с других форм обучения данной
    образовательной организации с программ того же уровня / 2.0"	12	0	0	3	15	0	0	0	0	0	9	0	0	3	12	1	0	0	0	1
Ивановская область	Государственные, муниципальные (без учета организаций в ведении ФСИН); Очная	    восстановлены из числа ранее отчисленных / 4.0	15	0	0	3	18	0	0	0	0	0	41	0	1	24	66	15	0	0	12	27
Ивановская область	Государственные, муниципальные (без учета организаций в ведении ФСИН); Очная	    выбыло по другим причинам / 16.0	101	0	0	4	105	0	0	0	0	0	154	0	8	57	219	21	0	0	60	81
Ивановская область	Государственные, муниципальные (без учета организаций в ведении ФСИН); Очная	"    добровольно прекратили образовательные отношения
    (бросили учебу) / 10.0"	154	0	0	0	154	0	0	0	0	0	292	0	63	62	417	54	0	0	66	120
Ивановская область	Государственные, муниципальные (без учета организаций в ведении ФСИН); Очная	"    отчислено:
         по неуспеваемости / 11.0"	152	0	0	3	155	8	0	0	0	8	211	0	50	62	323	30	0	1	8	39
Ивановская область	Государственные, муниципальные (без учета организаций в ведении ФСИН); Очная	"    переведено в другие образовательные организации
    на программы того же уровня / 8.0"	30	0	0	4	34	0	0	0	0	0	95	0	19	44	158	2	0	0	0	2
Ивановская область	Государственные, муниципальные (без учета организаций в ведении ФСИН); Очная	"    переведено из других образовательных организаций 
    с программ того же уровня / 3.0"	47	0	0	4	51	0	0	0	0	0	81	0	2	22	105	2	0	0	27	29
Ивановская область	Государственные, муниципальные (без учета организаций в ведении ФСИН); Очная	    по болезни / 9.0	12	1	0	0	13	0	0	0	0	0	2	0	1	1	4	1	0	0	0	1
Ивановская область	Государственные, муниципальные (без учета организаций в ведении ФСИН); Очная	    прибыло по другим причинам / 5.0	101	0	0	5	106	0	0	0	0	0	79	0	34	31	144	17	0	0	2	19
Ивановская область	Государственные, муниципальные (без учета организаций в ведении ФСИН); Очная	Выбыло студентов - всего (сумма стр. 07-11, 13-15) / 6.0	459	1	0	20	480	8	0	0	0	8	765	1	141	254	1161	108	0	1	140	249
Ивановская область	Государственные, муниципальные (без учета организаций в ведении ФСИН); Очная	Прибыло студентов - всего (сумма стр. 02-05) / 1.0	175	0	0	15	190	0	0	0	0	0	210	0	37	80	327	35	0	0	41	76
Ивановская область	Государственные, муниципальные (без учета организаций в ведении ФСИН); Очная	"Численность студентов на начало прошлого учебного года
(на 1 октября) / 17.0"	4576	0	0	122	4698	50	0	0	0	50	8920	0	1243	1720	11883	934	0	22	1085	2041
Ивановская область	Очно-заочная; Государственные, муниципальные (без учета организаций в ведении ФСИН)	            из стр. 11 - не прошли итоговую аттестацию / 12.0	0	0	0	0	0	0	0	0	0	0	0	0	0	0	0	0	0	0	0	0
Ивановская область	Очно-заочная; Государственные, муниципальные (без учета организаций в ведении ФСИН)	"            из стр. 11 – лица с ограниченными возможностями здоровья,
            инвалиды, дети-инвалиды / 13.0"	0	0	0	0	0	0	0	0	0	0	0	0	0	0	0	0	0	0	0	0
Ивановская область	Очно-заочная; Государственные, муниципальные (без учета организаций в ведении ФСИН)	         отчислено в виде меры дисциплинарного взыскания / 14.0	0	0	0	0	0	0	0	0	0	0	0	0	0	0	0	0	0	0	0	0
Ивановская область	Очно-заочная; Государственные, муниципальные (без учета организаций в ведении ФСИН)	         отчислено из-за просрочки оплаты обучения / 15.0	0	0	0	0	0	0	0	0	0	0	0	0	0	0	0	0	0	0	0	0
Ивановская область	Очно-заочная; Государственные, муниципальные (без учета организаций в ведении ФСИН)	"    в том числе:
    переведено на другие формы обучения данной
    организации на программы того же уровня / 7.0"	0	0	0	0	0	0	0	0	0	0	0	0	0	0	0	0	0	0	0	0
Ивановская область	Очно-заочная; Государственные, муниципальные (без учета организаций в ведении ФСИН)	"    в том числе:
    переведено с других форм обучения данной
    образовательной организации с программ того же уровня / 2.0"	0	0	0	0	0	0	0	0	0	0	0	0	0	0	0	0	0	0	2	2
Ивановская область	Очно-заочная; Государственные, муниципальные (без учета организаций в ведении ФСИН)	    восстановлены из числа ранее отчисленных / 4.0	0	0	0	0	0	0	0	0	0	0	0	0	0	0	0	0	0	0	6	6
Ивановская область	Очно-заочная; Государственные, муниципальные (без учета организаций в ведении ФСИН)	    выбыло по другим причинам / 16.0	0	0	0	0	0	0	0	0	0	0	0	0	0	0	0	0	0	0	6	6
Ивановская область	Очно-заочная; Государственные, муниципальные (без учета организаций в ведении ФСИН)	"    добровольно прекратили образовательные отношения
    (бросили учебу) / 10.0"	0	0	0	0	0	0	0	0	0	0	0	0	0	0	0	0	0	0	24	24
Ивановская область	Очно-заочная; Государственные, муниципальные (без учета организаций в ведении ФСИН)	"    отчислено:
         по неуспеваемости / 11.0"	0	0	0	0	0	0	0	0	0	0	0	0	0	0	0	0	0	0	0	0
Ивановская область	Очно-заочная; Государственные, муниципальные (без учета организаций в ведении ФСИН)	"    переведено в другие образовательные организации
    на программы того же уровня / 8.0"	0	0	0	0	0	0	0	0	0	0	0	0	0	0	0	0	0	0	0	0
Ивановская область	Очно-заочная; Государственные, муниципальные (без учета организаций в ведении ФСИН)	"    переведено из других образовательных организаций 
    с программ того же уровня / 3.0"	0	0	0	0	0	0	0	0	0	0	0	0	0	0	0	0	0	0	3	3
Ивановская область	Очно-заочная; Государственные, муниципальные (без учета организаций в ведении ФСИН)	    по болезни / 9.0	0	0	0	0	0	0	0	0	0	0	0	0	0	0	0	0	0	0	0	0
Ивановская область	Очно-заочная; Государственные, муниципальные (без учета организаций в ведении ФСИН)	    прибыло по другим причинам / 5.0	0	0	0	0	0	0	0	0	0	0	0	0	0	0	0	0	0	0	0	0
Ивановская область	Очно-заочная; Государственные, муниципальные (без учета организаций в ведении ФСИН)	Выбыло студентов - всего (сумма стр. 07-11, 13-15) / 6.0	0	0	0	0	0	0	0	0	0	0	0	0	0	0	0	0	0	0	30	30
Ивановская область	Очно-заочная; Государственные, муниципальные (без учета организаций в ведении ФСИН)	Прибыло студентов - всего (сумма стр. 02-05) / 1.0	0	0	0	0	0	0	0	0	0	0	0	0	0	0	0	0	0	0	11	11
Ивановская область	Очно-заочная; Государственные, муниципальные (без учета организаций в ведении ФСИН)	"Численность студентов на начало прошлого учебного года
(на 1 октября) / 17.0"	0	0	0	0	0	0	0	0	0	0	0	0	0	0	0	1	0	0	205	206
Ивановская область	Частные; Заочная	            из стр. 11 - не прошли итоговую аттестацию / 12.0	0	0	0	0	0	0	0	0	0	0	0	0	0	0	0	0	0	0	0	0
Ивановская область	Частные; Заочная	"            из стр. 11 – лица с ограниченными возможностями здоровья,
            инвалиды, дети-инвалиды / 13.0"	0	0	0	0	0	0	0	0	0	0	0	0	0	0	0	0	0	0	0	0
Ивановская область	Частные; Заочная	         отчислено в виде меры дисциплинарного взыскания / 14.0	0	0	0	0	0	0	0	0	0	0	0	0	0	0	0	0	0	0	0	0
Ивановская область	Частные; Заочная	         отчислено из-за просрочки оплаты обучения / 15.0	0	0	0	0	0	0	0	0	0	0	0	0	0	0	0	0	0	0	8	8
Ивановская область	Частные; Заочная	"    в том числе:
    переведено на другие формы обучения данной
    организации на программы того же уровня / 7.0"	0	0	0	0	0	0	0	0	0	0	0	0	0	0	0	0	0	0	0	0
Ивановская область	Частные; Заочная	"    в том числе:
    переведено с других форм обучения данной
    образовательной организации с программ того же уровня / 2.0"	0	0	0	0	0	0	0	0	0	0	0	0	0	0	0	0	0	0	8	8
Ивановская область	Частные; Заочная	    восстановлены из числа ранее отчисленных / 4.0	0	0	0	0	0	0	0	0	0	0	0	0	0	0	0	0	0	0	7	7
Ивановская область	Частные; Заочная	    выбыло по другим причинам / 16.0	0	0	0	0	0	0	0	0	0	0	0	0	0	1	1	0	0	0	3	3
Ивановская область	Частные; Заочная	"    добровольно прекратили образовательные отношения
    (бросили учебу) / 10.0"	0	0	0	0	0	0	0	0	0	0	0	0	0	11	11	0	0	0	3	3
Ивановская область	Частные; Заочная	"    отчислено:
         по неуспеваемости / 11.0"	0	0	0	0	0	0	0	0	0	0	0	0	0	40	40	0	0	0	54	54
Ивановская область	Частные; Заочная	"    переведено в другие образовательные организации
    на программы того же уровня / 8.0"	0	0	0	0	0	0	0	0	0	0	0	0	0	8	8	0	0	0	0	0
Ивановская область	Частные; Заочная	"    переведено из других образовательных организаций 
    с программ того же уровня / 3.0"	0	0	0	0	0	0	0	0	0	0	0	0	0	0	0	0	0	0	11	11
Ивановская область	Частные; Заочная	    по болезни / 9.0	0	0	0	0	0	0	0	0	0	0	0	0	0	0	0	0	0	0	0	0
Ивановская область	Частные; Заочная	    прибыло по другим причинам / 5.0	0	0	0	0	0	0	0	0	0	0	0	0	0	0	0	0	0	0	9	9
Ивановская область	Частные; Заочная	Выбыло студентов - всего (сумма стр. 07-11, 13-15) / 6.0	0	0	0	0	0	0	0	0	0	0	0	0	0	60	60	0	0	0	68	68
Ивановская область	Частные; Заочная	Прибыло студентов - всего (сумма стр. 02-05) / 1.0	0	0	0	0	0	0	0	0	0	0	0	0	0	0	0	0	0	0	35	35
Ивановская область	Частные; Заочная	"Численность студентов на начало прошлого учебного года
(на 1 октября) / 17.0"	0	0	0	0	0	0	0	0	0	0	0	0	0	510	510	0	0	0	420	420
Ивановская область	Частные; Очная	            из стр. 11 - не прошли итоговую аттестацию / 12.0	0	0	0	0	0	0	0	0	0	0	0	0	0	8	8	0	0	0	2	2
Ивановская область	Частные; Очная	"            из стр. 11 – лица с ограниченными возможностями здоровья,
            инвалиды, дети-инвалиды / 13.0"	0	0	0	0	0	0	0	0	0	0	0	0	0	0	0	0	0	0	0	0
Ивановская область	Частные; Очная	         отчислено в виде меры дисциплинарного взыскания / 14.0	0	0	0	0	0	0	0	0	0	0	0	0	0	8	8	0	0	0	2	2
Ивановская область	Частные; Очная	         отчислено из-за просрочки оплаты обучения / 15.0	0	0	0	0	0	0	0	0	0	0	0	0	0	2	2	0	0	0	3	3
Ивановская область	Частные; Очная	"    в том числе:
    переведено на другие формы обучения данной
    организации на программы того же уровня / 7.0"	0	0	0	0	0	0	0	0	0	0	0	0	0	12	12	0	0	0	0	0
Ивановская область	Частные; Очная	"    в том числе:
    переведено с других форм обучения данной
    образовательной организации с программ того же уровня / 2.0"	0	0	0	0	0	0	0	0	0	0	0	0	0	0	0	0	0	0	0	0
Ивановская область	Частные; Очная	    восстановлены из числа ранее отчисленных / 4.0	0	0	0	0	0	0	0	0	0	0	0	0	0	16	16	0	0	0	0	0
Ивановская область	Частные; Очная	    выбыло по другим причинам / 16.0	0	0	0	0	0	0	0	0	0	0	0	0	0	22	22	0	0	0	3	3
Ивановская область	Частные; Очная	"    добровольно прекратили образовательные отношения
    (бросили учебу) / 10.0"	0	0	0	0	0	0	0	0	0	0	0	0	0	46	46	0	0	0	21	21
Ивановская область	Частные; Очная	"    отчислено:
         по неуспеваемости / 11.0"	0	0	0	0	0	0	0	0	0	0	0	0	0	29	29	0	0	0	6	6
Ивановская область	Частные; Очная	"    переведено в другие образовательные организации
    на программы того же уровня / 8.0"	0	0	0	0	0	0	0	0	0	0	0	0	0	17	17	0	0	0	1	1
Ивановская область	Частные; Очная	"    переведено из других образовательных организаций 
    с программ того же уровня / 3.0"	0	0	0	0	0	0	0	0	0	0	0	0	0	24	24	0	0	0	4	4
Ивановская область	Частные; Очная	    по болезни / 9.0	0	0	0	0	0	0	0	0	0	0	0	0	0	0	0	0	0	0	0	0
Ивановская область	Частные; Очная	    прибыло по другим причинам / 5.0	0	0	0	0	0	0	0	0	0	0	0	0	0	10	10	0	0	0	5	5
Ивановская область	Частные; Очная	Выбыло студентов - всего (сумма стр. 07-11, 13-15) / 6.0	0	0	0	0	0	0	0	0	0	0	0	0	0	136	136	0	0	0	36	36
Ивановская область	Частные; Очная	Прибыло студентов - всего (сумма стр. 02-05) / 1.0	0	0	0	0	0	0	0	0	0	0	0	0	0	50	50	0	0	0	9	9
Ивановская область	Частные; Очная	"Численность студентов на начало прошлого учебного года
(на 1 октября) / 17.0"	0	0	0	0	0	0	0	0	0	0	181	0	0	1297	1478	4	0	0	312	316
Ивановская область	Частные; Очно-заочная	            из стр. 11 - не прошли итоговую аттестацию / 12.0	0	0	0	0	0	0	0	0	0	0	0	0	0	0	0	0	0	0	8	8
Ивановская область	Частные; Очно-заочная	"            из стр. 11 – лица с ограниченными возможностями здоровья,
            инвалиды, дети-инвалиды / 13.0"	0	0	0	0	0	0	0	0	0	0	0	0	0	0	0	0	0	0	0	0
Ивановская область	Частные; Очно-заочная	         отчислено в виде меры дисциплинарного взыскания / 14.0	0	0	0	0	0	0	0	0	0	0	0	0	0	0	0	0	0	0	0	0
Ивановская область	Частные; Очно-заочная	         отчислено из-за просрочки оплаты обучения / 15.0	0	0	0	0	0	0	0	0	0	0	0	0	0	0	0	0	0	0	0	0
Ивановская область	Частные; Очно-заочная	"    в том числе:
    переведено на другие формы обучения данной
    организации на программы того же уровня / 7.0"	0	0	0	0	0	0	0	0	0	0	0	0	0	0	0	0	0	0	0	0
Ивановская область	Частные; Очно-заочная	"    в том числе:
    переведено с других форм обучения данной
    образовательной организации с программ того же уровня / 2.0"	0	0	0	0	0	0	0	0	0	0	0	0	0	0	0	0	0	0	0	0
Ивановская область	Частные; Очно-заочная	    восстановлены из числа ранее отчисленных / 4.0	0	0	0	0	0	0	0	0	0	0	0	0	0	0	0	0	0	0	11	11
Ивановская область	Частные; Очно-заочная	    выбыло по другим причинам / 16.0	0	0	0	0	0	0	0	0	0	0	0	0	0	0	0	0	0	0	16	16
Ивановская область	Частные; Очно-заочная	"    добровольно прекратили образовательные отношения
    (бросили учебу) / 10.0"	0	0	0	0	0	0	0	0	0	0	0	0	0	0	0	0	0	0	22	22
Ивановская область	Частные; Очно-заочная	"    отчислено:
         по неуспеваемости / 11.0"	0	0	0	0	0	0	0	0	0	0	0	0	0	0	0	0	0	0	8	8
Ивановская область	Частные; Очно-заочная	"    переведено в другие образовательные организации
    на программы того же уровня / 8.0"	0	0	0	0	0	0	0	0	0	0	0	0	0	0	0	0	0	0	0	0
Ивановская область	Частные; Очно-заочная	"    переведено из других образовательных организаций 
    с программ того же уровня / 3.0"	0	0	0	0	0	0	0	0	0	0	0	0	0	0	0	0	0	0	0	0
Ивановская область	Частные; Очно-заочная	    по болезни / 9.0	0	0	0	0	0	0	0	0	0	0	0	0	0	0	0	0	0	0	0	0
Ивановская область	Частные; Очно-заочная	    прибыло по другим причинам / 5.0	0	0	0	0	0	0	0	0	0	0	0	0	0	0	0	0	0	0	24	24
Ивановская область	Частные; Очно-заочная	Выбыло студентов - всего (сумма стр. 07-11, 13-15) / 6.0	0	0	0	0	0	0	0	0	0	0	0	0	0	0	0	0	0	0	46	46
Ивановская область	Частные; Очно-заочная	Прибыло студентов - всего (сумма стр. 02-05) / 1.0	0	0	0	0	0	0	0	0	0	0	0	0	0	0	0	0	0	0	35	35
Ивановская область	Частные; Очно-заочная	"Численность студентов на начало прошлого учебного года
(на 1 октября) / 17.0"	0	0	0	0	0	0	0	0	0	0	0	0	0	0	0	0	0	0	517	517
Иркутская область	Государственные, муниципальные (без учета организаций в ведении ФСИН); Заочная	            из стр. 11 - не прошли итоговую аттестацию / 12.0	0	0	0	0	0	0	0	0	0	0	0	0	0	3	3	1	0	0	12	13
Иркутская область	Государственные, муниципальные (без учета организаций в ведении ФСИН); Заочная	"            из стр. 11 – лица с ограниченными возможностями здоровья,
            инвалиды, дети-инвалиды / 13.0"	0	0	0	0	0	0	0	0	0	0	0	0	0	0	0	0	0	0	0	0
Иркутская область	Государственные, муниципальные (без учета организаций в ведении ФСИН); Заочная	         отчислено в виде меры дисциплинарного взыскания / 14.0	0	0	0	0	0	0	0	0	0	0	0	0	0	0	0	0	0	0	0	0
Иркутская область	Государственные, муниципальные (без учета организаций в ведении ФСИН); Заочная	         отчислено из-за просрочки оплаты обучения / 15.0	0	0	0	0	0	0	0	0	0	0	0	0	0	134	134	0	0	0	99	99
Иркутская область	Государственные, муниципальные (без учета организаций в ведении ФСИН); Заочная	"    в том числе:
    переведено на другие формы обучения данной
    организации на программы того же уровня / 7.0"	0	0	0	0	0	0	0	0	0	0	0	2	3	44	49	37	0	3	28	68
Иркутская область	Государственные, муниципальные (без учета организаций в ведении ФСИН); Заочная	"    в том числе:
    переведено с других форм обучения данной
    образовательной организации с программ того же уровня / 2.0"	0	0	0	0	0	0	0	0	0	0	4	0	0	65	69	80	0	11	57	148
Иркутская область	Государственные, муниципальные (без учета организаций в ведении ФСИН); Заочная	    восстановлены из числа ранее отчисленных / 4.0	0	0	0	0	0	0	0	0	0	0	3	0	0	22	25	60	0	6	55	121
Иркутская область	Государственные, муниципальные (без учета организаций в ведении ФСИН); Заочная	    выбыло по другим причинам / 16.0	0	0	0	0	0	0	0	0	0	0	2	0	0	65	67	267	0	12	72	351
Иркутская область	Государственные, муниципальные (без учета организаций в ведении ФСИН); Заочная	"    добровольно прекратили образовательные отношения
    (бросили учебу) / 10.0"	0	0	0	0	0	0	0	0	0	0	4	3	10	36	53	256	0	19	94	369
Иркутская область	Государственные, муниципальные (без учета организаций в ведении ФСИН); Заочная	"    отчислено:
         по неуспеваемости / 11.0"	0	0	0	0	0	0	0	0	0	0	3	11	0	32	46	222	0	4	127	353
Иркутская область	Государственные, муниципальные (без учета организаций в ведении ФСИН); Заочная	"    переведено в другие образовательные организации
    на программы того же уровня / 8.0"	0	0	0	0	0	0	0	0	0	0	0	0	1	3	4	12	0	0	1	13
Иркутская область	Государственные, муниципальные (без учета организаций в ведении ФСИН); Заочная	"    переведено из других образовательных организаций 
    с программ того же уровня / 3.0"	0	0	0	0	0	0	0	0	0	0	1	0	0	6	7	12	0	1	18	31
Иркутская область	Государственные, муниципальные (без учета организаций в ведении ФСИН); Заочная	    по болезни / 9.0	0	0	0	0	0	0	0	0	0	0	0	0	0	0	0	6	0	0	2	8
Иркутская область	Государственные, муниципальные (без учета организаций в ведении ФСИН); Заочная	    прибыло по другим причинам / 5.0	0	0	0	0	0	0	0	0	0	0	16	0	0	61	77	178	0	7	115	300
Иркутская область	Государственные, муниципальные (без учета организаций в ведении ФСИН); Заочная	Выбыло студентов - всего (сумма стр. 07-11, 13-15) / 6.0	0	0	0	0	0	0	0	0	0	0	9	16	14	314	353	800	0	38	423	1261
Иркутская область	Государственные, муниципальные (без учета организаций в ведении ФСИН); Заочная	Прибыло студентов - всего (сумма стр. 02-05) / 1.0	0	0	0	0	0	0	0	0	0	0	24	0	0	154	178	330	0	25	245	600
Иркутская область	Государственные, муниципальные (без учета организаций в ведении ФСИН); Заочная	"Численность студентов на начало прошлого учебного года
(на 1 октября) / 17.0"	0	0	0	0	0	0	0	0	0	0	146	0	25	1001	1172	5850	0	411	1887	8148
Иркутская область	Государственные, муниципальные (без учета организаций в ведении ФСИН); Очная	            из стр. 11 - не прошли итоговую аттестацию / 12.0	14	0	0	0	14	0	0	0	0	0	2	0	22	44	68	1	0	1	20	22
Иркутская область	Государственные, муниципальные (без учета организаций в ведении ФСИН); Очная	"            из стр. 11 – лица с ограниченными возможностями здоровья,
            инвалиды, дети-инвалиды / 13.0"	1	0	0	0	1	0	0	0	0	0	0	0	2	2	4	0	0	0	0	0
Иркутская область	Государственные, муниципальные (без учета организаций в ведении ФСИН); Очная	         отчислено в виде меры дисциплинарного взыскания / 14.0	14	0	0	0	14	0	0	0	0	0	10	0	0	25	35	0	0	1	4	5
Иркутская область	Государственные, муниципальные (без учета организаций в ведении ФСИН); Очная	         отчислено из-за просрочки оплаты обучения / 15.0	0	0	0	7	7	0	0	0	0	0	0	0	0	276	276	0	0	0	55	55
Иркутская область	Государственные, муниципальные (без учета организаций в ведении ФСИН); Очная	"    в том числе:
    переведено на другие формы обучения данной
    организации на программы того же уровня / 7.0"	10	0	0	10	20	0	0	0	0	0	148	0	16	97	261	30	0	9	27	66
Иркутская область	Государственные, муниципальные (без учета организаций в ведении ФСИН); Очная	"    в том числе:
    переведено с других форм обучения данной
    образовательной организации с программ того же уровня / 2.0"	27	0	0	0	27	0	0	0	0	0	136	0	10	37	183	26	0	4	17	47
Иркутская область	Государственные, муниципальные (без учета организаций в ведении ФСИН); Очная	    восстановлены из числа ранее отчисленных / 4.0	52	0	0	1	53	5	0	0	0	5	89	0	42	129	260	8	0	11	42	61
Иркутская область	Государственные, муниципальные (без учета организаций в ведении ФСИН); Очная	    выбыло по другим причинам / 16.0	366	0	0	26	392	10	0	0	1	11	421	0	25	198	644	122	0	0	126	248
Иркутская область	Государственные, муниципальные (без учета организаций в ведении ФСИН); Очная	"    добровольно прекратили образовательные отношения
    (бросили учебу) / 10.0"	702	0	0	21	723	17	0	0	0	17	928	0	222	800	1950	160	0	71	397	628
Иркутская область	Государственные, муниципальные (без учета организаций в ведении ФСИН); Очная	"    отчислено:
         по неуспеваемости / 11.0"	413	0	0	9	422	0	0	0	0	0	355	0	101	350	806	54	0	85	210	349
Иркутская область	Государственные, муниципальные (без учета организаций в ведении ФСИН); Очная	"    переведено в другие образовательные организации
    на программы того же уровня / 8.0"	126	0	0	16	142	2	0	0	0	2	266	0	65	132	463	13	0	3	38	54
Иркутская область	Государственные, муниципальные (без учета организаций в ведении ФСИН); Очная	"    переведено из других образовательных организаций 
    с программ того же уровня / 3.0"	114	0	0	1	115	0	0	0	0	0	130	0	31	71	232	13	0	1	10	24
Иркутская область	Государственные, муниципальные (без учета организаций в ведении ФСИН); Очная	    по болезни / 9.0	15	0	0	1	16	2	0	0	0	2	13	0	0	0	13	4	0	0	0	4
Иркутская область	Государственные, муниципальные (без учета организаций в ведении ФСИН); Очная	    прибыло по другим причинам / 5.0	211	0	0	9	220	18	0	0	0	18	391	0	24	135	550	95	0	11	143	249
Иркутская область	Государственные, муниципальные (без учета организаций в ведении ФСИН); Очная	Выбыло студентов - всего (сумма стр. 07-11, 13-15) / 6.0	1646	0	0	90	1736	31	0	0	1	32	2141	0	429	1878	4448	383	0	169	857	1409
Иркутская область	Государственные, муниципальные (без учета организаций в ведении ФСИН); Очная	Прибыло студентов - всего (сумма стр. 02-05) / 1.0	404	0	0	11	415	23	0	0	0	23	746	0	107	372	1225	142	0	27	212	381
Иркутская область	Государственные, муниципальные (без учета организаций в ведении ФСИН); Очная	"Численность студентов на начало прошлого учебного года
(на 1 октября) / 17.0"	12482	0	0	515	12997	198	0	0	2	200	19075	0	4600	9225	32900	2820	0	1463	3701	7984
Иркутская область	Очно-заочная; Государственные, муниципальные (без учета организаций в ведении ФСИН)	            из стр. 11 - не прошли итоговую аттестацию / 12.0	0	0	0	0	0	0	0	0	0	0	0	0	0	0	0	15	0	0	0	15
Иркутская область	Очно-заочная; Государственные, муниципальные (без учета организаций в ведении ФСИН)	"            из стр. 11 – лица с ограниченными возможностями здоровья,
            инвалиды, дети-инвалиды / 13.0"	0	0	0	0	0	0	0	0	0	0	0	0	0	0	0	1	0	0	0	1
Иркутская область	Очно-заочная; Государственные, муниципальные (без учета организаций в ведении ФСИН)	         отчислено в виде меры дисциплинарного взыскания / 14.0	0	0	0	0	0	0	0	0	0	0	0	0	0	0	0	0	0	0	0	0
Иркутская область	Очно-заочная; Государственные, муниципальные (без учета организаций в ведении ФСИН)	         отчислено из-за просрочки оплаты обучения / 15.0	0	0	0	0	0	0	0	0	0	0	0	0	0	1	1	0	0	0	6	6
Иркутская область	Очно-заочная; Государственные, муниципальные (без учета организаций в ведении ФСИН)	"    в том числе:
    переведено на другие формы обучения данной
    организации на программы того же уровня / 7.0"	0	0	0	0	0	0	0	0	0	0	0	0	0	0	0	1	0	0	11	12
Иркутская область	Очно-заочная; Государственные, муниципальные (без учета организаций в ведении ФСИН)	"    в том числе:
    переведено с других форм обучения данной
    образовательной организации с программ того же уровня / 2.0"	0	0	0	0	0	0	0	0	0	0	1	0	0	2	3	10	0	0	7	17
Иркутская область	Очно-заочная; Государственные, муниципальные (без учета организаций в ведении ФСИН)	    восстановлены из числа ранее отчисленных / 4.0	0	0	0	0	0	0	0	0	0	0	0	0	0	2	2	4	0	0	13	17
Иркутская область	Очно-заочная; Государственные, муниципальные (без учета организаций в ведении ФСИН)	    выбыло по другим причинам / 16.0	0	0	0	0	0	0	0	0	0	0	0	0	0	1	1	2	0	0	5	7
Иркутская область	Очно-заочная; Государственные, муниципальные (без учета организаций в ведении ФСИН)	"    добровольно прекратили образовательные отношения
    (бросили учебу) / 10.0"	1	0	0	0	1	0	0	0	10	10	0	0	0	4	4	34	0	0	30	64
Иркутская область	Очно-заочная; Государственные, муниципальные (без учета организаций в ведении ФСИН)	"    отчислено:
         по неуспеваемости / 11.0"	0	0	0	0	0	0	0	0	0	0	0	0	0	0	0	26	0	0	5	31
Иркутская область	Очно-заочная; Государственные, муниципальные (без учета организаций в ведении ФСИН)	"    переведено в другие образовательные организации
    на программы того же уровня / 8.0"	0	0	0	0	0	0	0	0	0	0	0	0	0	0	0	1	0	0	0	1
Иркутская область	Очно-заочная; Государственные, муниципальные (без учета организаций в ведении ФСИН)	"    переведено из других образовательных организаций 
    с программ того же уровня / 3.0"	0	0	0	0	0	0	0	0	0	0	0	0	0	0	0	0	0	0	2	2
Иркутская область	Очно-заочная; Государственные, муниципальные (без учета организаций в ведении ФСИН)	    по болезни / 9.0	0	0	0	0	0	0	0	0	0	0	2	0	0	0	2	0	0	0	0	0
Иркутская область	Очно-заочная; Государственные, муниципальные (без учета организаций в ведении ФСИН)	    прибыло по другим причинам / 5.0	0	0	0	0	0	0	0	0	0	0	0	0	0	3	3	0	0	0	7	7
Иркутская область	Очно-заочная; Государственные, муниципальные (без учета организаций в ведении ФСИН)	Выбыло студентов - всего (сумма стр. 07-11, 13-15) / 6.0	1	0	0	0	1	0	0	0	10	10	2	0	0	6	8	64	0	0	57	121
Иркутская область	Очно-заочная; Государственные, муниципальные (без учета организаций в ведении ФСИН)	Прибыло студентов - всего (сумма стр. 02-05) / 1.0	0	0	0	0	0	0	0	0	0	0	1	0	0	7	8	14	0	0	29	43
Иркутская область	Очно-заочная; Государственные, муниципальные (без учета организаций в ведении ФСИН)	"Численность студентов на начало прошлого учебного года
(на 1 октября) / 17.0"	19	0	0	0	19	0	0	0	10	10	40	0	0	43	83	387	0	0	559	946
Иркутская область	Частные; Заочная	            из стр. 11 - не прошли итоговую аттестацию / 12.0	0	0	0	0	0	0	0	0	0	0	0	0	0	2	2	0	0	0	0	0
Иркутская область	Частные; Заочная	"            из стр. 11 – лица с ограниченными возможностями здоровья,
            инвалиды, дети-инвалиды / 13.0"	0	0	0	0	0	0	0	0	0	0	0	0	0	0	0	0	0	0	0	0
Иркутская область	Частные; Заочная	         отчислено в виде меры дисциплинарного взыскания / 14.0	0	0	0	0	0	0	0	0	0	0	0	0	0	0	0	0	0	0	0	0
Иркутская область	Частные; Заочная	         отчислено из-за просрочки оплаты обучения / 15.0	0	0	0	0	0	0	0	0	0	0	0	0	0	37	37	0	0	0	58	58
Иркутская область	Частные; Заочная	"    в том числе:
    переведено на другие формы обучения данной
    организации на программы того же уровня / 7.0"	0	0	0	0	0	0	0	0	0	0	0	0	0	42	42	0	0	0	0	0
Иркутская область	Частные; Заочная	"    в том числе:
    переведено с других форм обучения данной
    образовательной организации с программ того же уровня / 2.0"	0	0	0	0	0	0	0	0	0	0	2	0	0	42	44	0	0	0	27	27
Иркутская область	Частные; Заочная	    восстановлены из числа ранее отчисленных / 4.0	0	0	0	0	0	0	0	0	0	0	0	4	0	4	8	0	0	0	10	10
Иркутская область	Частные; Заочная	    выбыло по другим причинам / 16.0	0	0	0	0	0	0	0	0	0	0	0	0	0	4	4	0	0	0	36	36
Иркутская область	Частные; Заочная	"    добровольно прекратили образовательные отношения
    (бросили учебу) / 10.0"	0	0	0	0	0	0	0	0	0	0	2	0	0	25	27	0	0	0	24	24
Иркутская область	Частные; Заочная	"    отчислено:
         по неуспеваемости / 11.0"	0	0	0	0	0	0	0	0	0	0	0	0	0	2	2	3	0	0	21	24
Иркутская область	Частные; Заочная	"    переведено в другие образовательные организации
    на программы того же уровня / 8.0"	0	0	0	0	0	0	0	0	0	0	0	0	0	1	1	0	0	0	7	7
Иркутская область	Частные; Заочная	"    переведено из других образовательных организаций 
    с программ того же уровня / 3.0"	0	0	0	0	0	0	0	0	0	0	0	1	0	8	9	0	0	0	4	4
Иркутская область	Частные; Заочная	    по болезни / 9.0	0	0	0	0	0	0	0	0	0	0	0	0	0	0	0	0	0	0	0	0
Иркутская область	Частные; Заочная	    прибыло по другим причинам / 5.0	0	0	0	0	0	0	0	0	0	0	0	9	0	0	9	0	0	0	36	36
Иркутская область	Частные; Заочная	Выбыло студентов - всего (сумма стр. 07-11, 13-15) / 6.0	0	0	0	0	0	0	0	0	0	0	2	0	0	111	113	3	0	0	146	149
Иркутская область	Частные; Заочная	Прибыло студентов - всего (сумма стр. 02-05) / 1.0	0	0	0	0	0	0	0	0	0	0	2	14	0	54	70	0	0	0	77	77
Иркутская область	Частные; Заочная	"Численность студентов на начало прошлого учебного года
(на 1 октября) / 17.0"	0	0	0	0	0	0	0	0	0	0	2	0	0	298	300	63	0	0	448	511
Иркутская область	Частные; Очная	            из стр. 11 - не прошли итоговую аттестацию / 12.0	0	0	0	0	0	0	0	0	0	0	0	0	0	0	0	0	0	0	0	0
Иркутская область	Частные; Очная	"            из стр. 11 – лица с ограниченными возможностями здоровья,
            инвалиды, дети-инвалиды / 13.0"	0	0	0	0	0	0	0	0	0	0	0	0	0	0	0	0	0	0	0	0
Иркутская область	Частные; Очная	         отчислено в виде меры дисциплинарного взыскания / 14.0	0	0	0	0	0	0	0	0	0	0	0	0	0	0	0	0	0	0	0	0
Иркутская область	Частные; Очная	         отчислено из-за просрочки оплаты обучения / 15.0	0	0	0	0	0	0	0	0	0	0	0	0	0	125	125	0	0	0	46	46
Иркутская область	Частные; Очная	"    в том числе:
    переведено на другие формы обучения данной
    организации на программы того же уровня / 7.0"	0	0	0	0	0	0	0	0	0	0	0	0	0	63	63	0	0	0	19	19
Иркутская область	Частные; Очная	"    в том числе:
    переведено с других форм обучения данной
    образовательной организации с программ того же уровня / 2.0"	0	0	0	0	0	0	0	0	0	0	2	0	0	38	40	0	0	0	6	6
Иркутская область	Частные; Очная	    восстановлены из числа ранее отчисленных / 4.0	0	0	0	0	0	0	0	0	0	0	0	0	0	22	22	0	0	0	6	6
Иркутская область	Частные; Очная	    выбыло по другим причинам / 16.0	0	0	0	0	0	0	0	0	0	0	0	0	0	227	227	0	0	0	84	84
Иркутская область	Частные; Очная	"    добровольно прекратили образовательные отношения
    (бросили учебу) / 10.0"	0	0	0	0	0	0	0	0	0	0	2	0	0	158	160	3	0	0	16	19
Иркутская область	Частные; Очная	"    отчислено:
         по неуспеваемости / 11.0"	0	0	0	0	0	0	0	0	0	0	0	0	0	39	39	0	0	0	13	13
Иркутская область	Частные; Очная	"    переведено в другие образовательные организации
    на программы того же уровня / 8.0"	0	0	0	0	0	0	0	0	0	0	0	0	0	31	31	0	0	0	8	8
Иркутская область	Частные; Очная	"    переведено из других образовательных организаций 
    с программ того же уровня / 3.0"	0	0	0	0	0	0	0	0	0	0	0	0	0	61	61	0	0	0	14	14
Иркутская область	Частные; Очная	    по болезни / 9.0	0	0	0	0	0	0	0	0	0	0	0	0	0	0	0	0	0	0	0	0
Иркутская область	Частные; Очная	    прибыло по другим причинам / 5.0	0	0	0	0	0	0	0	0	0	0	0	0	0	251	251	0	0	0	77	77
Иркутская область	Частные; Очная	Выбыло студентов - всего (сумма стр. 07-11, 13-15) / 6.0	0	0	0	0	0	0	0	0	0	0	2	0	0	643	645	3	0	0	186	189
Иркутская область	Частные; Очная	Прибыло студентов - всего (сумма стр. 02-05) / 1.0	0	0	0	0	0	0	0	0	0	0	2	0	0	372	374	0	0	0	103	103
Иркутская область	Частные; Очная	"Численность студентов на начало прошлого учебного года
(на 1 октября) / 17.0"	0	0	0	0	0	0	0	0	0	0	100	0	0	2162	2262	25	0	0	582	607
Иркутская область	Частные; Очно-заочная	            из стр. 11 - не прошли итоговую аттестацию / 12.0	0	0	0	0	0	0	0	0	0	0	0	0	0	0	0	0	0	0	0	0
Иркутская область	Частные; Очно-заочная	"            из стр. 11 – лица с ограниченными возможностями здоровья,
            инвалиды, дети-инвалиды / 13.0"	0	0	0	0	0	0	0	0	0	0	0	0	0	0	0	0	0	0	0	0
Иркутская область	Частные; Очно-заочная	         отчислено в виде меры дисциплинарного взыскания / 14.0	0	0	0	0	0	0	0	0	0	0	0	0	0	0	0	0	0	0	0	0
Иркутская область	Частные; Очно-заочная	         отчислено из-за просрочки оплаты обучения / 15.0	0	0	0	0	0	0	0	0	0	0	0	0	0	0	0	0	0	0	0	0
Иркутская область	Частные; Очно-заочная	"    в том числе:
    переведено на другие формы обучения данной
    организации на программы того же уровня / 7.0"	0	0	0	0	0	0	0	0	0	0	0	0	0	0	0	0	0	0	0	0
Иркутская область	Частные; Очно-заочная	"    в том числе:
    переведено с других форм обучения данной
    образовательной организации с программ того же уровня / 2.0"	0	0	0	0	0	0	0	0	0	0	0	0	0	0	0	0	0	0	0	0
Иркутская область	Частные; Очно-заочная	    восстановлены из числа ранее отчисленных / 4.0	0	0	0	0	0	0	0	0	0	0	0	0	0	0	0	0	0	0	0	0
Иркутская область	Частные; Очно-заочная	    выбыло по другим причинам / 16.0	0	0	0	0	0	0	0	0	0	0	0	0	0	0	0	0	0	0	0	0
Иркутская область	Частные; Очно-заочная	"    добровольно прекратили образовательные отношения
    (бросили учебу) / 10.0"	0	0	0	0	0	0	0	0	0	0	0	0	0	0	0	0	0	0	9	9
Иркутская область	Частные; Очно-заочная	"    отчислено:
         по неуспеваемости / 11.0"	0	0	0	0	0	0	0	0	0	0	0	0	0	0	0	0	0	0	0	0
Иркутская область	Частные; Очно-заочная	"    переведено в другие образовательные организации
    на программы того же уровня / 8.0"	0	0	0	0	0	0	0	0	0	0	0	0	0	0	0	0	0	0	0	0
Иркутская область	Частные; Очно-заочная	"    переведено из других образовательных организаций 
    с программ того же уровня / 3.0"	0	0	0	0	0	0	0	0	0	0	0	0	0	0	0	0	0	0	0	0
Иркутская область	Частные; Очно-заочная	    по болезни / 9.0	0	0	0	0	0	0	0	0	0	0	0	0	0	0	0	0	0	0	0	0
Иркутская область	Частные; Очно-заочная	    прибыло по другим причинам / 5.0	0	0	0	0	0	0	0	0	0	0	0	0	0	0	0	0	0	0	0	0
Иркутская область	Частные; Очно-заочная	Выбыло студентов - всего (сумма стр. 07-11, 13-15) / 6.0	0	0	0	0	0	0	0	0	0	0	0	0	0	0	0	0	0	0	9	9
Иркутская область	Частные; Очно-заочная	Прибыло студентов - всего (сумма стр. 02-05) / 1.0	0	0	0	0	0	0	0	0	0	0	0	0	0	0	0	0	0	0	0	0
Иркутская область	Частные; Очно-заочная	"Численность студентов на начало прошлого учебного года
(на 1 октября) / 17.0"	0	0	0	0	0	0	0	0	0	0	0	0	0	0	0	0	0	0	95	95
Кабардино-Балкарская Республика	Государственные, муниципальные (без учета организаций в ведении ФСИН); Заочная	            из стр. 11 - не прошли итоговую аттестацию / 12.0	0	0	0	0	0	0	0	0	0	0	0	0	0	0	0	1	0	0	1	2
Кабардино-Балкарская Республика	Государственные, муниципальные (без учета организаций в ведении ФСИН); Заочная	"            из стр. 11 – лица с ограниченными возможностями здоровья,
            инвалиды, дети-инвалиды / 13.0"	0	0	0	0	0	0	0	0	0	0	0	0	0	0	0	0	0	0	0	0
Кабардино-Балкарская Республика	Государственные, муниципальные (без учета организаций в ведении ФСИН); Заочная	         отчислено в виде меры дисциплинарного взыскания / 14.0	0	0	0	0	0	0	0	0	0	0	0	0	0	0	0	0	0	0	3	3
Кабардино-Балкарская Республика	Государственные, муниципальные (без учета организаций в ведении ФСИН); Заочная	         отчислено из-за просрочки оплаты обучения / 15.0	0	0	0	0	0	0	0	0	0	0	0	0	0	0	0	0	0	0	7	7
Кабардино-Балкарская Республика	Государственные, муниципальные (без учета организаций в ведении ФСИН); Заочная	"    в том числе:
    переведено на другие формы обучения данной
    организации на программы того же уровня / 7.0"	0	0	0	0	0	0	0	0	0	0	5	0	0	8	13	4	0	0	5	9
Кабардино-Балкарская Республика	Государственные, муниципальные (без учета организаций в ведении ФСИН); Заочная	"    в том числе:
    переведено с других форм обучения данной
    образовательной организации с программ того же уровня / 2.0"	0	0	0	0	0	0	0	0	0	0	6	0	0	23	29	5	0	0	31	36
Кабардино-Балкарская Республика	Государственные, муниципальные (без учета организаций в ведении ФСИН); Заочная	    восстановлены из числа ранее отчисленных / 4.0	0	0	0	0	0	0	0	0	0	0	0	0	0	6	6	0	0	0	9	9
Кабардино-Балкарская Республика	Государственные, муниципальные (без учета организаций в ведении ФСИН); Заочная	    выбыло по другим причинам / 16.0	0	0	0	0	0	0	0	0	0	0	0	0	0	0	0	0	0	0	9	9
Кабардино-Балкарская Республика	Государственные, муниципальные (без учета организаций в ведении ФСИН); Заочная	"    добровольно прекратили образовательные отношения
    (бросили учебу) / 10.0"	0	0	0	0	0	0	0	0	0	0	2	0	0	12	14	83	0	0	0	83
Кабардино-Балкарская Республика	Государственные, муниципальные (без учета организаций в ведении ФСИН); Заочная	"    отчислено:
         по неуспеваемости / 11.0"	0	0	0	0	0	0	0	0	0	0	8	0	0	46	54	13	0	32	32	77
Кабардино-Балкарская Республика	Государственные, муниципальные (без учета организаций в ведении ФСИН); Заочная	"    переведено в другие образовательные организации
    на программы того же уровня / 8.0"	0	0	0	0	0	0	0	0	0	0	0	0	0	3	3	1	0	1	0	2
Кабардино-Балкарская Республика	Государственные, муниципальные (без учета организаций в ведении ФСИН); Заочная	"    переведено из других образовательных организаций 
    с программ того же уровня / 3.0"	0	0	0	0	0	0	0	0	0	0	0	0	0	3	3	2	0	0	13	15
Кабардино-Балкарская Республика	Государственные, муниципальные (без учета организаций в ведении ФСИН); Заочная	    по болезни / 9.0	0	0	0	0	0	0	0	0	0	0	0	0	0	0	0	0	0	0	0	0
Кабардино-Балкарская Республика	Государственные, муниципальные (без учета организаций в ведении ФСИН); Заочная	    прибыло по другим причинам / 5.0	0	0	0	0	0	0	0	0	0	0	0	0	0	0	0	0	0	8	5	13
Кабардино-Балкарская Республика	Государственные, муниципальные (без учета организаций в ведении ФСИН); Заочная	Выбыло студентов - всего (сумма стр. 07-11, 13-15) / 6.0	0	0	0	0	0	0	0	0	0	0	15	0	0	69	84	101	0	33	56	190
Кабардино-Балкарская Республика	Государственные, муниципальные (без учета организаций в ведении ФСИН); Заочная	Прибыло студентов - всего (сумма стр. 02-05) / 1.0	0	0	0	0	0	0	0	0	0	0	6	0	0	32	38	7	0	8	58	73
Кабардино-Балкарская Республика	Государственные, муниципальные (без учета организаций в ведении ФСИН); Заочная	"Численность студентов на начало прошлого учебного года
(на 1 октября) / 17.0"	0	0	0	0	0	0	0	0	0	0	170	0	0	293	463	1350	0	75	242	1667
Кабардино-Балкарская Республика	Государственные, муниципальные (без учета организаций в ведении ФСИН); Очная	            из стр. 11 - не прошли итоговую аттестацию / 12.0	12	0	0	0	12	1	0	0	1	2	3	0	0	0	3	1	0	0	0	1
Кабардино-Балкарская Республика	Государственные, муниципальные (без учета организаций в ведении ФСИН); Очная	"            из стр. 11 – лица с ограниченными возможностями здоровья,
            инвалиды, дети-инвалиды / 13.0"	0	0	0	0	0	0	0	0	0	0	0	0	0	0	0	0	0	0	0	0
Кабардино-Балкарская Республика	Государственные, муниципальные (без учета организаций в ведении ФСИН); Очная	         отчислено в виде меры дисциплинарного взыскания / 14.0	4	0	0	0	4	0	0	0	2	2	25	0	0	2	27	5	0	0	1	6
Кабардино-Балкарская Республика	Государственные, муниципальные (без учета организаций в ведении ФСИН); Очная	         отчислено из-за просрочки оплаты обучения / 15.0	0	0	0	5	5	0	0	0	12	12	0	0	0	20	20	0	0	0	4	4
Кабардино-Балкарская Республика	Государственные, муниципальные (без учета организаций в ведении ФСИН); Очная	"    в том числе:
    переведено на другие формы обучения данной
    организации на программы того же уровня / 7.0"	2	0	0	0	2	0	0	0	0	0	31	0	0	15	46	0	0	0	0	0
Кабардино-Балкарская Республика	Государственные, муниципальные (без учета организаций в ведении ФСИН); Очная	"    в том числе:
    переведено с других форм обучения данной
    образовательной организации с программ того же уровня / 2.0"	6	0	0	0	6	0	0	0	1	1	1	0	0	0	1	7	0	0	3	10
Кабардино-Балкарская Республика	Государственные, муниципальные (без учета организаций в ведении ФСИН); Очная	    восстановлены из числа ранее отчисленных / 4.0	18	0	0	0	18	1	0	0	0	1	14	0	9	25	48	6	0	0	1	7
Кабардино-Балкарская Республика	Государственные, муниципальные (без учета организаций в ведении ФСИН); Очная	    выбыло по другим причинам / 16.0	94	0	0	0	94	4	0	0	2	6	64	0	2	18	84	26	0	0	0	26
Кабардино-Балкарская Республика	Государственные, муниципальные (без учета организаций в ведении ФСИН); Очная	"    добровольно прекратили образовательные отношения
    (бросили учебу) / 10.0"	183	0	0	5	188	26	0	0	3	29	126	0	52	56	234	52	0	40	51	143
Кабардино-Балкарская Республика	Государственные, муниципальные (без учета организаций в ведении ФСИН); Очная	"    отчислено:
         по неуспеваемости / 11.0"	110	0	0	0	110	2	0	0	1	3	53	0	63	38	154	9	0	5	7	21
Кабардино-Балкарская Республика	Государственные, муниципальные (без учета организаций в ведении ФСИН); Очная	"    переведено в другие образовательные организации
    на программы того же уровня / 8.0"	28	0	0	0	28	1	0	0	0	1	41	0	16	34	91	0	0	0	3	3
Кабардино-Балкарская Республика	Государственные, муниципальные (без учета организаций в ведении ФСИН); Очная	"    переведено из других образовательных организаций 
    с программ того же уровня / 3.0"	16	0	0	0	16	0	0	0	1	1	22	0	2	3	27	14	0	0	1	15
Кабардино-Балкарская Республика	Государственные, муниципальные (без учета организаций в ведении ФСИН); Очная	    по болезни / 9.0	0	0	0	0	0	0	0	0	0	0	1	0	2	1	4	0	0	0	24	24
Кабардино-Балкарская Республика	Государственные, муниципальные (без учета организаций в ведении ФСИН); Очная	    прибыло по другим причинам / 5.0	149	0	0	0	149	14	0	0	2	16	29	0	0	34	63	6	0	0	10	16
Кабардино-Балкарская Республика	Государственные, муниципальные (без учета организаций в ведении ФСИН); Очная	Выбыло студентов - всего (сумма стр. 07-11, 13-15) / 6.0	421	0	0	10	431	33	0	0	20	53	341	0	135	184	660	92	0	45	90	227
Кабардино-Балкарская Республика	Государственные, муниципальные (без учета организаций в ведении ФСИН); Очная	Прибыло студентов - всего (сумма стр. 02-05) / 1.0	189	0	0	0	189	15	0	0	4	19	66	0	11	62	139	33	0	0	15	48
Кабардино-Балкарская Республика	Государственные, муниципальные (без учета организаций в ведении ФСИН); Очная	"Численность студентов на начало прошлого учебного года
(на 1 октября) / 17.0"	2984	0	0	45	3029	195	0	0	39	234	3130	0	1575	2546	7251	515	0	957	965	2437
Кабардино-Балкарская Республика	Очно-заочная; Государственные, муниципальные (без учета организаций в ведении ФСИН)	            из стр. 11 - не прошли итоговую аттестацию / 12.0	0	0	0	0	0	0	0	0	0	0	0	0	0	0	0	0	0	0	0	0
Кабардино-Балкарская Республика	Очно-заочная; Государственные, муниципальные (без учета организаций в ведении ФСИН)	"            из стр. 11 – лица с ограниченными возможностями здоровья,
            инвалиды, дети-инвалиды / 13.0"	0	0	0	0	0	0	0	0	0	0	0	0	0	0	0	0	0	0	0	0
Кабардино-Балкарская Республика	Очно-заочная; Государственные, муниципальные (без учета организаций в ведении ФСИН)	         отчислено в виде меры дисциплинарного взыскания / 14.0	0	0	0	0	0	0	0	0	0	0	0	0	0	0	0	0	0	0	0	0
Кабардино-Балкарская Республика	Очно-заочная; Государственные, муниципальные (без учета организаций в ведении ФСИН)	         отчислено из-за просрочки оплаты обучения / 15.0	0	0	0	0	0	0	0	0	0	0	0	0	0	0	0	0	0	0	1	1
Кабардино-Балкарская Республика	Очно-заочная; Государственные, муниципальные (без учета организаций в ведении ФСИН)	"    в том числе:
    переведено на другие формы обучения данной
    организации на программы того же уровня / 7.0"	0	0	0	0	0	0	0	0	0	0	0	0	0	0	0	0	0	0	0	0
Кабардино-Балкарская Республика	Очно-заочная; Государственные, муниципальные (без учета организаций в ведении ФСИН)	"    в том числе:
    переведено с других форм обучения данной
    образовательной организации с программ того же уровня / 2.0"	0	0	0	0	0	0	0	0	0	0	0	0	0	0	0	0	0	0	0	0
Кабардино-Балкарская Республика	Очно-заочная; Государственные, муниципальные (без учета организаций в ведении ФСИН)	    восстановлены из числа ранее отчисленных / 4.0	0	0	0	0	0	0	0	0	0	0	0	0	0	6	6	0	0	0	0	0
Кабардино-Балкарская Республика	Очно-заочная; Государственные, муниципальные (без учета организаций в ведении ФСИН)	    выбыло по другим причинам / 16.0	0	0	0	0	0	0	0	0	0	0	0	0	0	0	0	0	0	0	0	0
Кабардино-Балкарская Республика	Очно-заочная; Государственные, муниципальные (без учета организаций в ведении ФСИН)	"    добровольно прекратили образовательные отношения
    (бросили учебу) / 10.0"	0	0	0	0	0	0	0	0	0	0	0	0	0	0	0	0	0	0	2	2
Кабардино-Балкарская Республика	Очно-заочная; Государственные, муниципальные (без учета организаций в ведении ФСИН)	"    отчислено:
         по неуспеваемости / 11.0"	0	0	0	0	0	0	0	0	0	0	0	0	0	0	0	0	8	0	0	8
Кабардино-Балкарская Республика	Очно-заочная; Государственные, муниципальные (без учета организаций в ведении ФСИН)	"    переведено в другие образовательные организации
    на программы того же уровня / 8.0"	0	0	0	0	0	0	0	0	0	0	0	0	0	0	0	0	0	0	0	0
Кабардино-Балкарская Республика	Очно-заочная; Государственные, муниципальные (без учета организаций в ведении ФСИН)	"    переведено из других образовательных организаций 
    с программ того же уровня / 3.0"	0	0	0	0	0	0	0	0	0	0	0	0	0	0	0	0	0	0	0	0
Кабардино-Балкарская Республика	Очно-заочная; Государственные, муниципальные (без учета организаций в ведении ФСИН)	    по болезни / 9.0	0	0	0	0	0	0	0	0	0	0	0	0	0	0	0	0	0	0	0	0
Кабардино-Балкарская Республика	Очно-заочная; Государственные, муниципальные (без учета организаций в ведении ФСИН)	    прибыло по другим причинам / 5.0	0	0	0	0	0	0	0	0	0	0	0	0	0	0	0	0	0	0	0	0
Кабардино-Балкарская Республика	Очно-заочная; Государственные, муниципальные (без учета организаций в ведении ФСИН)	Выбыло студентов - всего (сумма стр. 07-11, 13-15) / 6.0	0	0	0	0	0	0	0	0	0	0	0	0	0	0	0	0	8	0	3	11
Кабардино-Балкарская Республика	Очно-заочная; Государственные, муниципальные (без учета организаций в ведении ФСИН)	Прибыло студентов - всего (сумма стр. 02-05) / 1.0	0	0	0	0	0	0	0	0	0	0	0	0	0	6	6	0	0	0	0	0
Кабардино-Балкарская Республика	Очно-заочная; Государственные, муниципальные (без учета организаций в ведении ФСИН)	"Численность студентов на начало прошлого учебного года
(на 1 октября) / 17.0"	0	0	0	0	0	0	0	0	0	0	0	0	0	34	34	0	0	0	133	133
Кабардино-Балкарская Республика	Частные; Очная	            из стр. 11 - не прошли итоговую аттестацию / 12.0	0	0	0	0	0	0	0	0	0	0	0	0	0	0	0	0	0	0	0	0
Кабардино-Балкарская Республика	Частные; Очная	"            из стр. 11 – лица с ограниченными возможностями здоровья,
            инвалиды, дети-инвалиды / 13.0"	0	0	0	0	0	0	0	0	0	0	0	0	0	0	0	0	0	0	0	0
Кабардино-Балкарская Республика	Частные; Очная	         отчислено в виде меры дисциплинарного взыскания / 14.0	0	0	0	0	0	0	0	0	0	0	0	0	0	2	2	0	0	0	0	0
Кабардино-Балкарская Республика	Частные; Очная	         отчислено из-за просрочки оплаты обучения / 15.0	0	0	0	0	0	0	0	0	0	0	0	0	0	9	9	0	0	0	3	3
Кабардино-Балкарская Республика	Частные; Очная	"    в том числе:
    переведено на другие формы обучения данной
    организации на программы того же уровня / 7.0"	0	0	0	0	0	0	0	0	0	0	0	0	0	0	0	0	0	0	0	0
Кабардино-Балкарская Республика	Частные; Очная	"    в том числе:
    переведено с других форм обучения данной
    образовательной организации с программ того же уровня / 2.0"	0	0	0	0	0	0	0	0	0	0	0	0	0	30	30	0	0	0	0	0
Кабардино-Балкарская Республика	Частные; Очная	    восстановлены из числа ранее отчисленных / 4.0	0	0	0	0	0	0	0	0	0	0	0	0	0	11	11	0	0	0	2	2
Кабардино-Балкарская Республика	Частные; Очная	    выбыло по другим причинам / 16.0	0	0	0	0	0	0	0	0	0	0	0	0	0	45	45	0	0	0	11	11
Кабардино-Балкарская Республика	Частные; Очная	"    добровольно прекратили образовательные отношения
    (бросили учебу) / 10.0"	0	0	0	0	0	0	0	0	0	0	0	0	0	44	44	0	0	0	20	20
Кабардино-Балкарская Республика	Частные; Очная	"    отчислено:
         по неуспеваемости / 11.0"	0	0	0	0	0	0	0	0	0	0	0	0	0	39	39	0	0	0	22	22
Кабардино-Балкарская Республика	Частные; Очная	"    переведено в другие образовательные организации
    на программы того же уровня / 8.0"	0	0	0	0	0	0	0	0	0	0	0	0	0	8	8	0	0	0	0	0
Кабардино-Балкарская Республика	Частные; Очная	"    переведено из других образовательных организаций 
    с программ того же уровня / 3.0"	0	0	0	0	0	0	0	0	0	0	0	0	0	17	17	0	0	0	6	6
Кабардино-Балкарская Республика	Частные; Очная	    по болезни / 9.0	0	0	0	0	0	0	0	0	0	0	0	0	0	0	0	0	0	0	0	0
Кабардино-Балкарская Республика	Частные; Очная	    прибыло по другим причинам / 5.0	0	0	0	0	0	0	0	0	0	0	0	0	0	16	16	0	0	0	4	4
Кабардино-Балкарская Республика	Частные; Очная	Выбыло студентов - всего (сумма стр. 07-11, 13-15) / 6.0	0	0	0	0	0	0	0	0	0	0	0	0	0	147	147	0	0	0	56	56
Кабардино-Балкарская Республика	Частные; Очная	Прибыло студентов - всего (сумма стр. 02-05) / 1.0	0	0	0	0	0	0	0	0	0	0	0	0	0	74	74	0	0	0	12	12
Кабардино-Балкарская Республика	Частные; Очная	"Численность студентов на начало прошлого учебного года
(на 1 октября) / 17.0"	0	0	0	0	0	0	0	0	0	0	0	0	0	1284	1284	0	0	0	603	603
Кабардино-Балкарская Республика	Частные; Очно-заочная	            из стр. 11 - не прошли итоговую аттестацию / 12.0	0	0	0	0	0	0	0	0	0	0	0	0	0	0	0	0	0	0	0	0
Кабардино-Балкарская Республика	Частные; Очно-заочная	"            из стр. 11 – лица с ограниченными возможностями здоровья,
            инвалиды, дети-инвалиды / 13.0"	0	0	0	0	0	0	0	0	0	0	0	0	0	0	0	0	0	0	0	0
Кабардино-Балкарская Республика	Частные; Очно-заочная	         отчислено в виде меры дисциплинарного взыскания / 14.0	0	0	0	0	0	0	0	0	0	0	0	0	0	0	0	0	0	0	0	0
Кабардино-Балкарская Республика	Частные; Очно-заочная	         отчислено из-за просрочки оплаты обучения / 15.0	0	0	0	0	0	0	0	0	0	0	0	0	0	0	0	0	0	0	0	0
Кабардино-Балкарская Республика	Частные; Очно-заочная	"    в том числе:
    переведено на другие формы обучения данной
    организации на программы того же уровня / 7.0"	0	0	0	0	0	0	0	0	0	0	0	0	0	0	0	0	0	0	0	0
Кабардино-Балкарская Республика	Частные; Очно-заочная	"    в том числе:
    переведено с других форм обучения данной
    образовательной организации с программ того же уровня / 2.0"	0	0	0	0	0	0	0	0	0	0	0	0	0	0	0	0	0	0	0	0
Кабардино-Балкарская Республика	Частные; Очно-заочная	    восстановлены из числа ранее отчисленных / 4.0	0	0	0	0	0	0	0	0	0	0	0	0	0	0	0	0	0	0	1	1
Кабардино-Балкарская Республика	Частные; Очно-заочная	    выбыло по другим причинам / 16.0	0	0	0	0	0	0	0	0	0	0	0	0	0	0	0	0	0	0	7	7
Кабардино-Балкарская Республика	Частные; Очно-заочная	"    добровольно прекратили образовательные отношения
    (бросили учебу) / 10.0"	0	0	0	0	0	0	0	0	0	0	0	0	0	0	0	0	0	0	9	9
Кабардино-Балкарская Республика	Частные; Очно-заочная	"    отчислено:
         по неуспеваемости / 11.0"	0	0	0	0	0	0	0	0	0	0	0	0	0	2	2	0	0	0	2	2
Кабардино-Балкарская Республика	Частные; Очно-заочная	"    переведено в другие образовательные организации
    на программы того же уровня / 8.0"	0	0	0	0	0	0	0	0	0	0	0	0	0	0	0	0	0	0	0	0
Кабардино-Балкарская Республика	Частные; Очно-заочная	"    переведено из других образовательных организаций 
    с программ того же уровня / 3.0"	0	0	0	0	0	0	0	0	0	0	0	0	0	0	0	0	0	0	3	3
Кабардино-Балкарская Республика	Частные; Очно-заочная	    по болезни / 9.0	0	0	0	0	0	0	0	0	0	0	0	0	0	0	0	0	0	0	0	0
Кабардино-Балкарская Республика	Частные; Очно-заочная	    прибыло по другим причинам / 5.0	0	0	0	0	0	0	0	0	0	0	0	0	0	0	0	0	0	0	6	6
Кабардино-Балкарская Республика	Частные; Очно-заочная	Выбыло студентов - всего (сумма стр. 07-11, 13-15) / 6.0	0	0	0	0	0	0	0	0	0	0	0	0	0	2	2	0	0	0	18	18
Кабардино-Балкарская Республика	Частные; Очно-заочная	Прибыло студентов - всего (сумма стр. 02-05) / 1.0	0	0	0	0	0	0	0	0	0	0	0	0	0	0	0	0	0	0	10	10
Кабардино-Балкарская Республика	Частные; Очно-заочная	"Численность студентов на начало прошлого учебного года
(на 1 октября) / 17.0"	0	0	0	0	0	0	0	0	0	0	0	0	0	9	9	0	0	0	140	140
Калининградская область	Государственные, муниципальные (без учета организаций в ведении ФСИН); Заочная	            из стр. 11 - не прошли итоговую аттестацию / 12.0	0	0	0	0	0	0	0	0	0	0	0	0	0	0	0	0	0	0	3	3
Калининградская область	Государственные, муниципальные (без учета организаций в ведении ФСИН); Заочная	"            из стр. 11 – лица с ограниченными возможностями здоровья,
            инвалиды, дети-инвалиды / 13.0"	0	0	0	0	0	0	0	0	0	0	0	0	0	0	0	0	0	0	0	0
Калининградская область	Государственные, муниципальные (без учета организаций в ведении ФСИН); Заочная	         отчислено в виде меры дисциплинарного взыскания / 14.0	0	0	0	0	0	0	0	0	0	0	0	0	0	0	0	0	0	0	0	0
Калининградская область	Государственные, муниципальные (без учета организаций в ведении ФСИН); Заочная	         отчислено из-за просрочки оплаты обучения / 15.0	0	0	0	0	0	0	0	0	0	0	0	0	0	0	0	0	0	0	12	12
Калининградская область	Государственные, муниципальные (без учета организаций в ведении ФСИН); Заочная	"    в том числе:
    переведено на другие формы обучения данной
    организации на программы того же уровня / 7.0"	0	0	0	0	0	0	0	0	0	0	0	0	0	0	0	0	0	0	5	5
Калининградская область	Государственные, муниципальные (без учета организаций в ведении ФСИН); Заочная	"    в том числе:
    переведено с других форм обучения данной
    образовательной организации с программ того же уровня / 2.0"	0	0	0	0	0	0	0	0	0	0	0	0	0	3	3	0	0	0	31	31
Калининградская область	Государственные, муниципальные (без учета организаций в ведении ФСИН); Заочная	    восстановлены из числа ранее отчисленных / 4.0	0	0	0	0	0	0	0	0	0	0	0	0	0	0	0	0	0	0	29	29
Калининградская область	Государственные, муниципальные (без учета организаций в ведении ФСИН); Заочная	    выбыло по другим причинам / 16.0	0	0	0	0	0	0	0	0	0	0	0	0	0	0	0	1	0	0	27	28
Калининградская область	Государственные, муниципальные (без учета организаций в ведении ФСИН); Заочная	"    добровольно прекратили образовательные отношения
    (бросили учебу) / 10.0"	0	0	0	0	0	0	0	0	0	0	0	0	0	32	32	1	0	0	99	100
Калининградская область	Государственные, муниципальные (без учета организаций в ведении ФСИН); Заочная	"    отчислено:
         по неуспеваемости / 11.0"	0	0	0	0	0	0	0	0	0	0	0	0	0	0	0	1	0	0	97	98
Калининградская область	Государственные, муниципальные (без учета организаций в ведении ФСИН); Заочная	"    переведено в другие образовательные организации
    на программы того же уровня / 8.0"	0	0	0	0	0	0	0	0	0	0	0	0	0	0	0	0	0	0	3	3
Калининградская область	Государственные, муниципальные (без учета организаций в ведении ФСИН); Заочная	"    переведено из других образовательных организаций 
    с программ того же уровня / 3.0"	0	0	0	0	0	0	0	0	0	0	0	0	0	1	1	0	0	0	3	3
Калининградская область	Государственные, муниципальные (без учета организаций в ведении ФСИН); Заочная	    по болезни / 9.0	0	0	0	0	0	0	0	0	0	0	0	0	0	0	0	0	0	0	0	0
Калининградская область	Государственные, муниципальные (без учета организаций в ведении ФСИН); Заочная	    прибыло по другим причинам / 5.0	0	0	0	0	0	0	0	0	0	0	0	0	0	15	15	0	0	0	13	13
Калининградская область	Государственные, муниципальные (без учета организаций в ведении ФСИН); Заочная	Выбыло студентов - всего (сумма стр. 07-11, 13-15) / 6.0	0	0	0	0	0	0	0	0	0	0	0	0	0	32	32	3	0	0	243	246
Калининградская область	Государственные, муниципальные (без учета организаций в ведении ФСИН); Заочная	Прибыло студентов - всего (сумма стр. 02-05) / 1.0	0	0	0	0	0	0	0	0	0	0	0	0	0	19	19	0	0	0	76	76
Калининградская область	Государственные, муниципальные (без учета организаций в ведении ФСИН); Заочная	"Численность студентов на начало прошлого учебного года
(на 1 октября) / 17.0"	0	0	0	0	0	0	0	0	0	0	0	0	0	110	110	34	0	0	1437	1471
Калининградская область	Государственные, муниципальные (без учета организаций в ведении ФСИН); Очная	            из стр. 11 - не прошли итоговую аттестацию / 12.0	4	0	0	1	5	0	0	0	0	0	1	0	0	5	6	0	0	0	0	0
Калининградская область	Государственные, муниципальные (без учета организаций в ведении ФСИН); Очная	"            из стр. 11 – лица с ограниченными возможностями здоровья,
            инвалиды, дети-инвалиды / 13.0"	0	0	0	0	0	0	0	0	0	0	1	0	0	0	1	0	0	0	0	0
Калининградская область	Государственные, муниципальные (без учета организаций в ведении ФСИН); Очная	         отчислено в виде меры дисциплинарного взыскания / 14.0	0	0	0	1	1	0	0	0	0	0	3	0	0	4	7	1	0	0	1	2
Калининградская область	Государственные, муниципальные (без учета организаций в ведении ФСИН); Очная	         отчислено из-за просрочки оплаты обучения / 15.0	0	0	0	12	12	0	0	0	0	0	0	0	0	32	32	0	0	0	17	17
Калининградская область	Государственные, муниципальные (без учета организаций в ведении ФСИН); Очная	"    в том числе:
    переведено на другие формы обучения данной
    организации на программы того же уровня / 7.0"	16	0	0	2	18	3	0	0	0	3	20	0	10	46	76	3	0	1	5	9
Калининградская область	Государственные, муниципальные (без учета организаций в ведении ФСИН); Очная	"    в том числе:
    переведено с других форм обучения данной
    образовательной организации с программ того же уровня / 2.0"	21	0	0	2	23	1	0	0	0	1	14	0	0	20	34	1	0	1	6	8
Калининградская область	Государственные, муниципальные (без учета организаций в ведении ФСИН); Очная	    восстановлены из числа ранее отчисленных / 4.0	19	0	0	7	26	0	0	0	0	0	17	0	7	89	113	15	0	7	15	37
Калининградская область	Государственные, муниципальные (без учета организаций в ведении ФСИН); Очная	    выбыло по другим причинам / 16.0	12	0	5	23	40	3	0	0	0	3	28	0	13	108	149	13	0	0	21	34
Калининградская область	Государственные, муниципальные (без учета организаций в ведении ФСИН); Очная	"    добровольно прекратили образовательные отношения
    (бросили учебу) / 10.0"	153	0	0	87	240	8	0	0	0	8	318	0	67	357	742	111	0	23	105	239
Калининградская область	Государственные, муниципальные (без учета организаций в ведении ФСИН); Очная	"    отчислено:
         по неуспеваемости / 11.0"	71	0	0	14	85	3	0	0	0	3	100	0	21	71	192	66	0	19	43	128
Калининградская область	Государственные, муниципальные (без учета организаций в ведении ФСИН); Очная	"    переведено в другие образовательные организации
    на программы того же уровня / 8.0"	9	0	1	1	11	1	0	0	0	1	50	0	41	180	271	6	0	4	18	28
Калининградская область	Государственные, муниципальные (без учета организаций в ведении ФСИН); Очная	"    переведено из других образовательных организаций 
    с программ того же уровня / 3.0"	10	0	0	8	18	1	0	0	0	1	47	0	5	74	126	10	0	2	22	34
Калининградская область	Государственные, муниципальные (без учета организаций в ведении ФСИН); Очная	    по болезни / 9.0	0	0	0	0	0	0	0	0	0	0	3	0	0	0	3	0	0	0	0	0
Калининградская область	Государственные, муниципальные (без учета организаций в ведении ФСИН); Очная	    прибыло по другим причинам / 5.0	3	0	0	8	11	0	0	0	0	0	51	0	21	20	92	21	0	8	21	50
Калининградская область	Государственные, муниципальные (без учета организаций в ведении ФСИН); Очная	Выбыло студентов - всего (сумма стр. 07-11, 13-15) / 6.0	261	0	6	140	407	18	0	0	0	18	522	0	152	798	1472	200	0	47	210	457
Калининградская область	Государственные, муниципальные (без учета организаций в ведении ФСИН); Очная	Прибыло студентов - всего (сумма стр. 02-05) / 1.0	53	0	0	25	78	2	0	0	0	2	129	0	33	203	365	47	0	18	64	129
Калининградская область	Государственные, муниципальные (без учета организаций в ведении ФСИН); Очная	"Численность студентов на начало прошлого учебного года
(на 1 октября) / 17.0"	2067	0	6	961	3034	85	0	0	10	95	6086	0	3319	4622	14027	1162	0	536	895	2593
Калининградская область	Очно-заочная; Государственные, муниципальные (без учета организаций в ведении ФСИН)	            из стр. 11 - не прошли итоговую аттестацию / 12.0	0	0	0	0	0	0	0	0	0	0	0	0	0	0	0	0	0	0	0	0
Калининградская область	Очно-заочная; Государственные, муниципальные (без учета организаций в ведении ФСИН)	"            из стр. 11 – лица с ограниченными возможностями здоровья,
            инвалиды, дети-инвалиды / 13.0"	0	0	0	0	0	0	0	0	0	0	0	0	0	0	0	0	0	0	0	0
Калининградская область	Очно-заочная; Государственные, муниципальные (без учета организаций в ведении ФСИН)	         отчислено в виде меры дисциплинарного взыскания / 14.0	0	0	0	0	0	0	0	0	0	0	0	0	0	0	0	0	0	0	25	25
Калининградская область	Очно-заочная; Государственные, муниципальные (без учета организаций в ведении ФСИН)	         отчислено из-за просрочки оплаты обучения / 15.0	0	0	0	0	0	0	0	0	0	0	0	0	0	0	0	0	0	0	5	5
Калининградская область	Очно-заочная; Государственные, муниципальные (без учета организаций в ведении ФСИН)	"    в том числе:
    переведено на другие формы обучения данной
    организации на программы того же уровня / 7.0"	0	0	0	0	0	0	0	0	0	0	0	0	0	0	0	0	0	0	0	0
Калининградская область	Очно-заочная; Государственные, муниципальные (без учета организаций в ведении ФСИН)	"    в том числе:
    переведено с других форм обучения данной
    образовательной организации с программ того же уровня / 2.0"	0	0	0	0	0	0	0	0	0	0	0	0	0	0	0	0	0	0	2	2
Калининградская область	Очно-заочная; Государственные, муниципальные (без учета организаций в ведении ФСИН)	    восстановлены из числа ранее отчисленных / 4.0	0	0	0	0	0	0	0	0	0	0	0	0	0	0	0	0	0	0	5	5
Калининградская область	Очно-заочная; Государственные, муниципальные (без учета организаций в ведении ФСИН)	    выбыло по другим причинам / 16.0	0	0	0	0	0	0	0	0	0	0	0	0	0	0	0	0	0	0	0	0
Калининградская область	Очно-заочная; Государственные, муниципальные (без учета организаций в ведении ФСИН)	"    добровольно прекратили образовательные отношения
    (бросили учебу) / 10.0"	0	0	0	0	0	0	0	0	0	0	0	0	0	0	0	0	0	0	30	30
Калининградская область	Очно-заочная; Государственные, муниципальные (без учета организаций в ведении ФСИН)	"    отчислено:
         по неуспеваемости / 11.0"	0	0	0	0	0	0	0	0	0	0	0	0	0	0	0	0	0	0	0	0
Калининградская область	Очно-заочная; Государственные, муниципальные (без учета организаций в ведении ФСИН)	"    переведено в другие образовательные организации
    на программы того же уровня / 8.0"	0	0	0	0	0	0	0	0	0	0	0	0	0	0	0	0	0	0	1	1
Калининградская область	Очно-заочная; Государственные, муниципальные (без учета организаций в ведении ФСИН)	"    переведено из других образовательных организаций 
    с программ того же уровня / 3.0"	0	0	0	0	0	0	0	0	0	0	0	0	0	0	0	0	0	0	1	1
Калининградская область	Очно-заочная; Государственные, муниципальные (без учета организаций в ведении ФСИН)	    по болезни / 9.0	0	0	0	0	0	0	0	0	0	0	0	0	0	0	0	0	0	0	0	0
Калининградская область	Очно-заочная; Государственные, муниципальные (без учета организаций в ведении ФСИН)	    прибыло по другим причинам / 5.0	0	0	0	0	0	0	0	0	0	0	0	0	0	0	0	0	0	0	3	3
Калининградская область	Очно-заочная; Государственные, муниципальные (без учета организаций в ведении ФСИН)	Выбыло студентов - всего (сумма стр. 07-11, 13-15) / 6.0	0	0	0	0	0	0	0	0	0	0	0	0	0	0	0	0	0	0	61	61
Калининградская область	Очно-заочная; Государственные, муниципальные (без учета организаций в ведении ФСИН)	Прибыло студентов - всего (сумма стр. 02-05) / 1.0	0	0	0	0	0	0	0	0	0	0	0	0	0	0	0	0	0	0	11	11
Калининградская область	Очно-заочная; Государственные, муниципальные (без учета организаций в ведении ФСИН)	"Численность студентов на начало прошлого учебного года
(на 1 октября) / 17.0"	0	0	0	0	0	0	0	0	0	0	0	0	0	0	0	0	0	0	311	311
Калининградская область	Частные; Заочная	            из стр. 11 - не прошли итоговую аттестацию / 12.0	0	0	0	0	0	0	0	0	0	0	0	0	0	2	2	0	0	0	1	1
Калининградская область	Частные; Заочная	"            из стр. 11 – лица с ограниченными возможностями здоровья,
            инвалиды, дети-инвалиды / 13.0"	0	0	0	0	0	0	0	0	0	0	0	0	0	0	0	0	0	0	0	0
Калининградская область	Частные; Заочная	         отчислено в виде меры дисциплинарного взыскания / 14.0	0	0	0	0	0	0	0	0	0	0	0	0	0	0	0	0	0	0	0	0
Калининградская область	Частные; Заочная	         отчислено из-за просрочки оплаты обучения / 15.0	0	0	0	0	0	0	0	0	0	0	0	0	0	17	17	0	0	0	15	15
Калининградская область	Частные; Заочная	"    в том числе:
    переведено на другие формы обучения данной
    организации на программы того же уровня / 7.0"	0	0	0	0	0	0	0	0	0	0	0	0	0	6	6	0	0	0	2	2
Калининградская область	Частные; Заочная	"    в том числе:
    переведено с других форм обучения данной
    образовательной организации с программ того же уровня / 2.0"	0	0	0	0	0	0	0	0	0	0	0	0	0	27	27	0	0	0	1	1
Калининградская область	Частные; Заочная	    восстановлены из числа ранее отчисленных / 4.0	0	0	0	0	0	0	0	0	0	0	0	0	0	5	5	0	0	0	2	2
Калининградская область	Частные; Заочная	    выбыло по другим причинам / 16.0	0	0	0	0	0	0	0	0	0	0	0	0	0	20	20	0	0	0	5	5
Калининградская область	Частные; Заочная	"    добровольно прекратили образовательные отношения
    (бросили учебу) / 10.0"	0	0	0	0	0	0	0	0	0	0	0	0	0	24	24	0	0	0	7	7
Калининградская область	Частные; Заочная	"    отчислено:
         по неуспеваемости / 11.0"	0	0	0	0	0	0	0	0	0	0	0	0	0	18	18	0	0	0	14	14
Калининградская область	Частные; Заочная	"    переведено в другие образовательные организации
    на программы того же уровня / 8.0"	0	0	0	0	0	0	0	0	0	0	0	0	0	6	6	0	0	0	1	1
Калининградская область	Частные; Заочная	"    переведено из других образовательных организаций 
    с программ того же уровня / 3.0"	0	0	0	0	0	0	0	0	0	0	0	0	0	11	11	0	0	0	0	0
Калининградская область	Частные; Заочная	    по болезни / 9.0	0	0	0	0	0	0	0	0	0	0	0	0	0	1	1	0	0	0	0	0
Калининградская область	Частные; Заочная	    прибыло по другим причинам / 5.0	0	0	0	0	0	0	0	0	0	0	0	0	0	23	23	0	0	0	5	5
Калининградская область	Частные; Заочная	Выбыло студентов - всего (сумма стр. 07-11, 13-15) / 6.0	0	0	0	0	0	0	0	0	0	0	0	0	0	92	92	0	0	0	44	44
Калининградская область	Частные; Заочная	Прибыло студентов - всего (сумма стр. 02-05) / 1.0	0	0	0	0	0	0	0	0	0	0	0	0	0	66	66	0	0	0	8	8
Калининградская область	Частные; Заочная	"Численность студентов на начало прошлого учебного года
(на 1 октября) / 17.0"	0	0	0	0	0	0	0	0	0	0	0	0	0	296	296	0	0	0	197	197
Калининградская область	Частные; Очная	            из стр. 11 - не прошли итоговую аттестацию / 12.0	0	0	0	0	0	0	0	0	0	0	0	0	0	4	4	0	0	0	0	0
Калининградская область	Частные; Очная	"            из стр. 11 – лица с ограниченными возможностями здоровья,
            инвалиды, дети-инвалиды / 13.0"	0	0	0	0	0	0	0	0	0	0	0	0	0	0	0	0	0	0	0	0
Калининградская область	Частные; Очная	         отчислено в виде меры дисциплинарного взыскания / 14.0	0	0	0	0	0	0	0	0	0	0	0	0	0	0	0	0	0	0	0	0
Калининградская область	Частные; Очная	         отчислено из-за просрочки оплаты обучения / 15.0	0	0	0	0	0	0	0	0	0	0	0	0	0	31	31	0	0	0	15	15
Калининградская область	Частные; Очная	"    в том числе:
    переведено на другие формы обучения данной
    организации на программы того же уровня / 7.0"	0	0	0	0	0	0	0	0	0	0	0	0	0	44	44	0	0	0	1	1
Калининградская область	Частные; Очная	"    в том числе:
    переведено с других форм обучения данной
    образовательной организации с программ того же уровня / 2.0"	0	0	0	0	0	0	0	0	0	0	0	0	0	5	5	0	0	0	2	2
Калининградская область	Частные; Очная	    восстановлены из числа ранее отчисленных / 4.0	0	0	0	0	0	0	0	0	0	0	0	0	0	24	24	0	0	0	14	14
Калининградская область	Частные; Очная	    выбыло по другим причинам / 16.0	0	0	0	0	0	0	0	0	0	0	0	0	0	42	42	0	0	0	7	7
Калининградская область	Частные; Очная	"    добровольно прекратили образовательные отношения
    (бросили учебу) / 10.0"	0	0	0	0	0	0	0	0	0	0	2	0	0	127	129	0	0	0	28	28
Калининградская область	Частные; Очная	"    отчислено:
         по неуспеваемости / 11.0"	0	0	0	0	0	0	0	0	0	0	0	0	0	39	39	0	0	0	8	8
Калининградская область	Частные; Очная	"    переведено в другие образовательные организации
    на программы того же уровня / 8.0"	0	0	0	0	0	0	0	0	0	0	0	0	0	71	71	0	0	0	4	4
Калининградская область	Частные; Очная	"    переведено из других образовательных организаций 
    с программ того же уровня / 3.0"	0	0	0	0	0	0	0	0	0	0	0	0	0	85	85	0	0	0	5	5
Калининградская область	Частные; Очная	    по болезни / 9.0	0	0	0	0	0	0	0	0	0	0	0	0	0	0	0	0	0	0	0	0
Калининградская область	Частные; Очная	    прибыло по другим причинам / 5.0	0	0	0	0	0	0	0	0	0	0	0	0	0	9	9	0	0	0	11	11
Калининградская область	Частные; Очная	Выбыло студентов - всего (сумма стр. 07-11, 13-15) / 6.0	0	0	0	0	0	0	0	0	0	0	2	0	0	354	356	0	0	0	63	63
Калининградская область	Частные; Очная	Прибыло студентов - всего (сумма стр. 02-05) / 1.0	0	0	0	0	0	0	0	0	0	0	0	0	0	123	123	0	0	0	32	32
Калининградская область	Частные; Очная	"Численность студентов на начало прошлого учебного года
(на 1 октября) / 17.0"	0	0	0	0	0	0	0	0	0	0	40	0	15	2957	3012	30	0	0	453	483
Калининградская область	Частные; Очно-заочная	            из стр. 11 - не прошли итоговую аттестацию / 12.0	0	0	0	0	0	0	0	0	0	0	0	0	0	0	0	0	0	0	0	0
Калининградская область	Частные; Очно-заочная	"            из стр. 11 – лица с ограниченными возможностями здоровья,
            инвалиды, дети-инвалиды / 13.0"	0	0	0	0	0	0	0	0	0	0	0	0	0	0	0	0	0	0	0	0
Калининградская область	Частные; Очно-заочная	         отчислено в виде меры дисциплинарного взыскания / 14.0	0	0	0	0	0	0	0	0	0	0	0	0	0	0	0	0	0	0	0	0
Калининградская область	Частные; Очно-заочная	         отчислено из-за просрочки оплаты обучения / 15.0	0	0	0	0	0	0	0	0	0	0	0	0	0	0	0	0	0	0	0	0
Калининградская область	Частные; Очно-заочная	"    в том числе:
    переведено на другие формы обучения данной
    организации на программы того же уровня / 7.0"	0	0	0	0	0	0	0	0	0	0	0	0	0	0	0	0	0	0	0	0
Калининградская область	Частные; Очно-заочная	"    в том числе:
    переведено с других форм обучения данной
    образовательной организации с программ того же уровня / 2.0"	0	0	0	0	0	0	0	0	0	0	0	0	0	1	1	0	0	0	0	0
Калининградская область	Частные; Очно-заочная	    восстановлены из числа ранее отчисленных / 4.0	0	0	0	0	0	0	0	0	0	0	0	0	0	0	0	0	0	0	2	2
Калининградская область	Частные; Очно-заочная	    выбыло по другим причинам / 16.0	0	0	0	0	0	0	0	0	0	0	0	0	0	0	0	0	0	0	0	0
Калининградская область	Частные; Очно-заочная	"    добровольно прекратили образовательные отношения
    (бросили учебу) / 10.0"	0	0	0	0	0	0	0	0	0	0	0	0	0	1	1	0	0	0	0	0
Калининградская область	Частные; Очно-заочная	"    отчислено:
         по неуспеваемости / 11.0"	0	0	0	0	0	0	0	0	0	0	0	0	0	0	0	0	0	0	0	0
Калининградская область	Частные; Очно-заочная	"    переведено в другие образовательные организации
    на программы того же уровня / 8.0"	0	0	0	0	0	0	0	0	0	0	0	0	0	0	0	0	0	0	0	0
Калининградская область	Частные; Очно-заочная	"    переведено из других образовательных организаций 
    с программ того же уровня / 3.0"	0	0	0	0	0	0	0	0	0	0	0	0	0	0	0	0	0	0	0	0
Калининградская область	Частные; Очно-заочная	    по болезни / 9.0	0	0	0	0	0	0	0	0	0	0	0	0	0	0	0	0	0	0	0	0
Калининградская область	Частные; Очно-заочная	    прибыло по другим причинам / 5.0	0	0	0	0	0	0	0	0	0	0	0	0	0	0	0	0	0	0	0	0
Калининградская область	Частные; Очно-заочная	Выбыло студентов - всего (сумма стр. 07-11, 13-15) / 6.0	0	0	0	0	0	0	0	0	0	0	0	0	0	1	1	0	0	0	0	0
Калининградская область	Частные; Очно-заочная	Прибыло студентов - всего (сумма стр. 02-05) / 1.0	0	0	0	0	0	0	0	0	0	0	0	0	0	1	1	0	0	0	2	2
Калининградская область	Частные; Очно-заочная	"Численность студентов на начало прошлого учебного года
(на 1 октября) / 17.0"	0	0	0	0	0	0	0	0	0	0	0	0	0	6	6	0	0	0	29	29
Калужская область	Государственные, муниципальные (без учета организаций в ведении ФСИН); Заочная	            из стр. 11 - не прошли итоговую аттестацию / 12.0	0	0	0	0	0	0	0	0	0	0	0	0	0	0	0	2	0	0	0	2
Калужская область	Государственные, муниципальные (без учета организаций в ведении ФСИН); Заочная	"            из стр. 11 – лица с ограниченными возможностями здоровья,
            инвалиды, дети-инвалиды / 13.0"	0	0	0	0	0	0	0	0	0	0	0	0	0	0	0	0	0	0	0	0
Калужская область	Государственные, муниципальные (без учета организаций в ведении ФСИН); Заочная	         отчислено в виде меры дисциплинарного взыскания / 14.0	0	0	0	0	0	0	0	0	0	0	0	0	0	0	0	0	0	0	0	0
Калужская область	Государственные, муниципальные (без учета организаций в ведении ФСИН); Заочная	         отчислено из-за просрочки оплаты обучения / 15.0	0	0	0	0	0	0	0	0	0	0	0	0	0	1	1	0	0	0	14	14
Калужская область	Государственные, муниципальные (без учета организаций в ведении ФСИН); Заочная	"    в том числе:
    переведено на другие формы обучения данной
    организации на программы того же уровня / 7.0"	0	0	0	0	0	0	0	0	0	0	0	0	0	3	3	0	0	0	0	0
Калужская область	Государственные, муниципальные (без учета организаций в ведении ФСИН); Заочная	"    в том числе:
    переведено с других форм обучения данной
    образовательной организации с программ того же уровня / 2.0"	0	0	0	0	0	0	0	0	0	0	0	0	0	7	7	0	0	0	0	0
Калужская область	Государственные, муниципальные (без учета организаций в ведении ФСИН); Заочная	    восстановлены из числа ранее отчисленных / 4.0	0	0	0	0	0	0	0	0	0	0	0	0	0	19	19	1	0	4	0	5
Калужская область	Государственные, муниципальные (без учета организаций в ведении ФСИН); Заочная	    выбыло по другим причинам / 16.0	0	0	0	0	0	0	0	0	0	0	0	0	0	2	2	2	0	2	14	18
Калужская область	Государственные, муниципальные (без учета организаций в ведении ФСИН); Заочная	"    добровольно прекратили образовательные отношения
    (бросили учебу) / 10.0"	0	0	0	0	0	0	0	0	0	0	0	0	0	8	8	41	0	5	7	53
Калужская область	Государственные, муниципальные (без учета организаций в ведении ФСИН); Заочная	"    отчислено:
         по неуспеваемости / 11.0"	0	0	0	0	0	0	0	0	0	0	0	0	0	1	1	17	0	0	0	17
Калужская область	Государственные, муниципальные (без учета организаций в ведении ФСИН); Заочная	"    переведено в другие образовательные организации
    на программы того же уровня / 8.0"	0	0	0	0	0	0	0	0	0	0	0	0	0	0	0	0	0	0	0	0
Калужская область	Государственные, муниципальные (без учета организаций в ведении ФСИН); Заочная	"    переведено из других образовательных организаций 
    с программ того же уровня / 3.0"	0	0	0	0	0	0	0	0	0	0	0	0	0	0	0	1	0	0	2	3
Калужская область	Государственные, муниципальные (без учета организаций в ведении ФСИН); Заочная	    по болезни / 9.0	0	0	0	0	0	0	0	0	0	0	0	0	0	0	0	0	0	0	0	0
Калужская область	Государственные, муниципальные (без учета организаций в ведении ФСИН); Заочная	    прибыло по другим причинам / 5.0	0	0	0	0	0	0	0	0	0	0	0	0	0	2	2	10	0	0	2	12
Калужская область	Государственные, муниципальные (без учета организаций в ведении ФСИН); Заочная	Выбыло студентов - всего (сумма стр. 07-11, 13-15) / 6.0	0	0	0	0	0	0	0	0	0	0	0	0	0	15	15	60	0	7	35	102
Калужская область	Государственные, муниципальные (без учета организаций в ведении ФСИН); Заочная	Прибыло студентов - всего (сумма стр. 02-05) / 1.0	0	0	0	0	0	0	0	0	0	0	0	0	0	28	28	12	0	4	4	20
Калужская область	Государственные, муниципальные (без учета организаций в ведении ФСИН); Заочная	"Численность студентов на начало прошлого учебного года
(на 1 октября) / 17.0"	0	0	0	0	0	0	0	0	0	0	0	0	7	121	128	410	0	126	261	797
Калужская область	Государственные, муниципальные (без учета организаций в ведении ФСИН); Очная	            из стр. 11 - не прошли итоговую аттестацию / 12.0	0	0	0	0	0	0	0	0	0	0	39	0	0	2	41	0	0	0	0	0
Калужская область	Государственные, муниципальные (без учета организаций в ведении ФСИН); Очная	"            из стр. 11 – лица с ограниченными возможностями здоровья,
            инвалиды, дети-инвалиды / 13.0"	0	0	0	0	0	0	0	0	0	0	0	0	0	0	0	0	0	0	0	0
Калужская область	Государственные, муниципальные (без учета организаций в ведении ФСИН); Очная	         отчислено в виде меры дисциплинарного взыскания / 14.0	0	0	0	0	0	0	0	0	0	0	6	0	0	1	7	0	0	0	0	0
Калужская область	Государственные, муниципальные (без учета организаций в ведении ФСИН); Очная	         отчислено из-за просрочки оплаты обучения / 15.0	0	0	0	0	0	0	0	0	0	0	0	0	0	3	3	0	0	0	0	0
Калужская область	Государственные, муниципальные (без учета организаций в ведении ФСИН); Очная	"    в том числе:
    переведено на другие формы обучения данной
    организации на программы того же уровня / 7.0"	1	0	0	0	1	0	0	0	0	0	23	0	2	14	39	0	0	0	2	2
Калужская область	Государственные, муниципальные (без учета организаций в ведении ФСИН); Очная	"    в том числе:
    переведено с других форм обучения данной
    образовательной организации с программ того же уровня / 2.0"	9	0	0	0	9	0	0	0	0	0	25	0	0	4	29	1	0	0	0	1
Калужская область	Государственные, муниципальные (без учета организаций в ведении ФСИН); Очная	    восстановлены из числа ранее отчисленных / 4.0	11	0	0	0	11	0	0	0	0	0	59	7	1	48	115	2	0	0	6	8
Калужская область	Государственные, муниципальные (без учета организаций в ведении ФСИН); Очная	    выбыло по другим причинам / 16.0	75	0	0	0	75	0	0	0	0	0	157	0	1	18	176	28	0	0	3	31
Калужская область	Государственные, муниципальные (без учета организаций в ведении ФСИН); Очная	"    добровольно прекратили образовательные отношения
    (бросили учебу) / 10.0"	134	0	0	0	134	2	0	0	0	2	564	0	27	127	718	52	0	0	78	130
Калужская область	Государственные, муниципальные (без учета организаций в ведении ФСИН); Очная	"    отчислено:
         по неуспеваемости / 11.0"	40	0	0	0	40	0	0	0	0	0	262	0	2	34	298	33	0	0	13	46
Калужская область	Государственные, муниципальные (без учета организаций в ведении ФСИН); Очная	"    переведено в другие образовательные организации
    на программы того же уровня / 8.0"	12	0	0	0	12	0	0	0	0	0	141	0	6	44	191	7	0	0	3	10
Калужская область	Государственные, муниципальные (без учета организаций в ведении ФСИН); Очная	"    переведено из других образовательных организаций 
    с программ того же уровня / 3.0"	20	0	0	0	20	0	0	0	0	0	113	4	0	18	135	1	0	0	1	2
Калужская область	Государственные, муниципальные (без учета организаций в ведении ФСИН); Очная	    по болезни / 9.0	2	0	0	0	2	0	0	0	0	0	0	0	0	0	0	0	0	0	0	0
Калужская область	Государственные, муниципальные (без учета организаций в ведении ФСИН); Очная	    прибыло по другим причинам / 5.0	18	0	0	0	18	2	0	0	0	2	160	0	0	4	164	5	0	0	0	5
Калужская область	Государственные, муниципальные (без учета организаций в ведении ФСИН); Очная	Выбыло студентов - всего (сумма стр. 07-11, 13-15) / 6.0	264	0	0	0	264	2	0	0	0	2	1153	0	38	241	1432	120	0	0	99	219
Калужская область	Государственные, муниципальные (без учета организаций в ведении ФСИН); Очная	Прибыло студентов - всего (сумма стр. 02-05) / 1.0	58	0	0	0	58	2	0	0	0	2	357	11	1	74	443	9	0	0	7	16
Калужская область	Государственные, муниципальные (без учета организаций в ведении ФСИН); Очная	"Численность студентов на начало прошлого учебного года
(на 1 октября) / 17.0"	2290	0	0	7	2297	0	0	0	0	0	11959	0	806	1771	14536	1033	0	0	511	1544
Калужская область	Очно-заочная; Государственные, муниципальные (без учета организаций в ведении ФСИН)	            из стр. 11 - не прошли итоговую аттестацию / 12.0	0	0	0	0	0	0	0	0	0	0	0	0	0	0	0	0	0	0	0	0
Калужская область	Очно-заочная; Государственные, муниципальные (без учета организаций в ведении ФСИН)	"            из стр. 11 – лица с ограниченными возможностями здоровья,
            инвалиды, дети-инвалиды / 13.0"	0	0	0	0	0	0	0	0	0	0	0	0	0	0	0	0	0	0	0	0
Калужская область	Очно-заочная; Государственные, муниципальные (без учета организаций в ведении ФСИН)	         отчислено в виде меры дисциплинарного взыскания / 14.0	0	0	0	0	0	0	0	0	0	0	0	0	0	0	0	0	0	0	0	0
Калужская область	Очно-заочная; Государственные, муниципальные (без учета организаций в ведении ФСИН)	         отчислено из-за просрочки оплаты обучения / 15.0	0	0	0	0	0	0	0	0	0	0	0	0	0	0	0	0	0	0	0	0
Калужская область	Очно-заочная; Государственные, муниципальные (без учета организаций в ведении ФСИН)	"    в том числе:
    переведено на другие формы обучения данной
    организации на программы того же уровня / 7.0"	0	0	0	0	0	0	0	0	0	0	0	0	0	0	0	0	0	0	0	0
Калужская область	Очно-заочная; Государственные, муниципальные (без учета организаций в ведении ФСИН)	"    в том числе:
    переведено с других форм обучения данной
    образовательной организации с программ того же уровня / 2.0"	0	0	0	0	0	0	0	0	0	0	0	0	0	0	0	0	0	0	0	0
Калужская область	Очно-заочная; Государственные, муниципальные (без учета организаций в ведении ФСИН)	    восстановлены из числа ранее отчисленных / 4.0	0	0	0	0	0	0	0	0	0	0	0	0	0	0	0	0	0	0	9	9
Калужская область	Очно-заочная; Государственные, муниципальные (без учета организаций в ведении ФСИН)	    выбыло по другим причинам / 16.0	0	0	0	0	0	0	0	0	0	0	0	0	0	0	0	0	0	0	1	1
Калужская область	Очно-заочная; Государственные, муниципальные (без учета организаций в ведении ФСИН)	"    добровольно прекратили образовательные отношения
    (бросили учебу) / 10.0"	0	0	0	0	0	0	0	0	0	0	0	0	0	0	0	0	0	0	41	41
Калужская область	Очно-заочная; Государственные, муниципальные (без учета организаций в ведении ФСИН)	"    отчислено:
         по неуспеваемости / 11.0"	0	0	0	0	0	0	0	0	0	0	0	0	0	0	0	0	0	0	9	9
Калужская область	Очно-заочная; Государственные, муниципальные (без учета организаций в ведении ФСИН)	"    переведено в другие образовательные организации
    на программы того же уровня / 8.0"	0	0	0	0	0	0	0	0	0	0	0	0	0	0	0	0	0	0	2	2
Калужская область	Очно-заочная; Государственные, муниципальные (без учета организаций в ведении ФСИН)	"    переведено из других образовательных организаций 
    с программ того же уровня / 3.0"	0	0	0	0	0	0	0	0	0	0	0	0	0	0	0	0	0	0	0	0
Калужская область	Очно-заочная; Государственные, муниципальные (без учета организаций в ведении ФСИН)	    по болезни / 9.0	0	0	0	0	0	0	0	0	0	0	0	0	0	0	0	0	0	0	0	0
Калужская область	Очно-заочная; Государственные, муниципальные (без учета организаций в ведении ФСИН)	    прибыло по другим причинам / 5.0	0	0	0	0	0	0	0	0	0	0	0	0	0	0	0	0	0	0	0	0
Калужская область	Очно-заочная; Государственные, муниципальные (без учета организаций в ведении ФСИН)	Выбыло студентов - всего (сумма стр. 07-11, 13-15) / 6.0	0	0	0	0	0	0	0	0	0	0	0	0	0	0	0	0	0	0	53	53
Калужская область	Очно-заочная; Государственные, муниципальные (без учета организаций в ведении ФСИН)	Прибыло студентов - всего (сумма стр. 02-05) / 1.0	0	0	0	0	0	0	0	0	0	0	0	0	0	0	0	0	0	0	9	9
Калужская область	Очно-заочная; Государственные, муниципальные (без учета организаций в ведении ФСИН)	"Численность студентов на начало прошлого учебного года
(на 1 октября) / 17.0"	0	0	0	0	0	0	0	0	41	41	0	0	0	0	0	0	0	0	473	473
Калужская область	Частные; Заочная	            из стр. 11 - не прошли итоговую аттестацию / 12.0	0	0	0	0	0	0	0	0	0	0	0	0	0	0	0	0	0	0	0	0
Калужская область	Частные; Заочная	"            из стр. 11 – лица с ограниченными возможностями здоровья,
            инвалиды, дети-инвалиды / 13.0"	0	0	0	0	0	0	0	0	0	0	0	0	0	0	0	0	0	0	0	0
Калужская область	Частные; Заочная	         отчислено в виде меры дисциплинарного взыскания / 14.0	0	0	0	0	0	0	0	0	0	0	0	0	0	0	0	0	0	0	0	0
Калужская область	Частные; Заочная	         отчислено из-за просрочки оплаты обучения / 15.0	0	0	0	0	0	0	0	0	0	0	0	0	0	0	0	0	0	0	0	0
Калужская область	Частные; Заочная	"    в том числе:
    переведено на другие формы обучения данной
    организации на программы того же уровня / 7.0"	0	0	0	0	0	0	0	0	0	0	0	0	0	1	1	0	0	0	0	0
Калужская область	Частные; Заочная	"    в том числе:
    переведено с других форм обучения данной
    образовательной организации с программ того же уровня / 2.0"	0	0	0	0	0	0	0	0	0	0	0	0	0	53	53	0	0	0	5	5
Калужская область	Частные; Заочная	    восстановлены из числа ранее отчисленных / 4.0	0	0	0	0	0	0	0	0	0	0	0	0	0	9	9	0	0	0	0	0
Калужская область	Частные; Заочная	    выбыло по другим причинам / 16.0	0	0	0	0	0	0	0	0	0	0	0	0	0	0	0	0	0	0	8	8
Калужская область	Частные; Заочная	"    добровольно прекратили образовательные отношения
    (бросили учебу) / 10.0"	0	0	0	0	0	0	0	0	0	0	0	0	0	7	7	0	0	0	23	23
Калужская область	Частные; Заочная	"    отчислено:
         по неуспеваемости / 11.0"	0	0	0	0	0	0	0	0	0	0	0	0	0	21	21	0	0	0	31	31
Калужская область	Частные; Заочная	"    переведено в другие образовательные организации
    на программы того же уровня / 8.0"	0	0	0	0	0	0	0	0	0	0	0	0	0	1	1	0	0	0	0	0
Калужская область	Частные; Заочная	"    переведено из других образовательных организаций 
    с программ того же уровня / 3.0"	0	0	0	0	0	0	0	0	0	0	0	0	0	14	14	0	0	0	3	3
Калужская область	Частные; Заочная	    по болезни / 9.0	0	0	0	0	0	0	0	0	0	0	0	0	0	0	0	0	0	0	0	0
Калужская область	Частные; Заочная	    прибыло по другим причинам / 5.0	0	0	0	0	0	0	0	0	0	0	0	0	0	1	1	0	0	0	0	0
Калужская область	Частные; Заочная	Выбыло студентов - всего (сумма стр. 07-11, 13-15) / 6.0	0	0	0	0	0	0	0	0	0	0	0	0	0	30	30	0	0	0	62	62
Калужская область	Частные; Заочная	Прибыло студентов - всего (сумма стр. 02-05) / 1.0	0	0	0	0	0	0	0	0	0	0	0	0	0	77	77	0	0	0	8	8
Калужская область	Частные; Заочная	"Численность студентов на начало прошлого учебного года
(на 1 октября) / 17.0"	0	0	0	0	0	0	0	0	0	0	0	0	0	98	98	0	0	0	263	263
Калужская область	Частные; Очная	            из стр. 11 - не прошли итоговую аттестацию / 12.0	0	0	0	0	0	0	0	0	0	0	0	0	0	0	0	0	0	0	0	0
Калужская область	Частные; Очная	"            из стр. 11 – лица с ограниченными возможностями здоровья,
            инвалиды, дети-инвалиды / 13.0"	0	0	0	0	0	0	0	0	0	0	0	0	0	0	0	0	0	0	0	0
Калужская область	Частные; Очная	         отчислено в виде меры дисциплинарного взыскания / 14.0	0	0	0	0	0	0	0	0	0	0	0	0	0	0	0	0	0	0	3	3
Калужская область	Частные; Очная	         отчислено из-за просрочки оплаты обучения / 15.0	0	0	0	0	0	0	0	0	0	0	0	0	0	2	2	0	0	0	0	0
Калужская область	Частные; Очная	"    в том числе:
    переведено на другие формы обучения данной
    организации на программы того же уровня / 7.0"	0	0	0	0	0	0	0	0	0	0	0	0	0	30	30	0	0	0	5	5
Калужская область	Частные; Очная	"    в том числе:
    переведено с других форм обучения данной
    образовательной организации с программ того же уровня / 2.0"	0	0	0	0	0	0	0	0	0	0	0	0	0	1	1	0	0	0	1	1
Калужская область	Частные; Очная	    восстановлены из числа ранее отчисленных / 4.0	0	0	0	0	0	0	0	0	2	2	0	0	0	9	9	0	0	0	1	1
Калужская область	Частные; Очная	    выбыло по другим причинам / 16.0	0	0	0	0	0	0	0	0	0	0	0	0	0	7	7	0	0	0	4	4
Калужская область	Частные; Очная	"    добровольно прекратили образовательные отношения
    (бросили учебу) / 10.0"	0	0	0	0	0	0	0	0	0	0	0	0	0	50	50	0	0	0	20	20
Калужская область	Частные; Очная	"    отчислено:
         по неуспеваемости / 11.0"	0	0	0	0	0	0	0	0	4	4	0	0	0	33	33	0	0	0	3	3
Калужская область	Частные; Очная	"    переведено в другие образовательные организации
    на программы того же уровня / 8.0"	0	0	0	0	0	0	0	0	0	0	0	0	0	27	27	0	0	0	2	2
Калужская область	Частные; Очная	"    переведено из других образовательных организаций 
    с программ того же уровня / 3.0"	0	0	0	42	42	0	0	0	0	0	0	0	0	36	36	0	0	0	6	6
Калужская область	Частные; Очная	    по болезни / 9.0	0	0	0	0	0	0	0	0	0	0	0	0	0	0	0	0	0	0	0	0
Калужская область	Частные; Очная	    прибыло по другим причинам / 5.0	0	0	0	0	0	0	0	0	0	0	0	0	0	159	159	0	0	0	1	1
Калужская область	Частные; Очная	Выбыло студентов - всего (сумма стр. 07-11, 13-15) / 6.0	0	0	0	0	0	0	0	0	4	4	0	0	0	149	149	0	0	0	37	37
Калужская область	Частные; Очная	Прибыло студентов - всего (сумма стр. 02-05) / 1.0	0	0	0	42	42	0	0	0	2	2	0	0	0	205	205	0	0	0	9	9
Калужская область	Частные; Очная	"Численность студентов на начало прошлого учебного года
(на 1 октября) / 17.0"	0	0	0	0	0	0	0	0	19	19	0	0	0	1296	1296	0	0	0	254	254
Калужская область	Частные; Очно-заочная	            из стр. 11 - не прошли итоговую аттестацию / 12.0	0	0	0	0	0	0	0	0	0	0	0	0	0	0	0	0	0	0	0	0
Калужская область	Частные; Очно-заочная	"            из стр. 11 – лица с ограниченными возможностями здоровья,
            инвалиды, дети-инвалиды / 13.0"	0	0	0	0	0	0	0	0	0	0	0	0	0	0	0	0	0	0	0	0
Калужская область	Частные; Очно-заочная	         отчислено в виде меры дисциплинарного взыскания / 14.0	0	0	0	0	0	0	0	0	0	0	0	0	0	0	0	0	0	0	0	0
Калужская область	Частные; Очно-заочная	         отчислено из-за просрочки оплаты обучения / 15.0	0	0	0	0	0	0	0	0	0	0	0	0	0	0	0	0	0	0	0	0
Калужская область	Частные; Очно-заочная	"    в том числе:
    переведено на другие формы обучения данной
    организации на программы того же уровня / 7.0"	0	0	0	0	0	0	0	0	0	0	0	0	0	0	0	0	0	0	0	0
Калужская область	Частные; Очно-заочная	"    в том числе:
    переведено с других форм обучения данной
    образовательной организации с программ того же уровня / 2.0"	0	0	0	0	0	0	0	0	0	0	0	0	0	16	16	0	0	0	0	0
Калужская область	Частные; Очно-заочная	    восстановлены из числа ранее отчисленных / 4.0	0	0	0	0	0	0	0	0	0	0	0	0	0	6	6	0	0	0	0	0
Калужская область	Частные; Очно-заочная	    выбыло по другим причинам / 16.0	0	0	0	0	0	0	0	0	0	0	0	0	0	24	24	0	0	0	0	0
Калужская область	Частные; Очно-заочная	"    добровольно прекратили образовательные отношения
    (бросили учебу) / 10.0"	0	0	0	0	0	0	0	0	0	0	0	0	0	20	20	0	0	0	0	0
Калужская область	Частные; Очно-заочная	"    отчислено:
         по неуспеваемости / 11.0"	0	0	0	0	0	0	0	0	0	0	0	0	0	0	0	0	0	0	0	0
Калужская область	Частные; Очно-заочная	"    переведено в другие образовательные организации
    на программы того же уровня / 8.0"	0	0	0	0	0	0	0	0	0	0	0	0	0	3	3	0	0	0	0	0
Калужская область	Частные; Очно-заочная	"    переведено из других образовательных организаций 
    с программ того же уровня / 3.0"	0	0	0	0	0	0	0	0	0	0	0	0	0	17	17	0	0	0	0	0
Калужская область	Частные; Очно-заочная	    по болезни / 9.0	0	0	0	0	0	0	0	0	0	0	0	0	0	0	0	0	0	0	0	0
Калужская область	Частные; Очно-заочная	    прибыло по другим причинам / 5.0	0	0	0	0	0	0	0	0	0	0	0	0	0	0	0	0	0	0	0	0
Калужская область	Частные; Очно-заочная	Выбыло студентов - всего (сумма стр. 07-11, 13-15) / 6.0	0	0	0	0	0	0	0	0	0	0	0	0	0	47	47	0	0	0	0	0
Калужская область	Частные; Очно-заочная	Прибыло студентов - всего (сумма стр. 02-05) / 1.0	0	0	0	0	0	0	0	0	0	0	0	0	0	39	39	0	0	0	0	0
Калужская область	Частные; Очно-заочная	"Численность студентов на начало прошлого учебного года
(на 1 октября) / 17.0"	0	0	0	0	0	0	0	0	0	0	0	0	0	360	360	0	0	0	0	0
Камчатский край	Государственные, муниципальные (без учета организаций в ведении ФСИН); Заочная	            из стр. 11 - не прошли итоговую аттестацию / 12.0	0	0	0	0	0	0	0	0	0	0	0	0	0	0	0	0	0	0	0	0
Камчатский край	Государственные, муниципальные (без учета организаций в ведении ФСИН); Заочная	"            из стр. 11 – лица с ограниченными возможностями здоровья,
            инвалиды, дети-инвалиды / 13.0"	0	0	0	0	0	0	0	0	0	0	0	0	0	0	0	0	0	0	0	0
Камчатский край	Государственные, муниципальные (без учета организаций в ведении ФСИН); Заочная	         отчислено в виде меры дисциплинарного взыскания / 14.0	0	0	0	0	0	0	0	0	0	0	0	0	0	0	0	0	0	0	0	0
Камчатский край	Государственные, муниципальные (без учета организаций в ведении ФСИН); Заочная	         отчислено из-за просрочки оплаты обучения / 15.0	0	0	0	0	0	0	0	0	0	0	0	0	0	19	19	0	0	0	32	32
Камчатский край	Государственные, муниципальные (без учета организаций в ведении ФСИН); Заочная	"    в том числе:
    переведено на другие формы обучения данной
    организации на программы того же уровня / 7.0"	0	0	0	0	0	0	0	0	0	0	0	0	0	0	0	3	0	0	1	4
Камчатский край	Государственные, муниципальные (без учета организаций в ведении ФСИН); Заочная	"    в том числе:
    переведено с других форм обучения данной
    образовательной организации с программ того же уровня / 2.0"	0	0	0	0	0	0	0	0	0	0	0	0	0	2	2	12	0	0	1	13
Камчатский край	Государственные, муниципальные (без учета организаций в ведении ФСИН); Заочная	    восстановлены из числа ранее отчисленных / 4.0	0	0	0	0	0	0	0	0	0	0	0	0	0	1	1	10	0	0	4	14
Камчатский край	Государственные, муниципальные (без учета организаций в ведении ФСИН); Заочная	    выбыло по другим причинам / 16.0	0	0	0	0	0	0	0	0	0	0	0	0	0	7	7	0	0	0	62	62
Камчатский край	Государственные, муниципальные (без учета организаций в ведении ФСИН); Заочная	"    добровольно прекратили образовательные отношения
    (бросили учебу) / 10.0"	0	0	0	0	0	0	0	0	0	0	0	0	0	11	11	46	0	0	32	78
Камчатский край	Государственные, муниципальные (без учета организаций в ведении ФСИН); Заочная	"    отчислено:
         по неуспеваемости / 11.0"	0	0	0	0	0	0	0	0	0	0	0	0	0	1	1	14	0	0	4	18
Камчатский край	Государственные, муниципальные (без учета организаций в ведении ФСИН); Заочная	"    переведено в другие образовательные организации
    на программы того же уровня / 8.0"	0	0	0	0	0	0	0	0	0	0	0	0	0	0	0	0	0	0	4	4
Камчатский край	Государственные, муниципальные (без учета организаций в ведении ФСИН); Заочная	"    переведено из других образовательных организаций 
    с программ того же уровня / 3.0"	0	0	0	0	0	0	0	0	0	0	0	0	0	0	0	0	0	0	0	0
Камчатский край	Государственные, муниципальные (без учета организаций в ведении ФСИН); Заочная	    по болезни / 9.0	0	0	0	0	0	0	0	0	0	0	0	0	0	0	0	0	0	0	0	0
Камчатский край	Государственные, муниципальные (без учета организаций в ведении ФСИН); Заочная	    прибыло по другим причинам / 5.0	0	0	0	0	0	0	0	0	0	0	0	0	0	6	6	2	0	0	117	119
Камчатский край	Государственные, муниципальные (без учета организаций в ведении ФСИН); Заочная	Выбыло студентов - всего (сумма стр. 07-11, 13-15) / 6.0	0	0	0	0	0	0	0	0	0	0	0	0	0	38	38	63	0	0	135	198
Камчатский край	Государственные, муниципальные (без учета организаций в ведении ФСИН); Заочная	Прибыло студентов - всего (сумма стр. 02-05) / 1.0	0	0	0	0	0	0	0	0	0	0	0	0	0	9	9	24	0	0	122	146
Камчатский край	Государственные, муниципальные (без учета организаций в ведении ФСИН); Заочная	"Численность студентов на начало прошлого учебного года
(на 1 октября) / 17.0"	0	0	0	0	0	0	0	0	0	0	0	0	0	143	143	361	0	0	497	858
Камчатский край	Государственные, муниципальные (без учета организаций в ведении ФСИН); Очная	            из стр. 11 - не прошли итоговую аттестацию / 12.0	1	0	0	0	1	0	0	0	0	0	2	0	0	0	2	0	0	0	0	0
Камчатский край	Государственные, муниципальные (без учета организаций в ведении ФСИН); Очная	"            из стр. 11 – лица с ограниченными возможностями здоровья,
            инвалиды, дети-инвалиды / 13.0"	0	0	0	0	0	0	0	0	0	0	1	0	0	0	1	0	0	0	0	0
Камчатский край	Государственные, муниципальные (без учета организаций в ведении ФСИН); Очная	         отчислено в виде меры дисциплинарного взыскания / 14.0	0	0	0	0	0	0	0	0	0	0	0	0	0	0	0	0	0	0	0	0
Камчатский край	Государственные, муниципальные (без учета организаций в ведении ФСИН); Очная	         отчислено из-за просрочки оплаты обучения / 15.0	0	0	0	0	0	0	0	0	0	0	0	0	0	8	8	0	0	0	0	0
Камчатский край	Государственные, муниципальные (без учета организаций в ведении ФСИН); Очная	"    в том числе:
    переведено на другие формы обучения данной
    организации на программы того же уровня / 7.0"	3	0	0	0	3	0	0	0	0	0	13	0	0	3	16	0	0	0	0	0
Камчатский край	Государственные, муниципальные (без учета организаций в ведении ФСИН); Очная	"    в том числе:
    переведено с других форм обучения данной
    образовательной организации с программ того же уровня / 2.0"	7	0	0	0	7	0	0	0	0	0	2	0	1	0	3	0	0	3	0	3
Камчатский край	Государственные, муниципальные (без учета организаций в ведении ФСИН); Очная	    восстановлены из числа ранее отчисленных / 4.0	16	0	0	0	16	0	0	0	0	0	21	0	7	13	41	0	0	0	0	0
Камчатский край	Государственные, муниципальные (без учета организаций в ведении ФСИН); Очная	    выбыло по другим причинам / 16.0	88	0	0	0	88	0	0	0	0	0	86	0	0	0	86	0	0	0	0	0
Камчатский край	Государственные, муниципальные (без учета организаций в ведении ФСИН); Очная	"    добровольно прекратили образовательные отношения
    (бросили учебу) / 10.0"	113	0	0	3	116	6	0	0	0	6	293	0	53	46	392	26	0	0	11	37
Камчатский край	Государственные, муниципальные (без учета организаций в ведении ФСИН); Очная	"    отчислено:
         по неуспеваемости / 11.0"	50	0	0	3	53	2	0	0	0	2	83	0	20	6	109	17	0	0	8	25
Камчатский край	Государственные, муниципальные (без учета организаций в ведении ФСИН); Очная	"    переведено в другие образовательные организации
    на программы того же уровня / 8.0"	12	0	0	0	12	0	0	0	0	0	34	0	22	12	68	4	0	0	2	6
Камчатский край	Государственные, муниципальные (без учета организаций в ведении ФСИН); Очная	"    переведено из других образовательных организаций 
    с программ того же уровня / 3.0"	8	0	0	0	8	0	0	0	0	0	22	0	16	7	45	3	0	0	1	4
Камчатский край	Государственные, муниципальные (без учета организаций в ведении ФСИН); Очная	    по болезни / 9.0	0	0	0	0	0	0	0	0	0	0	0	0	0	0	0	0	0	0	0	0
Камчатский край	Государственные, муниципальные (без учета организаций в ведении ФСИН); Очная	    прибыло по другим причинам / 5.0	72	0	0	4	76	0	0	0	0	0	179	0	0	23	202	1	0	0	0	1
Камчатский край	Государственные, муниципальные (без учета организаций в ведении ФСИН); Очная	Выбыло студентов - всего (сумма стр. 07-11, 13-15) / 6.0	266	0	0	6	272	8	0	0	0	8	509	0	95	75	679	47	0	0	21	68
Камчатский край	Государственные, муниципальные (без учета организаций в ведении ФСИН); Очная	Прибыло студентов - всего (сумма стр. 02-05) / 1.0	103	0	0	4	107	0	0	0	0	0	224	0	24	43	291	4	0	3	1	8
Камчатский край	Государственные, муниципальные (без учета организаций в ведении ФСИН); Очная	"Численность студентов на начало прошлого учебного года
(на 1 октября) / 17.0"	1399	0	0	55	1454	25	0	0	1	26	2504	0	432	420	3356	215	0	0	130	345
Камчатский край	Очно-заочная; Государственные, муниципальные (без учета организаций в ведении ФСИН)	            из стр. 11 - не прошли итоговую аттестацию / 12.0	0	0	0	0	0	0	0	0	0	0	0	0	0	0	0	0	0	0	0	0
Камчатский край	Очно-заочная; Государственные, муниципальные (без учета организаций в ведении ФСИН)	"            из стр. 11 – лица с ограниченными возможностями здоровья,
            инвалиды, дети-инвалиды / 13.0"	0	0	0	0	0	0	0	0	0	0	0	0	0	0	0	0	0	0	0	0
Камчатский край	Очно-заочная; Государственные, муниципальные (без учета организаций в ведении ФСИН)	         отчислено в виде меры дисциплинарного взыскания / 14.0	0	0	0	0	0	0	0	0	0	0	0	0	0	0	0	0	0	0	0	0
Камчатский край	Очно-заочная; Государственные, муниципальные (без учета организаций в ведении ФСИН)	         отчислено из-за просрочки оплаты обучения / 15.0	0	0	0	0	0	0	0	0	0	0	0	0	0	0	0	0	0	0	0	0
Камчатский край	Очно-заочная; Государственные, муниципальные (без учета организаций в ведении ФСИН)	"    в том числе:
    переведено на другие формы обучения данной
    организации на программы того же уровня / 7.0"	0	0	0	0	0	0	0	0	0	0	0	0	0	0	0	0	0	0	0	0
Камчатский край	Очно-заочная; Государственные, муниципальные (без учета организаций в ведении ФСИН)	"    в том числе:
    переведено с других форм обучения данной
    образовательной организации с программ того же уровня / 2.0"	0	0	0	0	0	0	0	0	0	0	0	0	0	0	0	0	0	0	0	0
Камчатский край	Очно-заочная; Государственные, муниципальные (без учета организаций в ведении ФСИН)	    восстановлены из числа ранее отчисленных / 4.0	0	0	0	0	0	0	0	0	0	0	0	0	0	0	0	0	0	0	5	5
Камчатский край	Очно-заочная; Государственные, муниципальные (без учета организаций в ведении ФСИН)	    выбыло по другим причинам / 16.0	0	0	0	0	0	0	0	0	0	0	0	0	0	0	0	0	0	0	0	0
Камчатский край	Очно-заочная; Государственные, муниципальные (без учета организаций в ведении ФСИН)	"    добровольно прекратили образовательные отношения
    (бросили учебу) / 10.0"	0	0	0	0	0	0	0	0	0	0	0	0	0	0	0	0	0	0	4	4
Камчатский край	Очно-заочная; Государственные, муниципальные (без учета организаций в ведении ФСИН)	"    отчислено:
         по неуспеваемости / 11.0"	0	0	0	0	0	0	0	0	0	0	0	0	0	0	0	0	0	0	0	0
Камчатский край	Очно-заочная; Государственные, муниципальные (без учета организаций в ведении ФСИН)	"    переведено в другие образовательные организации
    на программы того же уровня / 8.0"	0	0	0	0	0	0	0	0	0	0	0	0	0	0	0	0	0	0	1	1
Камчатский край	Очно-заочная; Государственные, муниципальные (без учета организаций в ведении ФСИН)	"    переведено из других образовательных организаций 
    с программ того же уровня / 3.0"	0	0	0	0	0	0	0	0	0	0	0	0	0	0	0	0	0	0	1	1
Камчатский край	Очно-заочная; Государственные, муниципальные (без учета организаций в ведении ФСИН)	    по болезни / 9.0	0	0	0	0	0	0	0	0	0	0	0	0	0	0	0	0	0	0	23	23
Камчатский край	Очно-заочная; Государственные, муниципальные (без учета организаций в ведении ФСИН)	    прибыло по другим причинам / 5.0	0	0	0	0	0	0	0	0	0	0	0	0	0	0	0	0	0	0	0	0
Камчатский край	Очно-заочная; Государственные, муниципальные (без учета организаций в ведении ФСИН)	Выбыло студентов - всего (сумма стр. 07-11, 13-15) / 6.0	0	0	0	0	0	0	0	0	0	0	0	0	0	0	0	0	0	0	28	28
Камчатский край	Очно-заочная; Государственные, муниципальные (без учета организаций в ведении ФСИН)	Прибыло студентов - всего (сумма стр. 02-05) / 1.0	0	0	0	0	0	0	0	0	0	0	0	0	0	0	0	0	0	0	6	6
Камчатский край	Очно-заочная; Государственные, муниципальные (без учета организаций в ведении ФСИН)	"Численность студентов на начало прошлого учебного года
(на 1 октября) / 17.0"	0	0	0	0	0	0	0	0	0	0	0	0	0	0	0	0	0	0	266	266
Камчатский край	Частные; Заочная	            из стр. 11 - не прошли итоговую аттестацию / 12.0	0	0	0	0	0	0	0	0	0	0	0	0	0	0	0	0	0	0	0	0
Камчатский край	Частные; Заочная	"            из стр. 11 – лица с ограниченными возможностями здоровья,
            инвалиды, дети-инвалиды / 13.0"	0	0	0	0	0	0	0	0	0	0	0	0	0	0	0	0	0	0	0	0
Камчатский край	Частные; Заочная	         отчислено в виде меры дисциплинарного взыскания / 14.0	0	0	0	0	0	0	0	0	0	0	0	0	0	0	0	0	0	0	0	0
Камчатский край	Частные; Заочная	         отчислено из-за просрочки оплаты обучения / 15.0	0	0	0	0	0	0	0	0	0	0	0	0	0	13	13	0	0	0	1	1
Камчатский край	Частные; Заочная	"    в том числе:
    переведено на другие формы обучения данной
    организации на программы того же уровня / 7.0"	0	0	0	0	0	0	0	0	0	0	0	0	0	0	0	0	0	0	0	0
Камчатский край	Частные; Заочная	"    в том числе:
    переведено с других форм обучения данной
    образовательной организации с программ того же уровня / 2.0"	0	0	0	0	0	0	0	0	0	0	0	0	0	7	7	0	0	0	0	0
Камчатский край	Частные; Заочная	    восстановлены из числа ранее отчисленных / 4.0	0	0	0	0	0	0	0	0	0	0	0	0	0	6	6	0	0	0	14	14
Камчатский край	Частные; Заочная	    выбыло по другим причинам / 16.0	0	0	0	0	0	0	0	0	0	0	0	0	0	1	1	0	0	0	0	0
Камчатский край	Частные; Заочная	"    добровольно прекратили образовательные отношения
    (бросили учебу) / 10.0"	0	0	0	0	0	0	0	0	0	0	0	0	0	0	0	0	0	0	0	0
Камчатский край	Частные; Заочная	"    отчислено:
         по неуспеваемости / 11.0"	0	0	0	0	0	0	0	0	0	0	0	0	0	0	0	0	0	0	0	0
Камчатский край	Частные; Заочная	"    переведено в другие образовательные организации
    на программы того же уровня / 8.0"	0	0	0	0	0	0	0	0	0	0	0	0	0	0	0	0	0	0	0	0
Камчатский край	Частные; Заочная	"    переведено из других образовательных организаций 
    с программ того же уровня / 3.0"	0	0	0	0	0	0	0	0	0	0	0	0	0	7	7	0	0	0	1	1
Камчатский край	Частные; Заочная	    по болезни / 9.0	0	0	0	0	0	0	0	0	0	0	0	0	0	0	0	0	0	0	0	0
Камчатский край	Частные; Заочная	    прибыло по другим причинам / 5.0	0	0	0	0	0	0	0	0	0	0	0	0	0	0	0	0	0	0	0	0
Камчатский край	Частные; Заочная	Выбыло студентов - всего (сумма стр. 07-11, 13-15) / 6.0	0	0	0	0	0	0	0	0	0	0	0	0	0	14	14	0	0	0	1	1
Камчатский край	Частные; Заочная	Прибыло студентов - всего (сумма стр. 02-05) / 1.0	0	0	0	0	0	0	0	0	0	0	0	0	0	20	20	0	0	0	15	15
Камчатский край	Частные; Заочная	"Численность студентов на начало прошлого учебного года
(на 1 октября) / 17.0"	0	0	0	0	0	0	0	0	0	0	0	0	0	73	73	0	0	0	90	90
Камчатский край	Частные; Очная	            из стр. 11 - не прошли итоговую аттестацию / 12.0	0	0	0	0	0	0	0	0	0	0	0	0	0	0	0	0	0	0	0	0
Камчатский край	Частные; Очная	"            из стр. 11 – лица с ограниченными возможностями здоровья,
            инвалиды, дети-инвалиды / 13.0"	0	0	0	0	0	0	0	0	0	0	0	0	0	0	0	0	0	0	0	0
Камчатский край	Частные; Очная	         отчислено в виде меры дисциплинарного взыскания / 14.0	0	0	0	0	0	0	0	0	0	0	0	0	0	0	0	0	0	0	0	0
Камчатский край	Частные; Очная	         отчислено из-за просрочки оплаты обучения / 15.0	0	0	0	0	0	0	0	0	0	0	0	0	0	21	21	0	0	0	7	7
Камчатский край	Частные; Очная	"    в том числе:
    переведено на другие формы обучения данной
    организации на программы того же уровня / 7.0"	0	0	0	0	0	0	0	0	0	0	0	0	0	2	2	0	0	0	2	2
Камчатский край	Частные; Очная	"    в том числе:
    переведено с других форм обучения данной
    образовательной организации с программ того же уровня / 2.0"	0	0	0	0	0	0	0	0	0	0	0	0	0	0	0	0	0	0	0	0
Камчатский край	Частные; Очная	    восстановлены из числа ранее отчисленных / 4.0	0	0	0	0	0	0	0	0	0	0	7	0	0	9	16	0	0	0	2	2
Камчатский край	Частные; Очная	    выбыло по другим причинам / 16.0	0	0	0	0	0	0	0	0	0	0	2	0	0	0	2	0	0	0	0	0
Камчатский край	Частные; Очная	"    добровольно прекратили образовательные отношения
    (бросили учебу) / 10.0"	0	0	0	0	0	0	0	0	0	0	20	0	0	0	20	0	0	0	0	0
Камчатский край	Частные; Очная	"    отчислено:
         по неуспеваемости / 11.0"	5	0	0	0	5	2	0	0	0	2	14	0	0	0	14	3	0	0	0	3
Камчатский край	Частные; Очная	"    переведено в другие образовательные организации
    на программы того же уровня / 8.0"	0	0	0	0	0	0	0	0	0	0	3	0	0	1	4	0	0	0	0	0
Камчатский край	Частные; Очная	"    переведено из других образовательных организаций 
    с программ того же уровня / 3.0"	0	0	0	0	0	0	0	0	0	0	0	0	0	14	14	1	0	0	0	1
Камчатский край	Частные; Очная	    по болезни / 9.0	0	0	0	0	0	0	0	0	0	0	0	0	0	0	0	0	0	0	0	0
Камчатский край	Частные; Очная	    прибыло по другим причинам / 5.0	0	0	0	0	0	0	0	0	0	0	0	0	0	0	0	0	0	0	0	0
Камчатский край	Частные; Очная	Выбыло студентов - всего (сумма стр. 07-11, 13-15) / 6.0	5	0	0	0	5	2	0	0	0	2	39	0	0	24	63	3	0	0	9	12
Камчатский край	Частные; Очная	Прибыло студентов - всего (сумма стр. 02-05) / 1.0	0	0	0	0	0	0	0	0	0	0	7	0	0	23	30	1	0	0	2	3
Камчатский край	Частные; Очная	"Численность студентов на начало прошлого учебного года
(на 1 октября) / 17.0"	19	0	0	0	19	6	0	0	0	6	281	0	0	344	625	21	0	0	149	170
Карачаево-Черкесская Республика	Государственные, муниципальные (без учета организаций в ведении ФСИН); Заочная	            из стр. 11 - не прошли итоговую аттестацию / 12.0	0	0	0	0	0	0	0	0	0	0	0	0	0	0	0	0	0	0	0	0
Карачаево-Черкесская Республика	Государственные, муниципальные (без учета организаций в ведении ФСИН); Заочная	"            из стр. 11 – лица с ограниченными возможностями здоровья,
            инвалиды, дети-инвалиды / 13.0"	0	0	0	0	0	0	0	0	0	0	0	0	0	0	0	0	0	0	0	0
Карачаево-Черкесская Республика	Государственные, муниципальные (без учета организаций в ведении ФСИН); Заочная	         отчислено в виде меры дисциплинарного взыскания / 14.0	0	0	0	0	0	0	0	0	0	0	0	0	0	0	0	0	0	0	0	0
Карачаево-Черкесская Республика	Государственные, муниципальные (без учета организаций в ведении ФСИН); Заочная	         отчислено из-за просрочки оплаты обучения / 15.0	0	0	0	0	0	0	0	0	0	0	0	0	0	0	0	0	0	0	0	0
Карачаево-Черкесская Республика	Государственные, муниципальные (без учета организаций в ведении ФСИН); Заочная	"    в том числе:
    переведено на другие формы обучения данной
    организации на программы того же уровня / 7.0"	0	0	0	0	0	0	0	0	0	0	0	0	0	0	0	0	0	0	0	0
Карачаево-Черкесская Республика	Государственные, муниципальные (без учета организаций в ведении ФСИН); Заочная	"    в том числе:
    переведено с других форм обучения данной
    образовательной организации с программ того же уровня / 2.0"	0	0	0	0	0	0	0	0	0	0	0	0	0	2	2	0	0	0	35	35
Карачаево-Черкесская Республика	Государственные, муниципальные (без учета организаций в ведении ФСИН); Заочная	    восстановлены из числа ранее отчисленных / 4.0	0	0	0	0	0	0	0	0	0	0	0	0	0	2	2	0	0	0	5	5
Карачаево-Черкесская Республика	Государственные, муниципальные (без учета организаций в ведении ФСИН); Заочная	    выбыло по другим причинам / 16.0	0	0	0	0	0	0	0	0	0	0	0	0	0	1	1	9	0	0	0	9
Карачаево-Черкесская Республика	Государственные, муниципальные (без учета организаций в ведении ФСИН); Заочная	"    добровольно прекратили образовательные отношения
    (бросили учебу) / 10.0"	0	0	0	0	0	0	0	0	0	0	0	0	0	4	4	0	0	0	3	3
Карачаево-Черкесская Республика	Государственные, муниципальные (без учета организаций в ведении ФСИН); Заочная	"    отчислено:
         по неуспеваемости / 11.0"	0	0	0	0	0	0	0	0	0	0	0	0	0	0	0	0	0	0	7	7
Карачаево-Черкесская Республика	Государственные, муниципальные (без учета организаций в ведении ФСИН); Заочная	"    переведено в другие образовательные организации
    на программы того же уровня / 8.0"	0	0	0	0	0	0	0	0	0	0	0	0	0	1	1	0	0	0	1	1
Карачаево-Черкесская Республика	Государственные, муниципальные (без учета организаций в ведении ФСИН); Заочная	"    переведено из других образовательных организаций 
    с программ того же уровня / 3.0"	0	0	0	0	0	0	0	0	0	0	0	0	0	0	0	0	0	0	0	0
Карачаево-Черкесская Республика	Государственные, муниципальные (без учета организаций в ведении ФСИН); Заочная	    по болезни / 9.0	0	0	0	0	0	0	0	0	0	0	0	0	0	0	0	0	0	0	0	0
Карачаево-Черкесская Республика	Государственные, муниципальные (без учета организаций в ведении ФСИН); Заочная	    прибыло по другим причинам / 5.0	0	0	0	0	0	0	0	0	0	0	0	0	0	0	0	47	0	0	0	47
Карачаево-Черкесская Республика	Государственные, муниципальные (без учета организаций в ведении ФСИН); Заочная	Выбыло студентов - всего (сумма стр. 07-11, 13-15) / 6.0	0	0	0	0	0	0	0	0	0	0	0	0	0	6	6	9	0	0	11	20
Карачаево-Черкесская Республика	Государственные, муниципальные (без учета организаций в ведении ФСИН); Заочная	Прибыло студентов - всего (сумма стр. 02-05) / 1.0	0	0	0	0	0	0	0	0	0	0	0	0	0	4	4	47	0	0	40	87
Карачаево-Черкесская Республика	Государственные, муниципальные (без учета организаций в ведении ФСИН); Заочная	"Численность студентов на начало прошлого учебного года
(на 1 октября) / 17.0"	0	0	0	0	0	0	0	0	0	0	0	0	0	63	63	4	0	0	87	91
Карачаево-Черкесская Республика	Государственные, муниципальные (без учета организаций в ведении ФСИН); Очная	            из стр. 11 - не прошли итоговую аттестацию / 12.0	5	0	0	0	5	0	0	0	0	0	11	0	0	0	11	0	0	0	0	0
Карачаево-Черкесская Республика	Государственные, муниципальные (без учета организаций в ведении ФСИН); Очная	"            из стр. 11 – лица с ограниченными возможностями здоровья,
            инвалиды, дети-инвалиды / 13.0"	0	0	0	0	0	0	0	0	0	0	0	0	0	0	0	0	0	0	0	0
Карачаево-Черкесская Республика	Государственные, муниципальные (без учета организаций в ведении ФСИН); Очная	         отчислено в виде меры дисциплинарного взыскания / 14.0	4	0	0	0	4	0	0	0	0	0	10	0	0	0	10	0	0	0	0	0
Карачаево-Черкесская Республика	Государственные, муниципальные (без учета организаций в ведении ФСИН); Очная	         отчислено из-за просрочки оплаты обучения / 15.0	0	0	0	0	0	0	0	0	0	0	0	0	0	1	1	0	0	0	0	0
Карачаево-Черкесская Республика	Государственные, муниципальные (без учета организаций в ведении ФСИН); Очная	"    в том числе:
    переведено на другие формы обучения данной
    организации на программы того же уровня / 7.0"	0	0	0	0	0	0	0	0	0	0	37	0	25	10	72	15	0	0	9	24
Карачаево-Черкесская Республика	Государственные, муниципальные (без учета организаций в ведении ФСИН); Очная	"    в том числе:
    переведено с других форм обучения данной
    образовательной организации с программ того же уровня / 2.0"	0	0	0	0	0	0	0	0	0	0	3	0	0	0	3	5	0	0	19	24
Карачаево-Черкесская Республика	Государственные, муниципальные (без учета организаций в ведении ФСИН); Очная	    восстановлены из числа ранее отчисленных / 4.0	11	0	0	0	11	0	0	0	0	0	15	0	2	4	21	0	0	2	17	19
Карачаево-Черкесская Республика	Государственные, муниципальные (без учета организаций в ведении ФСИН); Очная	    выбыло по другим причинам / 16.0	68	0	0	0	68	0	0	0	0	0	180	1	4	37	222	5	1	0	0	6
Карачаево-Черкесская Республика	Государственные, муниципальные (без учета организаций в ведении ФСИН); Очная	"    добровольно прекратили образовательные отношения
    (бросили учебу) / 10.0"	26	0	0	0	26	0	0	0	0	0	42	0	5	8	55	1	0	1	0	2
Карачаево-Черкесская Республика	Государственные, муниципальные (без учета организаций в ведении ФСИН); Очная	"    отчислено:
         по неуспеваемости / 11.0"	40	0	0	0	40	0	0	0	0	0	46	5	0	5	56	2	6	0	0	8
Карачаево-Черкесская Республика	Государственные, муниципальные (без учета организаций в ведении ФСИН); Очная	"    переведено в другие образовательные организации
    на программы того же уровня / 8.0"	11	6	0	0	17	0	0	0	0	0	52	0	3	4	59	0	0	0	0	0
Карачаево-Черкесская Республика	Государственные, муниципальные (без учета организаций в ведении ФСИН); Очная	"    переведено из других образовательных организаций 
    с программ того же уровня / 3.0"	12	0	0	0	12	0	0	0	0	0	124	4	11	22	161	0	0	6	13	19
Карачаево-Черкесская Республика	Государственные, муниципальные (без учета организаций в ведении ФСИН); Очная	    по болезни / 9.0	5	0	0	0	5	0	0	0	0	0	9	0	20	15	44	0	0	0	8	8
Карачаево-Черкесская Республика	Государственные, муниципальные (без учета организаций в ведении ФСИН); Очная	    прибыло по другим причинам / 5.0	154	0	0	0	154	0	0	0	0	0	349	0	0	38	387	69	0	0	13	82
Карачаево-Черкесская Республика	Государственные, муниципальные (без учета организаций в ведении ФСИН); Очная	Выбыло студентов - всего (сумма стр. 07-11, 13-15) / 6.0	154	6	0	0	160	0	0	0	0	0	376	6	57	80	519	23	7	1	17	48
Карачаево-Черкесская Республика	Государственные, муниципальные (без учета организаций в ведении ФСИН); Очная	Прибыло студентов - всего (сумма стр. 02-05) / 1.0	177	0	0	0	177	0	0	0	0	0	491	4	13	64	572	74	0	8	62	144
Карачаево-Черкесская Республика	Государственные, муниципальные (без учета организаций в ведении ФСИН); Очная	"Численность студентов на начало прошлого учебного года
(на 1 октября) / 17.0"	910	0	0	0	910	20	0	0	0	20	3511	99	1047	1195	5852	67	23	8	142	240
Карачаево-Черкесская Республика	Частные; Заочная	            из стр. 11 - не прошли итоговую аттестацию / 12.0	0	0	0	0	0	0	0	0	0	0	0	0	0	0	0	0	0	0	0	0
Карачаево-Черкесская Республика	Частные; Заочная	"            из стр. 11 – лица с ограниченными возможностями здоровья,
            инвалиды, дети-инвалиды / 13.0"	0	0	0	0	0	0	0	0	0	0	0	0	0	0	0	0	0	0	0	0
Карачаево-Черкесская Республика	Частные; Заочная	         отчислено в виде меры дисциплинарного взыскания / 14.0	0	0	0	0	0	0	0	0	0	0	0	0	0	0	0	0	0	0	0	0
Карачаево-Черкесская Республика	Частные; Заочная	         отчислено из-за просрочки оплаты обучения / 15.0	0	0	0	0	0	0	0	0	0	0	0	0	0	3	3	0	0	0	1	1
Карачаево-Черкесская Республика	Частные; Заочная	"    в том числе:
    переведено на другие формы обучения данной
    организации на программы того же уровня / 7.0"	0	0	0	0	0	0	0	0	0	0	0	0	0	0	0	0	0	0	0	0
Карачаево-Черкесская Республика	Частные; Заочная	"    в том числе:
    переведено с других форм обучения данной
    образовательной организации с программ того же уровня / 2.0"	0	0	0	0	0	0	0	0	0	0	0	0	0	0	0	0	0	0	0	0
Карачаево-Черкесская Республика	Частные; Заочная	    восстановлены из числа ранее отчисленных / 4.0	0	0	0	0	0	0	0	0	0	0	0	0	0	3	3	0	0	0	1	1
Карачаево-Черкесская Республика	Частные; Заочная	    выбыло по другим причинам / 16.0	0	0	0	0	0	0	0	0	0	0	0	0	0	21	21	0	0	0	16	16
Карачаево-Черкесская Республика	Частные; Заочная	"    добровольно прекратили образовательные отношения
    (бросили учебу) / 10.0"	0	0	0	0	0	0	0	0	0	0	0	0	0	3	3	0	0	0	0	0
Карачаево-Черкесская Республика	Частные; Заочная	"    отчислено:
         по неуспеваемости / 11.0"	0	0	0	0	0	0	0	0	0	0	0	0	0	6	6	0	0	0	0	0
Карачаево-Черкесская Республика	Частные; Заочная	"    переведено в другие образовательные организации
    на программы того же уровня / 8.0"	0	0	0	0	0	0	0	0	0	0	0	0	0	7	7	0	0	0	2	2
Карачаево-Черкесская Республика	Частные; Заочная	"    переведено из других образовательных организаций 
    с программ того же уровня / 3.0"	0	0	0	0	0	0	0	0	0	0	0	0	0	1	1	0	0	0	0	0
Карачаево-Черкесская Республика	Частные; Заочная	    по болезни / 9.0	0	0	0	0	0	0	0	0	0	0	0	0	0	0	0	0	0	0	0	0
Карачаево-Черкесская Республика	Частные; Заочная	    прибыло по другим причинам / 5.0	0	0	0	0	0	0	0	0	0	0	0	0	0	0	0	0	0	0	0	0
Карачаево-Черкесская Республика	Частные; Заочная	Выбыло студентов - всего (сумма стр. 07-11, 13-15) / 6.0	0	0	0	0	0	0	0	0	0	0	0	0	0	40	40	0	0	0	19	19
Карачаево-Черкесская Республика	Частные; Заочная	Прибыло студентов - всего (сумма стр. 02-05) / 1.0	0	0	0	0	0	0	0	0	0	0	0	0	0	4	4	0	0	0	1	1
Карачаево-Черкесская Республика	Частные; Заочная	"Численность студентов на начало прошлого учебного года
(на 1 октября) / 17.0"	0	0	0	0	0	0	0	0	0	0	0	0	0	182	182	0	0	0	27	27
Карачаево-Черкесская Республика	Частные; Очная	            из стр. 11 - не прошли итоговую аттестацию / 12.0	0	0	0	0	0	0	0	0	0	0	0	0	0	0	0	0	0	0	0	0
Карачаево-Черкесская Республика	Частные; Очная	"            из стр. 11 – лица с ограниченными возможностями здоровья,
            инвалиды, дети-инвалиды / 13.0"	0	0	0	0	0	0	0	0	0	0	0	0	0	0	0	0	0	0	0	0
Карачаево-Черкесская Республика	Частные; Очная	         отчислено в виде меры дисциплинарного взыскания / 14.0	0	0	0	0	0	0	0	0	0	0	0	0	0	0	0	0	0	0	0	0
Карачаево-Черкесская Республика	Частные; Очная	         отчислено из-за просрочки оплаты обучения / 15.0	0	0	0	0	0	0	0	0	0	0	0	0	0	14	14	0	0	0	21	21
Карачаево-Черкесская Республика	Частные; Очная	"    в том числе:
    переведено на другие формы обучения данной
    организации на программы того же уровня / 7.0"	0	0	0	0	0	0	0	0	0	0	0	0	0	1	1	0	0	0	0	0
Карачаево-Черкесская Республика	Частные; Очная	"    в том числе:
    переведено с других форм обучения данной
    образовательной организации с программ того же уровня / 2.0"	0	0	0	0	0	0	0	0	0	0	0	0	0	2	2	0	0	0	0	0
Карачаево-Черкесская Республика	Частные; Очная	    восстановлены из числа ранее отчисленных / 4.0	0	0	0	0	0	0	0	0	0	0	0	0	0	17	17	0	0	0	3	3
Карачаево-Черкесская Республика	Частные; Очная	    выбыло по другим причинам / 16.0	0	0	0	0	0	0	0	0	0	0	0	0	0	53	53	0	0	0	4	4
Карачаево-Черкесская Республика	Частные; Очная	"    добровольно прекратили образовательные отношения
    (бросили учебу) / 10.0"	0	0	0	0	0	0	0	0	0	0	0	0	0	19	19	0	0	0	2	2
Карачаево-Черкесская Республика	Частные; Очная	"    отчислено:
         по неуспеваемости / 11.0"	0	0	0	0	0	0	0	0	0	0	0	0	0	19	19	0	0	0	2	2
Карачаево-Черкесская Республика	Частные; Очная	"    переведено в другие образовательные организации
    на программы того же уровня / 8.0"	0	0	0	0	0	0	0	0	0	0	0	0	0	16	16	0	0	0	0	0
Карачаево-Черкесская Республика	Частные; Очная	"    переведено из других образовательных организаций 
    с программ того же уровня / 3.0"	0	0	0	0	0	0	0	0	0	0	0	0	0	66	66	0	0	0	20	20
Карачаево-Черкесская Республика	Частные; Очная	    по болезни / 9.0	0	0	0	0	0	0	0	0	0	0	0	0	0	0	0	0	0	0	0	0
Карачаево-Черкесская Республика	Частные; Очная	    прибыло по другим причинам / 5.0	0	0	0	0	0	0	0	0	0	0	0	0	0	39	39	0	0	0	9	9
Карачаево-Черкесская Республика	Частные; Очная	Выбыло студентов - всего (сумма стр. 07-11, 13-15) / 6.0	0	0	0	0	0	0	0	0	0	0	0	0	0	122	122	0	0	0	29	29
Карачаево-Черкесская Республика	Частные; Очная	Прибыло студентов - всего (сумма стр. 02-05) / 1.0	0	0	0	0	0	0	0	0	0	0	0	0	0	124	124	0	0	0	32	32
Карачаево-Черкесская Республика	Частные; Очная	"Численность студентов на начало прошлого учебного года
(на 1 октября) / 17.0"	0	0	0	0	0	0	0	0	0	0	0	0	0	1775	1775	0	0	0	313	313
Карачаево-Черкесская Республика	Частные; Очно-заочная	            из стр. 11 - не прошли итоговую аттестацию / 12.0	0	0	0	0	0	0	0	0	0	0	0	0	0	0	0	0	0	0	0	0
Карачаево-Черкесская Республика	Частные; Очно-заочная	"            из стр. 11 – лица с ограниченными возможностями здоровья,
            инвалиды, дети-инвалиды / 13.0"	0	0	0	0	0	0	0	0	0	0	0	0	0	0	0	0	0	0	0	0
Карачаево-Черкесская Республика	Частные; Очно-заочная	         отчислено в виде меры дисциплинарного взыскания / 14.0	0	0	0	0	0	0	0	0	0	0	0	0	0	0	0	0	0	0	0	0
Карачаево-Черкесская Республика	Частные; Очно-заочная	         отчислено из-за просрочки оплаты обучения / 15.0	0	0	0	0	0	0	0	0	0	0	0	0	0	2	2	0	0	0	0	0
Карачаево-Черкесская Республика	Частные; Очно-заочная	"    в том числе:
    переведено на другие формы обучения данной
    организации на программы того же уровня / 7.0"	0	0	0	0	0	0	0	0	0	0	0	0	0	0	0	0	0	0	0	0
Карачаево-Черкесская Республика	Частные; Очно-заочная	"    в том числе:
    переведено с других форм обучения данной
    образовательной организации с программ того же уровня / 2.0"	0	0	0	0	0	0	0	0	0	0	0	0	0	0	0	0	0	0	0	0
Карачаево-Черкесская Республика	Частные; Очно-заочная	    восстановлены из числа ранее отчисленных / 4.0	0	0	0	0	0	0	0	0	0	0	0	0	0	0	0	0	0	0	2	2
Карачаево-Черкесская Республика	Частные; Очно-заочная	    выбыло по другим причинам / 16.0	0	0	0	0	0	0	0	0	0	0	0	0	0	0	0	0	0	0	0	0
Карачаево-Черкесская Республика	Частные; Очно-заочная	"    добровольно прекратили образовательные отношения
    (бросили учебу) / 10.0"	0	0	0	0	0	0	0	0	0	0	0	0	0	0	0	0	0	0	4	4
Карачаево-Черкесская Республика	Частные; Очно-заочная	"    отчислено:
         по неуспеваемости / 11.0"	0	0	0	0	0	0	0	0	0	0	0	0	0	0	0	0	0	0	2	2
Карачаево-Черкесская Республика	Частные; Очно-заочная	"    переведено в другие образовательные организации
    на программы того же уровня / 8.0"	0	0	0	0	0	0	0	0	0	0	0	0	0	0	0	0	0	0	0	0
Карачаево-Черкесская Республика	Частные; Очно-заочная	"    переведено из других образовательных организаций 
    с программ того же уровня / 3.0"	0	0	0	0	0	0	0	0	0	0	0	0	0	0	0	0	0	0	0	0
Карачаево-Черкесская Республика	Частные; Очно-заочная	    по болезни / 9.0	0	0	0	0	0	0	0	0	0	0	0	0	0	0	0	0	0	0	0	0
Карачаево-Черкесская Республика	Частные; Очно-заочная	    прибыло по другим причинам / 5.0	0	0	0	0	0	0	0	0	0	0	0	0	0	0	0	0	0	0	0	0
Карачаево-Черкесская Республика	Частные; Очно-заочная	Выбыло студентов - всего (сумма стр. 07-11, 13-15) / 6.0	0	0	0	0	0	0	0	0	0	0	0	0	0	2	2	0	0	0	6	6
Карачаево-Черкесская Республика	Частные; Очно-заочная	Прибыло студентов - всего (сумма стр. 02-05) / 1.0	0	0	0	0	0	0	0	0	0	0	0	0	0	0	0	0	0	0	2	2
Карачаево-Черкесская Республика	Частные; Очно-заочная	"Численность студентов на начало прошлого учебного года
(на 1 октября) / 17.0"	0	0	0	0	0	0	0	0	0	0	0	0	0	4	4	0	0	0	153	153
Кемеровская область	Государственные, муниципальные (без учета организаций в ведении ФСИН); Заочная	            из стр. 11 - не прошли итоговую аттестацию / 12.0	0	0	0	0	0	0	0	0	0	0	0	0	0	0	0	0	0	1	1	2
Кемеровская область	Государственные, муниципальные (без учета организаций в ведении ФСИН); Заочная	"            из стр. 11 – лица с ограниченными возможностями здоровья,
            инвалиды, дети-инвалиды / 13.0"	0	0	0	0	0	0	0	0	0	0	0	0	0	0	0	0	0	0	0	0
Кемеровская область	Государственные, муниципальные (без учета организаций в ведении ФСИН); Заочная	         отчислено в виде меры дисциплинарного взыскания / 14.0	0	0	0	0	0	0	0	0	0	0	0	0	0	7	7	0	0	0	6	6
Кемеровская область	Государственные, муниципальные (без учета организаций в ведении ФСИН); Заочная	         отчислено из-за просрочки оплаты обучения / 15.0	0	0	0	0	0	0	0	0	0	0	0	0	0	110	110	0	0	0	117	117
Кемеровская область	Государственные, муниципальные (без учета организаций в ведении ФСИН); Заочная	"    в том числе:
    переведено на другие формы обучения данной
    организации на программы того же уровня / 7.0"	0	0	0	0	0	0	0	0	0	0	0	0	3	0	3	2	0	0	17	19
Кемеровская область	Государственные, муниципальные (без учета организаций в ведении ФСИН); Заочная	"    в том числе:
    переведено с других форм обучения данной
    образовательной организации с программ того же уровня / 2.0"	0	0	0	0	0	0	0	0	0	0	0	0	2	124	126	16	0	0	37	53
Кемеровская область	Государственные, муниципальные (без учета организаций в ведении ФСИН); Заочная	    восстановлены из числа ранее отчисленных / 4.0	0	0	0	0	0	0	0	0	0	0	0	0	0	40	40	7	0	1	64	72
Кемеровская область	Государственные, муниципальные (без учета организаций в ведении ФСИН); Заочная	    выбыло по другим причинам / 16.0	0	0	0	0	0	0	0	0	0	0	0	0	0	33	33	14	0	2	61	77
Кемеровская область	Государственные, муниципальные (без учета организаций в ведении ФСИН); Заочная	"    добровольно прекратили образовательные отношения
    (бросили учебу) / 10.0"	0	0	0	0	0	0	0	0	0	0	0	0	1	113	114	104	2	15	152	273
Кемеровская область	Государственные, муниципальные (без учета организаций в ведении ФСИН); Заочная	"    отчислено:
         по неуспеваемости / 11.0"	0	0	0	0	0	0	0	0	0	0	17	3	5	42	67	69	7	9	81	166
Кемеровская область	Государственные, муниципальные (без учета организаций в ведении ФСИН); Заочная	"    переведено в другие образовательные организации
    на программы того же уровня / 8.0"	0	0	0	0	0	0	0	0	0	0	0	0	0	4	4	7	0	1	2	10
Кемеровская область	Государственные, муниципальные (без учета организаций в ведении ФСИН); Заочная	"    переведено из других образовательных организаций 
    с программ того же уровня / 3.0"	0	0	0	0	0	0	0	0	0	0	0	0	0	20	20	4	0	0	9	13
Кемеровская область	Государственные, муниципальные (без учета организаций в ведении ФСИН); Заочная	    по болезни / 9.0	0	0	0	0	0	0	0	0	0	0	0	0	0	0	0	0	0	0	6	6
Кемеровская область	Государственные, муниципальные (без учета организаций в ведении ФСИН); Заочная	    прибыло по другим причинам / 5.0	0	0	0	0	0	0	0	0	0	0	0	0	0	94	94	13	6	0	154	173
Кемеровская область	Государственные, муниципальные (без учета организаций в ведении ФСИН); Заочная	Выбыло студентов - всего (сумма стр. 07-11, 13-15) / 6.0	0	0	0	0	0	0	0	0	0	0	17	3	9	309	338	196	9	27	442	674
Кемеровская область	Государственные, муниципальные (без учета организаций в ведении ФСИН); Заочная	Прибыло студентов - всего (сумма стр. 02-05) / 1.0	0	0	0	0	0	0	0	0	0	0	0	0	2	278	280	40	6	1	264	311
Кемеровская область	Государственные, муниципальные (без учета организаций в ведении ФСИН); Заочная	"Численность студентов на начало прошлого учебного года
(на 1 октября) / 17.0"	0	0	0	0	0	0	0	0	0	0	21	55	89	1357	1522	1701	175	384	3270	5530
Кемеровская область	Государственные, муниципальные (без учета организаций в ведении ФСИН); Очная	            из стр. 11 - не прошли итоговую аттестацию / 12.0	4	0	0	0	4	0	0	0	0	0	3	0	2	1	6	0	0	0	0	0
Кемеровская область	Государственные, муниципальные (без учета организаций в ведении ФСИН); Очная	"            из стр. 11 – лица с ограниченными возможностями здоровья,
            инвалиды, дети-инвалиды / 13.0"	1	0	4	0	5	0	0	0	0	0	3	0	1	1	5	0	0	2	0	2
Кемеровская область	Государственные, муниципальные (без учета организаций в ведении ФСИН); Очная	         отчислено в виде меры дисциплинарного взыскания / 14.0	15	0	1	0	16	0	0	0	0	0	37	0	0	0	37	3	0	0	0	3
Кемеровская область	Государственные, муниципальные (без учета организаций в ведении ФСИН); Очная	         отчислено из-за просрочки оплаты обучения / 15.0	0	0	0	2	2	0	0	0	0	0	0	0	0	36	36	0	0	0	14	14
Кемеровская область	Государственные, муниципальные (без учета организаций в ведении ФСИН); Очная	"    в том числе:
    переведено на другие формы обучения данной
    организации на программы того же уровня / 7.0"	18	0	0	4	22	0	0	0	0	0	128	0	7	54	189	2	0	2	36	40
Кемеровская область	Государственные, муниципальные (без учета организаций в ведении ФСИН); Очная	"    в том числе:
    переведено с других форм обучения данной
    образовательной организации с программ того же уровня / 2.0"	35	0	10	1	46	0	0	0	1	1	57	0	16	5	78	3	0	0	3	6
Кемеровская область	Государственные, муниципальные (без учета организаций в ведении ФСИН); Очная	    восстановлены из числа ранее отчисленных / 4.0	81	0	3	0	84	0	0	0	0	0	225	0	9	79	313	5	0	1	20	26
Кемеровская область	Государственные, муниципальные (без учета организаций в ведении ФСИН); Очная	    выбыло по другим причинам / 16.0	164	0	10	0	174	2	0	0	0	2	464	0	8	124	596	40	0	6	17	63
Кемеровская область	Государственные, муниципальные (без учета организаций в ведении ФСИН); Очная	"    добровольно прекратили образовательные отношения
    (бросили учебу) / 10.0"	782	0	56	5	843	12	0	0	9	21	2330	0	169	588	3087	223	0	11	130	364
Кемеровская область	Государственные, муниципальные (без учета организаций в ведении ФСИН); Очная	"    отчислено:
         по неуспеваемости / 11.0"	201	0	20	0	221	1	0	0	0	1	542	0	33	205	780	28	0	15	38	81
Кемеровская область	Государственные, муниципальные (без учета организаций в ведении ФСИН); Очная	"    переведено в другие образовательные организации
    на программы того же уровня / 8.0"	66	0	12	0	78	1	0	0	0	1	457	0	34	131	622	6	0	1	31	38
Кемеровская область	Государственные, муниципальные (без учета организаций в ведении ФСИН); Очная	"    переведено из других образовательных организаций 
    с программ того же уровня / 3.0"	111	0	7	0	118	2	0	0	0	2	359	0	31	105	495	13	0	1	8	22
Кемеровская область	Государственные, муниципальные (без учета организаций в ведении ФСИН); Очная	    по болезни / 9.0	14	0	3	0	17	0	0	0	0	0	22	0	0	1	23	0	0	0	0	0
Кемеровская область	Государственные, муниципальные (без учета организаций в ведении ФСИН); Очная	    прибыло по другим причинам / 5.0	102	0	8	1	111	1	0	0	0	1	343	0	17	95	455	15	0	4	44	63
Кемеровская область	Государственные, муниципальные (без учета организаций в ведении ФСИН); Очная	Выбыло студентов - всего (сумма стр. 07-11, 13-15) / 6.0	1260	0	102	11	1373	16	0	0	9	25	3980	0	251	1139	5370	302	0	35	266	603
Кемеровская область	Государственные, муниципальные (без учета организаций в ведении ФСИН); Очная	Прибыло студентов - всего (сумма стр. 02-05) / 1.0	329	0	28	2	359	3	0	0	1	4	984	0	73	284	1341	36	0	6	75	117
Кемеровская область	Государственные, муниципальные (без учета организаций в ведении ФСИН); Очная	"Численность студентов на начало прошлого учебного года
(на 1 октября) / 17.0"	8897	0	1249	124	10270	77	0	5	28	110	36546	0	3984	8776	49306	2073	0	229	1729	4031
Кемеровская область	Очно-заочная; Государственные, муниципальные (без учета организаций в ведении ФСИН)	            из стр. 11 - не прошли итоговую аттестацию / 12.0	0	0	0	0	0	0	0	0	0	0	0	0	0	0	0	0	0	0	0	0
Кемеровская область	Очно-заочная; Государственные, муниципальные (без учета организаций в ведении ФСИН)	"            из стр. 11 – лица с ограниченными возможностями здоровья,
            инвалиды, дети-инвалиды / 13.0"	0	0	0	0	0	0	0	0	0	0	0	0	0	0	0	0	0	0	0	0
Кемеровская область	Очно-заочная; Государственные, муниципальные (без учета организаций в ведении ФСИН)	         отчислено в виде меры дисциплинарного взыскания / 14.0	0	0	0	0	0	0	0	0	0	0	0	0	0	0	0	0	0	0	0	0
Кемеровская область	Очно-заочная; Государственные, муниципальные (без учета организаций в ведении ФСИН)	         отчислено из-за просрочки оплаты обучения / 15.0	0	0	0	7	7	0	0	0	0	0	0	0	0	9	9	0	0	0	9	9
Кемеровская область	Очно-заочная; Государственные, муниципальные (без учета организаций в ведении ФСИН)	"    в том числе:
    переведено на другие формы обучения данной
    организации на программы того же уровня / 7.0"	0	0	0	11	11	0	0	0	0	0	0	0	0	4	4	0	0	0	6	6
Кемеровская область	Очно-заочная; Государственные, муниципальные (без учета организаций в ведении ФСИН)	"    в том числе:
    переведено с других форм обучения данной
    образовательной организации с программ того же уровня / 2.0"	0	0	0	5	5	0	0	0	0	0	0	0	0	2	2	0	0	0	6	6
Кемеровская область	Очно-заочная; Государственные, муниципальные (без учета организаций в ведении ФСИН)	    восстановлены из числа ранее отчисленных / 4.0	0	0	0	1	1	0	0	0	1	1	0	0	0	0	0	0	0	0	24	24
Кемеровская область	Очно-заочная; Государственные, муниципальные (без учета организаций в ведении ФСИН)	    выбыло по другим причинам / 16.0	0	0	0	7	7	0	0	0	2	2	0	0	0	7	7	0	0	0	14	14
Кемеровская область	Очно-заочная; Государственные, муниципальные (без учета организаций в ведении ФСИН)	"    добровольно прекратили образовательные отношения
    (бросили учебу) / 10.0"	0	0	0	9	9	0	0	0	0	0	0	0	0	11	11	0	0	0	140	140
Кемеровская область	Очно-заочная; Государственные, муниципальные (без учета организаций в ведении ФСИН)	"    отчислено:
         по неуспеваемости / 11.0"	0	0	0	0	0	0	0	0	0	0	0	0	0	0	0	0	0	0	29	29
Кемеровская область	Очно-заочная; Государственные, муниципальные (без учета организаций в ведении ФСИН)	"    переведено в другие образовательные организации
    на программы того же уровня / 8.0"	0	0	0	6	6	0	0	0	0	0	0	0	0	9	9	0	0	0	9	9
Кемеровская область	Очно-заочная; Государственные, муниципальные (без учета организаций в ведении ФСИН)	"    переведено из других образовательных организаций 
    с программ того же уровня / 3.0"	0	0	0	21	21	0	0	0	2	2	0	0	0	16	16	0	0	0	2	2
Кемеровская область	Очно-заочная; Государственные, муниципальные (без учета организаций в ведении ФСИН)	    по болезни / 9.0	0	0	0	0	0	0	0	0	0	0	0	0	0	0	0	0	0	0	0	0
Кемеровская область	Очно-заочная; Государственные, муниципальные (без учета организаций в ведении ФСИН)	    прибыло по другим причинам / 5.0	0	0	0	5	5	0	0	0	0	0	0	0	0	5	5	0	0	0	20	20
Кемеровская область	Очно-заочная; Государственные, муниципальные (без учета организаций в ведении ФСИН)	Выбыло студентов - всего (сумма стр. 07-11, 13-15) / 6.0	0	0	0	40	40	0	0	0	2	2	0	0	0	40	40	0	0	0	207	207
Кемеровская область	Очно-заочная; Государственные, муниципальные (без учета организаций в ведении ФСИН)	Прибыло студентов - всего (сумма стр. 02-05) / 1.0	0	0	0	32	32	0	0	0	3	3	0	0	0	23	23	0	0	0	52	52
Кемеровская область	Очно-заочная; Государственные, муниципальные (без учета организаций в ведении ФСИН)	"Численность студентов на начало прошлого учебного года
(на 1 октября) / 17.0"	0	0	0	149	149	0	0	0	24	24	0	0	0	103	103	0	0	0	2234	2234
Кемеровская область	Частные; Заочная	            из стр. 11 - не прошли итоговую аттестацию / 12.0	0	0	0	0	0	0	0	0	0	0	0	0	0	0	0	0	0	0	0	0
Кемеровская область	Частные; Заочная	"            из стр. 11 – лица с ограниченными возможностями здоровья,
            инвалиды, дети-инвалиды / 13.0"	0	0	0	0	0	0	0	0	0	0	0	0	0	0	0	0	0	0	0	0
Кемеровская область	Частные; Заочная	         отчислено в виде меры дисциплинарного взыскания / 14.0	0	0	0	0	0	0	0	0	0	0	0	0	0	0	0	0	0	0	0	0
Кемеровская область	Частные; Заочная	         отчислено из-за просрочки оплаты обучения / 15.0	0	0	0	0	0	0	0	0	0	0	0	0	0	12	12	0	0	0	0	0
Кемеровская область	Частные; Заочная	"    в том числе:
    переведено на другие формы обучения данной
    организации на программы того же уровня / 7.0"	0	0	0	0	0	0	0	0	0	0	0	0	0	0	0	0	0	0	0	0
Кемеровская область	Частные; Заочная	"    в том числе:
    переведено с других форм обучения данной
    образовательной организации с программ того же уровня / 2.0"	0	0	0	0	0	0	0	0	0	0	0	0	0	21	21	0	0	0	17	17
Кемеровская область	Частные; Заочная	    восстановлены из числа ранее отчисленных / 4.0	0	0	0	0	0	0	0	0	0	0	0	0	0	12	12	0	0	0	2	2
Кемеровская область	Частные; Заочная	    выбыло по другим причинам / 16.0	0	0	0	0	0	0	0	0	0	0	0	0	0	5	5	0	0	0	2	2
Кемеровская область	Частные; Заочная	"    добровольно прекратили образовательные отношения
    (бросили учебу) / 10.0"	0	0	0	0	0	0	0	0	0	0	0	0	0	8	8	0	0	0	3	3
Кемеровская область	Частные; Заочная	"    отчислено:
         по неуспеваемости / 11.0"	0	0	0	0	0	0	0	0	0	0	0	0	0	12	12	0	0	0	20	20
Кемеровская область	Частные; Заочная	"    переведено в другие образовательные организации
    на программы того же уровня / 8.0"	0	0	0	0	0	0	0	0	0	0	0	0	0	0	0	0	0	0	0	0
Кемеровская область	Частные; Заочная	"    переведено из других образовательных организаций 
    с программ того же уровня / 3.0"	0	0	0	0	0	0	0	0	0	0	0	0	0	10	10	0	0	0	12	12
Кемеровская область	Частные; Заочная	    по болезни / 9.0	0	0	0	0	0	0	0	0	0	0	0	0	0	0	0	0	0	0	0	0
Кемеровская область	Частные; Заочная	    прибыло по другим причинам / 5.0	0	0	0	0	0	0	0	0	0	0	0	0	0	4	4	0	0	0	4	4
Кемеровская область	Частные; Заочная	Выбыло студентов - всего (сумма стр. 07-11, 13-15) / 6.0	0	0	0	0	0	0	0	0	0	0	0	0	0	37	37	0	0	0	25	25
Кемеровская область	Частные; Заочная	Прибыло студентов - всего (сумма стр. 02-05) / 1.0	0	0	0	0	0	0	0	0	0	0	0	0	0	47	47	0	0	0	35	35
Кемеровская область	Частные; Заочная	"Численность студентов на начало прошлого учебного года
(на 1 октября) / 17.0"	0	0	0	0	0	0	0	0	0	0	0	0	0	237	237	0	0	0	118	118
Кемеровская область	Частные; Очная	            из стр. 11 - не прошли итоговую аттестацию / 12.0	0	0	0	0	0	0	0	0	0	0	0	0	0	0	0	0	0	0	0	0
Кемеровская область	Частные; Очная	"            из стр. 11 – лица с ограниченными возможностями здоровья,
            инвалиды, дети-инвалиды / 13.0"	0	0	0	0	0	0	0	0	0	0	0	0	0	0	0	0	0	0	0	0
Кемеровская область	Частные; Очная	         отчислено в виде меры дисциплинарного взыскания / 14.0	0	0	0	0	0	0	0	0	0	0	0	0	0	4	4	0	0	0	0	0
Кемеровская область	Частные; Очная	         отчислено из-за просрочки оплаты обучения / 15.0	0	0	0	0	0	0	0	0	0	0	0	0	0	4	4	0	0	0	0	0
Кемеровская область	Частные; Очная	"    в том числе:
    переведено на другие формы обучения данной
    организации на программы того же уровня / 7.0"	0	0	0	0	0	0	0	0	0	0	3	0	0	30	33	0	0	0	20	20
Кемеровская область	Частные; Очная	"    в том числе:
    переведено с других форм обучения данной
    образовательной организации с программ того же уровня / 2.0"	0	0	0	0	0	0	0	0	0	0	0	0	0	0	0	0	0	0	0	0
Кемеровская область	Частные; Очная	    восстановлены из числа ранее отчисленных / 4.0	0	0	0	0	0	0	0	0	0	0	0	0	0	4	4	0	0	0	7	7
Кемеровская область	Частные; Очная	    выбыло по другим причинам / 16.0	0	0	0	0	0	0	0	0	0	0	3	0	0	60	63	0	0	0	22	22
Кемеровская область	Частные; Очная	"    добровольно прекратили образовательные отношения
    (бросили учебу) / 10.0"	0	0	0	0	0	0	0	0	0	0	0	0	0	0	0	0	0	0	0	0
Кемеровская область	Частные; Очная	"    отчислено:
         по неуспеваемости / 11.0"	0	0	0	0	0	0	0	0	0	0	0	0	0	75	75	0	0	0	6	6
Кемеровская область	Частные; Очная	"    переведено в другие образовательные организации
    на программы того же уровня / 8.0"	0	0	0	0	0	0	0	0	0	0	0	0	0	20	20	0	0	0	3	3
Кемеровская область	Частные; Очная	"    переведено из других образовательных организаций 
    с программ того же уровня / 3.0"	0	0	0	0	0	0	0	0	0	0	0	0	0	34	34	0	0	0	43	43
Кемеровская область	Частные; Очная	    по болезни / 9.0	0	0	0	0	0	0	0	0	0	0	0	0	0	10	10	0	0	0	1	1
Кемеровская область	Частные; Очная	    прибыло по другим причинам / 5.0	0	0	0	0	0	0	0	0	0	0	0	0	0	3	3	0	0	0	26	26
Кемеровская область	Частные; Очная	Выбыло студентов - всего (сумма стр. 07-11, 13-15) / 6.0	0	0	0	0	0	0	0	0	0	0	6	0	0	203	209	0	0	0	52	52
Кемеровская область	Частные; Очная	Прибыло студентов - всего (сумма стр. 02-05) / 1.0	0	0	0	0	0	0	0	0	0	0	0	0	0	41	41	0	0	0	76	76
Кемеровская область	Частные; Очная	"Численность студентов на начало прошлого учебного года
(на 1 октября) / 17.0"	0	0	0	0	0	0	0	0	0	0	208	0	0	1450	1658	0	0	0	236	236
Кировская область	Государственные, муниципальные (без учета организаций в ведении ФСИН); Заочная	            из стр. 11 - не прошли итоговую аттестацию / 12.0	0	0	0	0	0	0	0	0	0	0	0	0	0	0	0	5	0	0	0	5
Кировская область	Государственные, муниципальные (без учета организаций в ведении ФСИН); Заочная	"            из стр. 11 – лица с ограниченными возможностями здоровья,
            инвалиды, дети-инвалиды / 13.0"	0	0	0	0	0	0	0	0	0	0	0	0	0	0	0	1	0	0	0	1
Кировская область	Государственные, муниципальные (без учета организаций в ведении ФСИН); Заочная	         отчислено в виде меры дисциплинарного взыскания / 14.0	0	0	0	0	0	0	0	0	0	0	0	0	0	0	0	0	0	0	0	0
Кировская область	Государственные, муниципальные (без учета организаций в ведении ФСИН); Заочная	         отчислено из-за просрочки оплаты обучения / 15.0	0	0	0	0	0	0	0	0	0	0	0	0	0	0	0	0	0	0	13	13
Кировская область	Государственные, муниципальные (без учета организаций в ведении ФСИН); Заочная	"    в том числе:
    переведено на другие формы обучения данной
    организации на программы того же уровня / 7.0"	0	0	0	0	0	0	0	0	0	0	0	0	0	0	0	11	0	0	4	15
Кировская область	Государственные, муниципальные (без учета организаций в ведении ФСИН); Заочная	"    в том числе:
    переведено с других форм обучения данной
    образовательной организации с программ того же уровня / 2.0"	0	0	0	0	0	0	0	0	0	0	9	0	0	20	29	77	0	0	13	90
Кировская область	Государственные, муниципальные (без учета организаций в ведении ФСИН); Заочная	    восстановлены из числа ранее отчисленных / 4.0	0	0	0	0	0	0	0	0	0	0	2	0	0	0	2	31	0	0	9	40
Кировская область	Государственные, муниципальные (без учета организаций в ведении ФСИН); Заочная	    выбыло по другим причинам / 16.0	0	0	0	0	0	0	0	0	0	0	5	0	0	1	6	146	0	0	10	156
Кировская область	Государственные, муниципальные (без учета организаций в ведении ФСИН); Заочная	"    добровольно прекратили образовательные отношения
    (бросили учебу) / 10.0"	0	0	0	0	0	0	0	0	0	0	9	0	0	8	17	343	0	13	61	417
Кировская область	Государственные, муниципальные (без учета организаций в ведении ФСИН); Заочная	"    отчислено:
         по неуспеваемости / 11.0"	0	0	0	0	0	0	0	0	0	0	1	0	0	0	1	174	0	20	26	220
Кировская область	Государственные, муниципальные (без учета организаций в ведении ФСИН); Заочная	"    переведено в другие образовательные организации
    на программы того же уровня / 8.0"	0	0	0	0	0	0	0	0	0	0	6	0	0	0	6	25	0	0	0	25
Кировская область	Государственные, муниципальные (без учета организаций в ведении ФСИН); Заочная	"    переведено из других образовательных организаций 
    с программ того же уровня / 3.0"	0	0	0	0	0	0	0	0	0	0	0	0	0	0	0	21	0	0	1	22
Кировская область	Государственные, муниципальные (без учета организаций в ведении ФСИН); Заочная	    по болезни / 9.0	0	0	0	0	0	0	0	0	0	0	0	0	0	0	0	0	0	0	0	0
Кировская область	Государственные, муниципальные (без учета организаций в ведении ФСИН); Заочная	    прибыло по другим причинам / 5.0	0	0	0	0	0	0	0	0	0	0	0	0	0	1	1	86	0	0	30	116
Кировская область	Государственные, муниципальные (без учета организаций в ведении ФСИН); Заочная	Выбыло студентов - всего (сумма стр. 07-11, 13-15) / 6.0	0	0	0	0	0	0	0	0	0	0	21	0	0	9	30	699	0	33	114	846
Кировская область	Государственные, муниципальные (без учета организаций в ведении ФСИН); Заочная	Прибыло студентов - всего (сумма стр. 02-05) / 1.0	0	0	0	0	0	0	0	0	0	0	11	0	0	21	32	215	0	0	53	268
Кировская область	Государственные, муниципальные (без учета организаций в ведении ФСИН); Заочная	"Численность студентов на начало прошлого учебного года
(на 1 октября) / 17.0"	0	0	0	0	0	0	0	0	0	0	188	0	0	17	205	3434	0	307	646	4387
Кировская область	Государственные, муниципальные (без учета организаций в ведении ФСИН); Очная	            из стр. 11 - не прошли итоговую аттестацию / 12.0	9	0	0	0	9	0	0	0	0	0	3	0	1	3	7	0	0	0	2	2
Кировская область	Государственные, муниципальные (без учета организаций в ведении ФСИН); Очная	"            из стр. 11 – лица с ограниченными возможностями здоровья,
            инвалиды, дети-инвалиды / 13.0"	0	0	0	0	0	0	0	0	0	0	1	0	0	0	1	0	0	0	0	0
Кировская область	Государственные, муниципальные (без учета организаций в ведении ФСИН); Очная	         отчислено в виде меры дисциплинарного взыскания / 14.0	2	0	0	0	2	0	0	0	0	0	4	0	0	0	4	0	0	0	0	0
Кировская область	Государственные, муниципальные (без учета организаций в ведении ФСИН); Очная	         отчислено из-за просрочки оплаты обучения / 15.0	0	0	0	0	0	0	0	0	0	0	0	0	0	11	11	0	0	0	2	2
Кировская область	Государственные, муниципальные (без учета организаций в ведении ФСИН); Очная	"    в том числе:
    переведено на другие формы обучения данной
    организации на программы того же уровня / 7.0"	6	0	0	0	6	0	0	0	0	0	134	0	1	23	158	4	0	0	1	5
Кировская область	Государственные, муниципальные (без учета организаций в ведении ФСИН); Очная	"    в том числе:
    переведено с других форм обучения данной
    образовательной организации с программ того же уровня / 2.0"	5	0	0	0	5	0	0	0	1	1	36	0	0	0	36	11	0	0	0	11
Кировская область	Государственные, муниципальные (без учета организаций в ведении ФСИН); Очная	    восстановлены из числа ранее отчисленных / 4.0	19	0	0	0	19	0	0	0	0	0	48	0	2	21	71	16	0	0	5	21
Кировская область	Государственные, муниципальные (без учета организаций в ведении ФСИН); Очная	    выбыло по другим причинам / 16.0	207	0	14	0	221	0	0	0	0	0	446	0	0	31	477	24	0	1	4	29
Кировская область	Государственные, муниципальные (без учета организаций в ведении ФСИН); Очная	"    добровольно прекратили образовательные отношения
    (бросили учебу) / 10.0"	292	0	0	0	292	13	0	0	0	13	679	0	48	164	891	100	0	15	80	195
Кировская область	Государственные, муниципальные (без учета организаций в ведении ФСИН); Очная	"    отчислено:
         по неуспеваемости / 11.0"	71	0	0	1	72	0	0	0	0	0	113	0	19	27	159	12	0	14	15	41
Кировская область	Государственные, муниципальные (без учета организаций в ведении ФСИН); Очная	"    переведено в другие образовательные организации
    на программы того же уровня / 8.0"	46	0	0	1	47	0	0	0	0	0	251	0	5	59	315	7	0	0	8	15
Кировская область	Государственные, муниципальные (без учета организаций в ведении ФСИН); Очная	"    переведено из других образовательных организаций 
    с программ того же уровня / 3.0"	15	0	0	0	15	0	0	0	0	0	95	0	1	18	114	4	0	0	0	4
Кировская область	Государственные, муниципальные (без учета организаций в ведении ФСИН); Очная	    по болезни / 9.0	0	0	0	0	0	0	0	0	0	0	5	0	0	0	5	0	0	0	0	0
Кировская область	Государственные, муниципальные (без учета организаций в ведении ФСИН); Очная	    прибыло по другим причинам / 5.0	176	0	0	3	179	0	0	0	0	0	286	0	0	10	296	17	0	0	8	25
Кировская область	Государственные, муниципальные (без учета организаций в ведении ФСИН); Очная	Выбыло студентов - всего (сумма стр. 07-11, 13-15) / 6.0	624	0	14	2	640	13	0	0	0	13	1632	0	73	315	2020	147	0	30	110	287
Кировская область	Государственные, муниципальные (без учета организаций в ведении ФСИН); Очная	Прибыло студентов - всего (сумма стр. 02-05) / 1.0	215	0	0	3	218	0	0	0	1	1	465	0	3	49	517	48	0	0	13	61
Кировская область	Государственные, муниципальные (без учета организаций в ведении ФСИН); Очная	"Численность студентов на начало прошлого учебного года
(на 1 октября) / 17.0"	3986	0	15	54	4055	46	0	0	4	50	12512	0	950	1936	15398	1023	0	258	511	1792
Кировская область	Очно-заочная; Государственные, муниципальные (без учета организаций в ведении ФСИН)	            из стр. 11 - не прошли итоговую аттестацию / 12.0	0	0	0	0	0	0	0	0	0	0	0	0	0	0	0	0	0	0	0	0
Кировская область	Очно-заочная; Государственные, муниципальные (без учета организаций в ведении ФСИН)	"            из стр. 11 – лица с ограниченными возможностями здоровья,
            инвалиды, дети-инвалиды / 13.0"	0	0	0	0	0	0	0	0	0	0	0	0	0	0	0	0	0	0	0	0
Кировская область	Очно-заочная; Государственные, муниципальные (без учета организаций в ведении ФСИН)	         отчислено в виде меры дисциплинарного взыскания / 14.0	0	0	0	0	0	0	0	0	0	0	0	0	0	0	0	0	0	0	0	0
Кировская область	Очно-заочная; Государственные, муниципальные (без учета организаций в ведении ФСИН)	         отчислено из-за просрочки оплаты обучения / 15.0	0	0	0	0	0	0	0	0	0	0	0	0	0	0	0	0	0	0	0	0
Кировская область	Очно-заочная; Государственные, муниципальные (без учета организаций в ведении ФСИН)	"    в том числе:
    переведено на другие формы обучения данной
    организации на программы того же уровня / 7.0"	0	0	0	0	0	0	0	0	0	0	0	0	0	0	0	0	0	0	0	0
Кировская область	Очно-заочная; Государственные, муниципальные (без учета организаций в ведении ФСИН)	"    в том числе:
    переведено с других форм обучения данной
    образовательной организации с программ того же уровня / 2.0"	0	0	0	0	0	0	0	0	0	0	0	0	0	0	0	0	0	0	0	0
Кировская область	Очно-заочная; Государственные, муниципальные (без учета организаций в ведении ФСИН)	    восстановлены из числа ранее отчисленных / 4.0	0	0	0	0	0	0	0	0	0	0	0	0	0	0	0	0	0	0	3	3
Кировская область	Очно-заочная; Государственные, муниципальные (без учета организаций в ведении ФСИН)	    выбыло по другим причинам / 16.0	0	0	0	0	0	0	0	0	0	0	0	0	0	0	0	0	0	0	0	0
Кировская область	Очно-заочная; Государственные, муниципальные (без учета организаций в ведении ФСИН)	"    добровольно прекратили образовательные отношения
    (бросили учебу) / 10.0"	0	0	0	0	0	0	0	0	0	0	0	0	0	0	0	0	0	0	28	28
Кировская область	Очно-заочная; Государственные, муниципальные (без учета организаций в ведении ФСИН)	"    отчислено:
         по неуспеваемости / 11.0"	0	0	0	0	0	0	0	0	0	0	0	0	0	0	0	0	0	0	8	8
Кировская область	Очно-заочная; Государственные, муниципальные (без учета организаций в ведении ФСИН)	"    переведено в другие образовательные организации
    на программы того же уровня / 8.0"	0	0	0	0	0	0	0	0	0	0	0	0	0	0	0	0	0	0	0	0
Кировская область	Очно-заочная; Государственные, муниципальные (без учета организаций в ведении ФСИН)	"    переведено из других образовательных организаций 
    с программ того же уровня / 3.0"	0	0	0	0	0	0	0	0	0	0	0	0	0	0	0	0	0	0	0	0
Кировская область	Очно-заочная; Государственные, муниципальные (без учета организаций в ведении ФСИН)	    по болезни / 9.0	0	0	0	0	0	0	0	0	0	0	0	0	0	0	0	0	0	0	0	0
Кировская область	Очно-заочная; Государственные, муниципальные (без учета организаций в ведении ФСИН)	    прибыло по другим причинам / 5.0	0	0	0	0	0	0	0	0	0	0	0	0	0	0	0	0	0	0	0	0
Кировская область	Очно-заочная; Государственные, муниципальные (без учета организаций в ведении ФСИН)	Выбыло студентов - всего (сумма стр. 07-11, 13-15) / 6.0	0	0	0	0	0	0	0	0	0	0	0	0	0	0	0	0	0	0	36	36
Кировская область	Очно-заочная; Государственные, муниципальные (без учета организаций в ведении ФСИН)	Прибыло студентов - всего (сумма стр. 02-05) / 1.0	0	0	0	0	0	0	0	0	0	0	0	0	0	0	0	0	0	0	3	3
Кировская область	Очно-заочная; Государственные, муниципальные (без учета организаций в ведении ФСИН)	"Численность студентов на начало прошлого учебного года
(на 1 октября) / 17.0"	0	0	0	0	0	0	0	0	0	0	0	0	0	0	0	15	0	0	249	264
Кировская область	Частные; Заочная	            из стр. 11 - не прошли итоговую аттестацию / 12.0	0	0	0	0	0	0	0	0	0	0	0	0	0	0	0	0	0	0	0	0
Кировская область	Частные; Заочная	"            из стр. 11 – лица с ограниченными возможностями здоровья,
            инвалиды, дети-инвалиды / 13.0"	0	0	0	0	0	0	0	0	0	0	0	0	0	0	0	0	0	0	0	0
Кировская область	Частные; Заочная	         отчислено в виде меры дисциплинарного взыскания / 14.0	0	0	0	0	0	0	0	0	0	0	0	0	0	0	0	0	0	0	0	0
Кировская область	Частные; Заочная	         отчислено из-за просрочки оплаты обучения / 15.0	0	0	0	0	0	0	0	0	0	0	0	0	0	4	4	0	0	0	1	1
Кировская область	Частные; Заочная	"    в том числе:
    переведено на другие формы обучения данной
    организации на программы того же уровня / 7.0"	0	0	0	0	0	0	0	0	0	0	0	0	0	1	1	0	0	0	1	1
Кировская область	Частные; Заочная	"    в том числе:
    переведено с других форм обучения данной
    образовательной организации с программ того же уровня / 2.0"	0	0	0	0	0	0	0	0	0	0	0	0	0	10	10	0	0	0	15	15
Кировская область	Частные; Заочная	    восстановлены из числа ранее отчисленных / 4.0	0	0	0	0	0	0	0	0	0	0	0	0	0	6	6	0	0	0	5	5
Кировская область	Частные; Заочная	    выбыло по другим причинам / 16.0	0	0	0	0	0	0	0	0	0	0	0	0	0	0	0	0	0	0	0	0
Кировская область	Частные; Заочная	"    добровольно прекратили образовательные отношения
    (бросили учебу) / 10.0"	0	0	0	0	0	0	0	0	0	0	0	0	0	18	18	0	0	0	11	11
Кировская область	Частные; Заочная	"    отчислено:
         по неуспеваемости / 11.0"	0	0	0	0	0	0	0	0	0	0	0	0	0	15	15	0	0	0	6	6
Кировская область	Частные; Заочная	"    переведено в другие образовательные организации
    на программы того же уровня / 8.0"	0	0	0	0	0	0	0	0	0	0	0	0	0	2	2	0	0	0	4	4
Кировская область	Частные; Заочная	"    переведено из других образовательных организаций 
    с программ того же уровня / 3.0"	0	0	0	0	0	0	0	0	0	0	0	0	0	1	1	0	0	0	0	0
Кировская область	Частные; Заочная	    по болезни / 9.0	0	0	0	0	0	0	0	0	0	0	0	0	0	0	0	0	0	0	0	0
Кировская область	Частные; Заочная	    прибыло по другим причинам / 5.0	0	0	0	0	0	0	0	0	0	0	0	0	0	0	0	0	0	0	6	6
Кировская область	Частные; Заочная	Выбыло студентов - всего (сумма стр. 07-11, 13-15) / 6.0	0	0	0	0	0	0	0	0	0	0	0	0	0	40	40	0	0	0	23	23
Кировская область	Частные; Заочная	Прибыло студентов - всего (сумма стр. 02-05) / 1.0	0	0	0	0	0	0	0	0	0	0	0	0	0	17	17	0	0	0	26	26
Кировская область	Частные; Заочная	"Численность студентов на начало прошлого учебного года
(на 1 октября) / 17.0"	0	0	0	0	0	0	0	0	0	0	30	0	0	150	180	0	0	0	157	157
Кировская область	Частные; Очная	            из стр. 11 - не прошли итоговую аттестацию / 12.0	0	0	0	0	0	0	0	0	0	0	0	0	0	18	18	0	0	0	3	3
Кировская область	Частные; Очная	"            из стр. 11 – лица с ограниченными возможностями здоровья,
            инвалиды, дети-инвалиды / 13.0"	0	0	0	0	0	0	0	0	0	0	0	0	0	0	0	0	0	0	0	0
Кировская область	Частные; Очная	         отчислено в виде меры дисциплинарного взыскания / 14.0	0	0	0	0	0	0	0	0	0	0	0	0	0	0	0	0	0	0	0	0
Кировская область	Частные; Очная	         отчислено из-за просрочки оплаты обучения / 15.0	0	0	0	0	0	0	0	0	0	0	0	0	0	42	42	0	0	0	17	17
Кировская область	Частные; Очная	"    в том числе:
    переведено на другие формы обучения данной
    организации на программы того же уровня / 7.0"	0	0	0	0	0	0	0	0	0	0	0	0	0	13	13	0	0	0	9	9
Кировская область	Частные; Очная	"    в том числе:
    переведено с других форм обучения данной
    образовательной организации с программ того же уровня / 2.0"	0	0	0	0	0	0	0	0	0	0	0	0	0	4	4	0	0	0	10	10
Кировская область	Частные; Очная	    восстановлены из числа ранее отчисленных / 4.0	0	0	0	0	0	0	0	0	0	0	0	0	0	46	46	0	0	0	12	12
Кировская область	Частные; Очная	    выбыло по другим причинам / 16.0	0	0	0	0	0	0	0	0	0	0	0	0	0	102	102	0	0	0	26	26
Кировская область	Частные; Очная	"    добровольно прекратили образовательные отношения
    (бросили учебу) / 10.0"	0	0	0	0	0	0	0	0	0	0	0	0	0	119	119	0	0	0	44	44
Кировская область	Частные; Очная	"    отчислено:
         по неуспеваемости / 11.0"	0	0	0	0	0	0	0	0	0	0	0	0	0	150	150	0	0	0	52	52
Кировская область	Частные; Очная	"    переведено в другие образовательные организации
    на программы того же уровня / 8.0"	0	0	0	0	0	0	0	0	0	0	0	0	0	40	40	0	0	0	6	6
Кировская область	Частные; Очная	"    переведено из других образовательных организаций 
    с программ того же уровня / 3.0"	0	0	0	0	0	0	0	0	0	0	0	0	0	116	116	0	0	0	30	30
Кировская область	Частные; Очная	    по болезни / 9.0	0	0	0	0	0	0	0	0	0	0	0	0	0	0	0	0	0	0	0	0
Кировская область	Частные; Очная	    прибыло по другим причинам / 5.0	0	0	0	0	0	0	0	0	0	0	0	0	0	104	104	0	0	0	30	30
Кировская область	Частные; Очная	Выбыло студентов - всего (сумма стр. 07-11, 13-15) / 6.0	0	0	0	0	0	0	0	0	0	0	0	0	0	466	466	0	0	0	154	154
Кировская область	Частные; Очная	Прибыло студентов - всего (сумма стр. 02-05) / 1.0	0	0	0	0	0	0	0	0	0	0	0	0	0	270	270	0	0	0	82	82
Кировская область	Частные; Очная	"Численность студентов на начало прошлого учебного года
(на 1 октября) / 17.0"	0	0	0	0	0	0	0	0	0	0	0	0	0	3915	3915	0	0	0	909	909
Костромская область	Государственные, муниципальные (без учета организаций в ведении ФСИН); Заочная	            из стр. 11 - не прошли итоговую аттестацию / 12.0	0	0	0	0	0	0	0	0	0	0	0	0	0	0	0	16	0	0	0	16
Костромская область	Государственные, муниципальные (без учета организаций в ведении ФСИН); Заочная	"            из стр. 11 – лица с ограниченными возможностями здоровья,
            инвалиды, дети-инвалиды / 13.0"	0	0	0	0	0	0	0	0	0	0	0	0	0	0	0	0	0	0	0	0
Костромская область	Государственные, муниципальные (без учета организаций в ведении ФСИН); Заочная	         отчислено в виде меры дисциплинарного взыскания / 14.0	0	0	0	0	0	0	0	0	0	0	0	0	0	0	0	0	0	0	0	0
Костромская область	Государственные, муниципальные (без учета организаций в ведении ФСИН); Заочная	         отчислено из-за просрочки оплаты обучения / 15.0	0	0	0	0	0	0	0	0	0	0	0	0	0	0	0	0	0	0	0	0
Костромская область	Государственные, муниципальные (без учета организаций в ведении ФСИН); Заочная	"    в том числе:
    переведено на другие формы обучения данной
    организации на программы того же уровня / 7.0"	0	0	0	0	0	0	0	0	0	0	0	0	0	0	0	4	0	0	4	8
Костромская область	Государственные, муниципальные (без учета организаций в ведении ФСИН); Заочная	"    в том числе:
    переведено с других форм обучения данной
    образовательной организации с программ того же уровня / 2.0"	0	0	0	0	0	0	0	0	0	0	3	0	0	0	3	10	0	0	1	11
Костромская область	Государственные, муниципальные (без учета организаций в ведении ФСИН); Заочная	    восстановлены из числа ранее отчисленных / 4.0	0	0	0	0	0	0	0	0	0	0	0	0	0	0	0	6	0	0	0	6
Костромская область	Государственные, муниципальные (без учета организаций в ведении ФСИН); Заочная	    выбыло по другим причинам / 16.0	0	0	0	0	0	0	0	0	0	0	0	0	0	0	0	50	0	0	2	52
Костромская область	Государственные, муниципальные (без учета организаций в ведении ФСИН); Заочная	"    добровольно прекратили образовательные отношения
    (бросили учебу) / 10.0"	0	0	0	0	0	0	0	0	0	0	2	0	0	0	2	73	0	0	1	74
Костромская область	Государственные, муниципальные (без учета организаций в ведении ФСИН); Заочная	"    отчислено:
         по неуспеваемости / 11.0"	0	0	0	0	0	0	0	0	0	0	0	0	0	0	0	56	0	0	0	56
Костромская область	Государственные, муниципальные (без учета организаций в ведении ФСИН); Заочная	"    переведено в другие образовательные организации
    на программы того же уровня / 8.0"	0	0	0	0	0	0	0	0	0	0	0	0	0	0	0	0	0	0	0	0
Костромская область	Государственные, муниципальные (без учета организаций в ведении ФСИН); Заочная	"    переведено из других образовательных организаций 
    с программ того же уровня / 3.0"	0	0	0	0	0	0	0	0	0	0	1	0	0	0	1	3	0	0	0	3
Костромская область	Государственные, муниципальные (без учета организаций в ведении ФСИН); Заочная	    по болезни / 9.0	0	0	0	0	0	0	0	0	0	0	0	0	0	0	0	1	0	0	0	1
Костромская область	Государственные, муниципальные (без учета организаций в ведении ФСИН); Заочная	    прибыло по другим причинам / 5.0	0	0	0	0	0	0	0	0	0	0	0	0	0	0	0	20	0	0	0	20
Костромская область	Государственные, муниципальные (без учета организаций в ведении ФСИН); Заочная	Выбыло студентов - всего (сумма стр. 07-11, 13-15) / 6.0	0	0	0	0	0	0	0	0	0	0	2	0	0	0	2	184	0	0	7	191
Костромская область	Государственные, муниципальные (без учета организаций в ведении ФСИН); Заочная	Прибыло студентов - всего (сумма стр. 02-05) / 1.0	0	0	0	0	0	0	0	0	0	0	4	0	0	0	4	39	0	0	1	40
Костромская область	Государственные, муниципальные (без учета организаций в ведении ФСИН); Заочная	"Численность студентов на начало прошлого учебного года
(на 1 октября) / 17.0"	0	0	0	0	0	0	0	0	0	0	84	0	0	0	84	1270	0	44	207	1521
Костромская область	Государственные, муниципальные (без учета организаций в ведении ФСИН); Очная	            из стр. 11 - не прошли итоговую аттестацию / 12.0	8	0	0	0	8	0	0	0	0	0	7	0	0	1	8	0	0	0	0	0
Костромская область	Государственные, муниципальные (без учета организаций в ведении ФСИН); Очная	"            из стр. 11 – лица с ограниченными возможностями здоровья,
            инвалиды, дети-инвалиды / 13.0"	0	0	0	0	0	0	0	0	0	0	1	0	0	0	1	0	0	0	0	0
Костромская область	Государственные, муниципальные (без учета организаций в ведении ФСИН); Очная	         отчислено в виде меры дисциплинарного взыскания / 14.0	2	0	0	0	2	0	0	0	0	0	3	0	0	0	3	0	0	0	0	0
Костромская область	Государственные, муниципальные (без учета организаций в ведении ФСИН); Очная	         отчислено из-за просрочки оплаты обучения / 15.0	0	0	0	0	0	0	0	0	0	0	0	0	0	0	0	0	0	0	0	0
Костромская область	Государственные, муниципальные (без учета организаций в ведении ФСИН); Очная	"    в том числе:
    переведено на другие формы обучения данной
    организации на программы того же уровня / 7.0"	20	0	0	0	20	5	0	0	0	5	22	0	0	2	24	8	0	0	1	9
Костромская область	Государственные, муниципальные (без учета организаций в ведении ФСИН); Очная	"    в том числе:
    переведено с других форм обучения данной
    образовательной организации с программ того же уровня / 2.0"	18	0	0	0	18	0	0	0	0	0	15	0	0	1	16	3	0	0	0	3
Костромская область	Государственные, муниципальные (без учета организаций в ведении ФСИН); Очная	    восстановлены из числа ранее отчисленных / 4.0	17	0	0	0	17	0	0	0	0	0	33	0	3	30	66	2	0	0	4	6
Костромская область	Государственные, муниципальные (без учета организаций в ведении ФСИН); Очная	    выбыло по другим причинам / 16.0	63	0	0	0	63	0	0	0	0	0	106	0	4	25	135	11	0	0	0	11
Костромская область	Государственные, муниципальные (без учета организаций в ведении ФСИН); Очная	"    добровольно прекратили образовательные отношения
    (бросили учебу) / 10.0"	154	0	0	1	155	5	0	0	0	5	310	0	27	85	422	72	0	0	12	84
Костромская область	Государственные, муниципальные (без учета организаций в ведении ФСИН); Очная	"    отчислено:
         по неуспеваемости / 11.0"	134	1	0	2	137	0	0	0	0	0	134	0	2	16	152	6	0	0	0	6
Костромская область	Государственные, муниципальные (без учета организаций в ведении ФСИН); Очная	"    переведено в другие образовательные организации
    на программы того же уровня / 8.0"	27	0	0	0	27	0	0	0	0	0	148	0	3	4	155	15	0	0	3	18
Костромская область	Государственные, муниципальные (без учета организаций в ведении ФСИН); Очная	"    переведено из других образовательных организаций 
    с программ того же уровня / 3.0"	16	0	0	0	16	0	0	0	0	0	50	0	1	15	66	4	0	0	2	6
Костромская область	Государственные, муниципальные (без учета организаций в ведении ФСИН); Очная	    по болезни / 9.0	5	0	0	0	5	0	0	0	0	0	5	0	0	0	5	0	0	0	0	0
Костромская область	Государственные, муниципальные (без учета организаций в ведении ФСИН); Очная	    прибыло по другим причинам / 5.0	40	0	0	0	40	0	0	0	0	0	100	0	0	9	109	17	0	0	2	19
Костромская область	Государственные, муниципальные (без учета организаций в ведении ФСИН); Очная	Выбыло студентов - всего (сумма стр. 07-11, 13-15) / 6.0	405	1	0	3	409	10	0	0	0	10	728	0	36	132	896	112	0	0	16	128
Костромская область	Государственные, муниципальные (без учета организаций в ведении ФСИН); Очная	Прибыло студентов - всего (сумма стр. 02-05) / 1.0	91	0	0	0	91	0	0	0	0	0	198	0	4	55	257	26	0	0	8	34
Костромская область	Государственные, муниципальные (без учета организаций в ведении ФСИН); Очная	"Численность студентов на начало прошлого учебного года
(на 1 октября) / 17.0"	3023	0	74	25	3122	46	0	0	0	46	7378	0	432	1520	9330	816	0	0	172	988
Костромская область	Очно-заочная; Государственные, муниципальные (без учета организаций в ведении ФСИН)	            из стр. 11 - не прошли итоговую аттестацию / 12.0	0	0	0	0	0	0	0	0	0	0	0	0	0	0	0	0	0	0	0	0
Костромская область	Очно-заочная; Государственные, муниципальные (без учета организаций в ведении ФСИН)	"            из стр. 11 – лица с ограниченными возможностями здоровья,
            инвалиды, дети-инвалиды / 13.0"	0	0	0	0	0	0	0	0	0	0	0	0	0	0	0	0	0	0	0	0
Костромская область	Очно-заочная; Государственные, муниципальные (без учета организаций в ведении ФСИН)	         отчислено в виде меры дисциплинарного взыскания / 14.0	0	0	0	0	0	0	0	0	0	0	0	0	0	0	0	0	0	0	0	0
Костромская область	Очно-заочная; Государственные, муниципальные (без учета организаций в ведении ФСИН)	         отчислено из-за просрочки оплаты обучения / 15.0	0	0	0	0	0	0	0	0	0	0	0	0	0	0	0	0	0	0	0	0
Костромская область	Очно-заочная; Государственные, муниципальные (без учета организаций в ведении ФСИН)	"    в том числе:
    переведено на другие формы обучения данной
    организации на программы того же уровня / 7.0"	0	0	0	0	0	0	0	0	0	0	0	0	0	0	0	0	0	0	0	0
Костромская область	Очно-заочная; Государственные, муниципальные (без учета организаций в ведении ФСИН)	"    в том числе:
    переведено с других форм обучения данной
    образовательной организации с программ того же уровня / 2.0"	0	0	0	0	0	0	0	0	0	0	0	0	0	0	0	1	0	0	0	1
Костромская область	Очно-заочная; Государственные, муниципальные (без учета организаций в ведении ФСИН)	    восстановлены из числа ранее отчисленных / 4.0	0	0	0	0	0	0	0	0	0	0	0	0	0	0	0	0	0	0	0	0
Костромская область	Очно-заочная; Государственные, муниципальные (без учета организаций в ведении ФСИН)	    выбыло по другим причинам / 16.0	0	0	0	0	0	0	0	0	0	0	0	0	0	0	0	0	0	0	15	15
Костромская область	Очно-заочная; Государственные, муниципальные (без учета организаций в ведении ФСИН)	"    добровольно прекратили образовательные отношения
    (бросили учебу) / 10.0"	0	0	0	0	0	3	0	0	3	6	0	0	0	0	0	2	0	0	11	13
Костромская область	Очно-заочная; Государственные, муниципальные (без учета организаций в ведении ФСИН)	"    отчислено:
         по неуспеваемости / 11.0"	0	0	0	0	0	0	0	0	0	0	0	0	0	0	0	1	0	0	0	1
Костромская область	Очно-заочная; Государственные, муниципальные (без учета организаций в ведении ФСИН)	"    переведено в другие образовательные организации
    на программы того же уровня / 8.0"	0	0	0	0	0	0	0	0	0	0	0	0	0	0	0	1	0	0	0	1
Костромская область	Очно-заочная; Государственные, муниципальные (без учета организаций в ведении ФСИН)	"    переведено из других образовательных организаций 
    с программ того же уровня / 3.0"	0	0	0	0	0	0	0	0	0	0	0	0	0	0	0	0	0	0	0	0
Костромская область	Очно-заочная; Государственные, муниципальные (без учета организаций в ведении ФСИН)	    по болезни / 9.0	0	0	0	0	0	0	0	0	0	0	0	0	0	0	0	0	0	0	0	0
Костромская область	Очно-заочная; Государственные, муниципальные (без учета организаций в ведении ФСИН)	    прибыло по другим причинам / 5.0	0	0	0	0	0	0	0	0	0	0	0	0	0	0	0	0	0	0	9	9
Костромская область	Очно-заочная; Государственные, муниципальные (без учета организаций в ведении ФСИН)	Выбыло студентов - всего (сумма стр. 07-11, 13-15) / 6.0	0	0	0	0	0	3	0	0	3	6	0	0	0	0	0	4	0	0	26	30
Костромская область	Очно-заочная; Государственные, муниципальные (без учета организаций в ведении ФСИН)	Прибыло студентов - всего (сумма стр. 02-05) / 1.0	0	0	0	0	0	0	0	0	0	0	0	0	0	0	0	1	0	0	9	10
Костромская область	Очно-заочная; Государственные, муниципальные (без учета организаций в ведении ФСИН)	"Численность студентов на начало прошлого учебного года
(на 1 октября) / 17.0"	0	0	0	0	0	16	0	0	2	18	0	0	0	0	0	24	0	0	87	111
Костромская область	Частные; Заочная	            из стр. 11 - не прошли итоговую аттестацию / 12.0	0	0	0	0	0	0	0	0	0	0	0	0	0	0	0	0	0	0	0	0
Костромская область	Частные; Заочная	"            из стр. 11 – лица с ограниченными возможностями здоровья,
            инвалиды, дети-инвалиды / 13.0"	0	0	0	0	0	0	0	0	0	0	0	0	0	0	0	0	0	0	0	0
Костромская область	Частные; Заочная	         отчислено в виде меры дисциплинарного взыскания / 14.0	0	0	0	0	0	0	0	0	0	0	0	0	0	0	0	0	0	0	0	0
Костромская область	Частные; Заочная	         отчислено из-за просрочки оплаты обучения / 15.0	0	0	0	0	0	0	0	0	0	0	0	0	0	0	0	0	0	0	0	0
Костромская область	Частные; Заочная	"    в том числе:
    переведено на другие формы обучения данной
    организации на программы того же уровня / 7.0"	0	0	0	0	0	0	0	0	0	0	0	0	0	0	0	0	0	0	0	0
Костромская область	Частные; Заочная	"    в том числе:
    переведено с других форм обучения данной
    образовательной организации с программ того же уровня / 2.0"	0	0	0	0	0	0	0	0	0	0	0	0	0	0	0	0	0	0	1	1
Костромская область	Частные; Заочная	    восстановлены из числа ранее отчисленных / 4.0	0	0	0	0	0	0	0	0	0	0	0	0	0	0	0	0	0	0	0	0
Костромская область	Частные; Заочная	    выбыло по другим причинам / 16.0	0	0	0	0	0	0	0	0	0	0	0	0	0	0	0	0	0	0	0	0
Костромская область	Частные; Заочная	"    добровольно прекратили образовательные отношения
    (бросили учебу) / 10.0"	0	0	0	0	0	0	0	0	0	0	0	0	0	0	0	0	0	0	5	5
Костромская область	Частные; Заочная	"    отчислено:
         по неуспеваемости / 11.0"	0	0	0	0	0	0	0	0	0	0	0	0	0	0	0	0	0	0	2	2
Костромская область	Частные; Заочная	"    переведено в другие образовательные организации
    на программы того же уровня / 8.0"	0	0	0	0	0	0	0	0	0	0	0	0	0	0	0	0	0	0	0	0
Костромская область	Частные; Заочная	"    переведено из других образовательных организаций 
    с программ того же уровня / 3.0"	0	0	0	0	0	0	0	0	0	0	0	0	0	0	0	0	0	0	0	0
Костромская область	Частные; Заочная	    по болезни / 9.0	0	0	0	0	0	0	0	0	0	0	0	0	0	0	0	0	0	0	0	0
Костромская область	Частные; Заочная	    прибыло по другим причинам / 5.0	0	0	0	0	0	0	0	0	0	0	0	0	0	0	0	0	0	0	0	0
Костромская область	Частные; Заочная	Выбыло студентов - всего (сумма стр. 07-11, 13-15) / 6.0	0	0	0	0	0	0	0	0	0	0	0	0	0	0	0	0	0	0	7	7
Костромская область	Частные; Заочная	Прибыло студентов - всего (сумма стр. 02-05) / 1.0	0	0	0	0	0	0	0	0	0	0	0	0	0	0	0	0	0	0	1	1
Костромская область	Частные; Заочная	"Численность студентов на начало прошлого учебного года
(на 1 октября) / 17.0"	0	0	0	0	0	0	0	0	0	0	0	0	0	0	0	0	0	0	23	23
Костромская область	Частные; Очная	            из стр. 11 - не прошли итоговую аттестацию / 12.0	0	0	0	0	0	0	0	0	0	0	0	0	0	0	0	0	0	0	0	0
Костромская область	Частные; Очная	"            из стр. 11 – лица с ограниченными возможностями здоровья,
            инвалиды, дети-инвалиды / 13.0"	0	0	0	0	0	0	0	0	0	0	0	0	0	0	0	0	0	0	0	0
Костромская область	Частные; Очная	         отчислено в виде меры дисциплинарного взыскания / 14.0	0	0	0	0	0	0	0	0	0	0	0	0	0	1	1	0	0	0	0	0
Костромская область	Частные; Очная	         отчислено из-за просрочки оплаты обучения / 15.0	0	0	0	0	0	0	0	0	0	0	0	0	0	0	0	0	0	0	0	0
Костромская область	Частные; Очная	"    в том числе:
    переведено на другие формы обучения данной
    организации на программы того же уровня / 7.0"	0	0	0	0	0	0	0	0	0	0	0	0	0	1	1	0	0	0	0	0
Костромская область	Частные; Очная	"    в том числе:
    переведено с других форм обучения данной
    образовательной организации с программ того же уровня / 2.0"	0	0	0	0	0	0	0	0	0	0	0	0	0	0	0	0	0	0	0	0
Костромская область	Частные; Очная	    восстановлены из числа ранее отчисленных / 4.0	0	0	0	0	0	0	0	0	0	0	0	0	0	22	22	0	0	0	10	10
Костромская область	Частные; Очная	    выбыло по другим причинам / 16.0	0	0	0	0	0	0	0	0	0	0	0	0	0	0	0	0	0	0	0	0
Костромская область	Частные; Очная	"    добровольно прекратили образовательные отношения
    (бросили учебу) / 10.0"	0	0	0	0	0	0	0	0	0	0	2	0	0	18	20	1	0	0	10	11
Костромская область	Частные; Очная	"    отчислено:
         по неуспеваемости / 11.0"	0	0	0	0	0	0	0	0	0	0	0	0	0	14	14	0	0	0	2	2
Костромская область	Частные; Очная	"    переведено в другие образовательные организации
    на программы того же уровня / 8.0"	0	0	0	0	0	0	0	0	0	0	0	0	0	1	1	0	0	0	1	1
Костромская область	Частные; Очная	"    переведено из других образовательных организаций 
    с программ того же уровня / 3.0"	0	0	0	0	0	0	0	0	0	0	0	0	0	1	1	0	0	0	3	3
Костромская область	Частные; Очная	    по болезни / 9.0	0	0	0	0	0	0	0	0	0	0	2	0	0	0	2	1	0	0	0	1
Костромская область	Частные; Очная	    прибыло по другим причинам / 5.0	0	0	0	0	0	0	0	0	0	0	0	0	0	0	0	0	0	0	0	0
Костромская область	Частные; Очная	Выбыло студентов - всего (сумма стр. 07-11, 13-15) / 6.0	0	0	0	0	0	0	0	0	0	0	4	0	0	35	39	2	0	0	13	15
Костромская область	Частные; Очная	Прибыло студентов - всего (сумма стр. 02-05) / 1.0	0	0	0	0	0	0	0	0	0	0	0	0	0	23	23	0	0	0	13	13
Костромская область	Частные; Очная	"Численность студентов на начало прошлого учебного года
(на 1 октября) / 17.0"	0	0	0	0	0	0	0	0	0	0	190	0	0	245	435	34	0	0	35	69
Краснодарский край	Государственные, муниципальные (без учета организаций в ведении ФСИН); Заочная	            из стр. 11 - не прошли итоговую аттестацию / 12.0	0	0	0	0	0	0	0	0	0	0	0	0	0	1	1	0	0	0	0	0
Краснодарский край	Государственные, муниципальные (без учета организаций в ведении ФСИН); Заочная	"            из стр. 11 – лица с ограниченными возможностями здоровья,
            инвалиды, дети-инвалиды / 13.0"	0	0	0	0	0	0	0	0	0	0	0	0	0	0	0	0	0	0	0	0
Краснодарский край	Государственные, муниципальные (без учета организаций в ведении ФСИН); Заочная	         отчислено в виде меры дисциплинарного взыскания / 14.0	0	0	0	0	0	0	0	0	0	0	1	0	0	0	1	1	9	15	0	25
Краснодарский край	Государственные, муниципальные (без учета организаций в ведении ФСИН); Заочная	         отчислено из-за просрочки оплаты обучения / 15.0	0	0	0	0	0	0	0	0	0	0	0	0	0	4	4	0	0	0	24	24
Краснодарский край	Государственные, муниципальные (без учета организаций в ведении ФСИН); Заочная	"    в том числе:
    переведено на другие формы обучения данной
    организации на программы того же уровня / 7.0"	0	0	0	0	0	0	0	0	0	0	1	0	0	31	32	3	0	2	23	28
Краснодарский край	Государственные, муниципальные (без учета организаций в ведении ФСИН); Заочная	"    в том числе:
    переведено с других форм обучения данной
    образовательной организации с программ того же уровня / 2.0"	0	0	0	0	0	0	0	0	0	0	10	0	0	31	41	23	0	11	89	123
Краснодарский край	Государственные, муниципальные (без учета организаций в ведении ФСИН); Заочная	    восстановлены из числа ранее отчисленных / 4.0	0	0	0	0	0	0	0	0	0	0	2	0	0	6	8	28	0	3	43	74
Краснодарский край	Государственные, муниципальные (без учета организаций в ведении ФСИН); Заочная	    выбыло по другим причинам / 16.0	0	0	0	0	0	0	0	0	0	0	0	0	0	1	1	44	7	21	59	131
Краснодарский край	Государственные, муниципальные (без учета организаций в ведении ФСИН); Заочная	"    добровольно прекратили образовательные отношения
    (бросили учебу) / 10.0"	0	0	0	0	0	0	0	0	0	0	35	0	0	8	43	202	11	14	89	316
Краснодарский край	Государственные, муниципальные (без учета организаций в ведении ФСИН); Заочная	"    отчислено:
         по неуспеваемости / 11.0"	0	0	0	0	0	0	0	0	0	0	0	0	0	7	7	113	4	13	141	271
Краснодарский край	Государственные, муниципальные (без учета организаций в ведении ФСИН); Заочная	"    переведено в другие образовательные организации
    на программы того же уровня / 8.0"	0	0	0	0	0	0	0	0	0	0	1	0	0	1	2	2	0	3	14	19
Краснодарский край	Государственные, муниципальные (без учета организаций в ведении ФСИН); Заочная	"    переведено из других образовательных организаций 
    с программ того же уровня / 3.0"	0	0	0	0	0	0	0	0	0	0	2	0	0	4	6	15	0	1	8	24
Краснодарский край	Государственные, муниципальные (без учета организаций в ведении ФСИН); Заочная	    по болезни / 9.0	0	0	0	0	0	0	0	0	0	0	0	0	0	0	0	0	0	0	0	0
Краснодарский край	Государственные, муниципальные (без учета организаций в ведении ФСИН); Заочная	    прибыло по другим причинам / 5.0	0	0	0	0	0	0	0	0	0	0	0	0	0	61	61	74	0	4	34	112
Краснодарский край	Государственные, муниципальные (без учета организаций в ведении ФСИН); Заочная	Выбыло студентов - всего (сумма стр. 07-11, 13-15) / 6.0	0	0	0	0	0	0	0	0	0	0	38	0	0	52	90	365	31	68	350	814
Краснодарский край	Государственные, муниципальные (без учета организаций в ведении ФСИН); Заочная	Прибыло студентов - всего (сумма стр. 02-05) / 1.0	0	0	0	0	0	0	0	0	0	0	14	0	0	102	116	140	0	19	174	333
Краснодарский край	Государственные, муниципальные (без учета организаций в ведении ФСИН); Заочная	"Численность студентов на начало прошлого учебного года
(на 1 октября) / 17.0"	0	0	0	0	0	0	0	0	0	0	307	0	5	519	831	4101	76	304	1398	5879
Краснодарский край	Государственные, муниципальные (без учета организаций в ведении ФСИН); Очная	            из стр. 11 - не прошли итоговую аттестацию / 12.0	13	0	0	2	15	0	0	0	0	0	6	0	1	5	12	1	0	0	0	1
Краснодарский край	Государственные, муниципальные (без учета организаций в ведении ФСИН); Очная	"            из стр. 11 – лица с ограниченными возможностями здоровья,
            инвалиды, дети-инвалиды / 13.0"	0	0	0	0	0	0	0	0	0	0	1	0	0	0	1	0	0	0	0	0
Краснодарский край	Государственные, муниципальные (без учета организаций в ведении ФСИН); Очная	         отчислено в виде меры дисциплинарного взыскания / 14.0	5	0	0	0	5	0	0	0	0	0	3	0	0	19	22	0	0	0	0	0
Краснодарский край	Государственные, муниципальные (без учета организаций в ведении ФСИН); Очная	         отчислено из-за просрочки оплаты обучения / 15.0	0	0	0	7	7	0	0	0	0	0	0	0	0	175	175	0	0	0	22	22
Краснодарский край	Государственные, муниципальные (без учета организаций в ведении ФСИН); Очная	"    в том числе:
    переведено на другие формы обучения данной
    организации на программы того же уровня / 7.0"	38	0	0	4	42	0	0	0	0	0	73	0	51	232	356	19	0	0	5	24
Краснодарский край	Государственные, муниципальные (без учета организаций в ведении ФСИН); Очная	"    в том числе:
    переведено с других форм обучения данной
    образовательной организации с программ того же уровня / 2.0"	54	0	0	0	54	0	0	0	0	0	88	0	52	118	258	4	0	0	2	6
Краснодарский край	Государственные, муниципальные (без учета организаций в ведении ФСИН); Очная	    восстановлены из числа ранее отчисленных / 4.0	83	0	0	5	88	0	0	0	0	0	115	0	4	223	342	17	0	0	17	34
Краснодарский край	Государственные, муниципальные (без учета организаций в ведении ФСИН); Очная	    выбыло по другим причинам / 16.0	308	0	0	8	316	0	0	0	0	0	399	0	30	400	829	43	0	0	30	73
Краснодарский край	Государственные, муниципальные (без учета организаций в ведении ФСИН); Очная	"    добровольно прекратили образовательные отношения
    (бросили учебу) / 10.0"	891	0	0	43	934	16	0	0	0	16	1194	0	119	1241	2554	186	0	4	129	319
Краснодарский край	Государственные, муниципальные (без учета организаций в ведении ФСИН); Очная	"    отчислено:
         по неуспеваемости / 11.0"	217	0	0	31	248	0	0	0	1	1	208	0	22	324	554	39	0	13	44	96
Краснодарский край	Государственные, муниципальные (без учета организаций в ведении ФСИН); Очная	"    переведено в другие образовательные организации
    на программы того же уровня / 8.0"	286	0	0	9	295	6	0	0	0	6	647	0	36	720	1403	29	0	0	56	85
Краснодарский край	Государственные, муниципальные (без учета организаций в ведении ФСИН); Очная	"    переведено из других образовательных организаций 
    с программ того же уровня / 3.0"	262	0	0	13	275	0	0	0	0	0	372	0	18	488	878	28	0	0	39	67
Краснодарский край	Государственные, муниципальные (без учета организаций в ведении ФСИН); Очная	    по болезни / 9.0	21	0	0	0	21	0	0	0	0	0	3	0	0	6	9	0	0	0	0	0
Краснодарский край	Государственные, муниципальные (без учета организаций в ведении ФСИН); Очная	    прибыло по другим причинам / 5.0	125	0	0	9	134	1	0	0	0	1	237	0	33	137	407	14	0	2	22	38
Краснодарский край	Государственные, муниципальные (без учета организаций в ведении ФСИН); Очная	Выбыло студентов - всего (сумма стр. 07-11, 13-15) / 6.0	1766	0	0	102	1868	22	0	0	1	23	2527	0	258	3117	5902	316	0	17	286	619
Краснодарский край	Государственные, муниципальные (без учета организаций в ведении ФСИН); Очная	Прибыло студентов - всего (сумма стр. 02-05) / 1.0	524	0	0	27	551	1	0	0	0	1	812	0	107	966	1885	63	0	2	80	145
Краснодарский край	Государственные, муниципальные (без учета организаций в ведении ФСИН); Очная	"Численность студентов на начало прошлого учебного года
(на 1 октября) / 17.0"	21151	97	284	1695	23227	251	0	0	16	267	41002	0	4903	32945	78850	2912	0	168	2806	5886
Краснодарский край	Очно-заочная; Государственные, муниципальные (без учета организаций в ведении ФСИН)	            из стр. 11 - не прошли итоговую аттестацию / 12.0	0	0	0	0	0	0	0	0	0	0	0	0	0	0	0	0	0	0	0	0
Краснодарский край	Очно-заочная; Государственные, муниципальные (без учета организаций в ведении ФСИН)	"            из стр. 11 – лица с ограниченными возможностями здоровья,
            инвалиды, дети-инвалиды / 13.0"	0	0	0	0	0	0	0	0	0	0	0	0	0	0	0	0	0	0	0	0
Краснодарский край	Очно-заочная; Государственные, муниципальные (без учета организаций в ведении ФСИН)	         отчислено в виде меры дисциплинарного взыскания / 14.0	0	0	0	0	0	0	0	0	0	0	0	0	0	0	0	0	0	0	1	1
Краснодарский край	Очно-заочная; Государственные, муниципальные (без учета организаций в ведении ФСИН)	         отчислено из-за просрочки оплаты обучения / 15.0	0	0	0	0	0	0	0	0	0	0	0	0	0	0	0	0	0	0	0	0
Краснодарский край	Очно-заочная; Государственные, муниципальные (без учета организаций в ведении ФСИН)	"    в том числе:
    переведено на другие формы обучения данной
    организации на программы того же уровня / 7.0"	0	0	0	0	0	0	0	0	0	0	0	0	0	0	0	0	0	0	13	13
Краснодарский край	Очно-заочная; Государственные, муниципальные (без учета организаций в ведении ФСИН)	"    в том числе:
    переведено с других форм обучения данной
    образовательной организации с программ того же уровня / 2.0"	0	0	0	0	0	0	0	0	0	0	0	0	0	1	1	16	0	0	7	23
Краснодарский край	Очно-заочная; Государственные, муниципальные (без учета организаций в ведении ФСИН)	    восстановлены из числа ранее отчисленных / 4.0	0	0	0	0	0	0	0	0	0	0	0	0	0	0	0	2	0	0	6	8
Краснодарский край	Очно-заочная; Государственные, муниципальные (без учета организаций в ведении ФСИН)	    выбыло по другим причинам / 16.0	0	0	0	0	0	0	0	0	0	0	0	0	0	0	0	7	0	0	15	22
Краснодарский край	Очно-заочная; Государственные, муниципальные (без учета организаций в ведении ФСИН)	"    добровольно прекратили образовательные отношения
    (бросили учебу) / 10.0"	0	0	0	0	0	0	0	0	0	0	0	0	0	0	0	22	0	0	69	91
Краснодарский край	Очно-заочная; Государственные, муниципальные (без учета организаций в ведении ФСИН)	"    отчислено:
         по неуспеваемости / 11.0"	0	0	0	0	0	0	0	0	0	0	0	0	0	0	0	10	0	0	9	19
Краснодарский край	Очно-заочная; Государственные, муниципальные (без учета организаций в ведении ФСИН)	"    переведено в другие образовательные организации
    на программы того же уровня / 8.0"	0	0	0	0	0	0	0	0	0	0	0	0	0	0	0	2	0	0	16	18
Краснодарский край	Очно-заочная; Государственные, муниципальные (без учета организаций в ведении ФСИН)	"    переведено из других образовательных организаций 
    с программ того же уровня / 3.0"	0	0	0	0	0	0	0	0	0	0	0	0	0	0	0	6	0	0	18	24
Краснодарский край	Очно-заочная; Государственные, муниципальные (без учета организаций в ведении ФСИН)	    по болезни / 9.0	0	0	0	0	0	0	0	0	0	0	0	0	0	0	0	0	0	0	0	0
Краснодарский край	Очно-заочная; Государственные, муниципальные (без учета организаций в ведении ФСИН)	    прибыло по другим причинам / 5.0	0	0	0	0	0	0	0	0	0	0	0	0	0	0	0	11	0	0	0	11
Краснодарский край	Очно-заочная; Государственные, муниципальные (без учета организаций в ведении ФСИН)	Выбыло студентов - всего (сумма стр. 07-11, 13-15) / 6.0	0	0	0	0	0	0	0	0	0	0	0	0	0	0	0	41	0	0	123	164
Краснодарский край	Очно-заочная; Государственные, муниципальные (без учета организаций в ведении ФСИН)	Прибыло студентов - всего (сумма стр. 02-05) / 1.0	0	0	0	0	0	0	0	0	0	0	0	0	0	1	1	35	0	0	31	66
Краснодарский край	Очно-заочная; Государственные, муниципальные (без учета организаций в ведении ФСИН)	"Численность студентов на начало прошлого учебного года
(на 1 октября) / 17.0"	0	0	0	0	0	0	0	0	0	0	0	0	0	0	0	542	0	0	1006	1548
Краснодарский край	Частные; Заочная	            из стр. 11 - не прошли итоговую аттестацию / 12.0	0	0	0	0	0	0	0	0	0	0	0	0	0	1	1	0	0	0	1	1
Краснодарский край	Частные; Заочная	"            из стр. 11 – лица с ограниченными возможностями здоровья,
            инвалиды, дети-инвалиды / 13.0"	0	0	0	0	0	0	0	0	0	0	0	0	0	0	0	0	0	0	0	0
Краснодарский край	Частные; Заочная	         отчислено в виде меры дисциплинарного взыскания / 14.0	0	0	0	0	0	0	0	0	0	0	0	0	0	0	0	0	0	0	0	0
Краснодарский край	Частные; Заочная	         отчислено из-за просрочки оплаты обучения / 15.0	0	0	0	0	0	0	0	0	0	0	0	0	0	35	35	0	0	0	29	29
Краснодарский край	Частные; Заочная	"    в том числе:
    переведено на другие формы обучения данной
    организации на программы того же уровня / 7.0"	0	0	0	0	0	0	0	0	0	0	0	0	0	44	44	0	0	0	19	19
Краснодарский край	Частные; Заочная	"    в том числе:
    переведено с других форм обучения данной
    образовательной организации с программ того же уровня / 2.0"	0	0	0	0	0	0	0	0	0	0	0	0	0	139	139	0	0	0	87	87
Краснодарский край	Частные; Заочная	    восстановлены из числа ранее отчисленных / 4.0	0	0	0	0	0	0	0	0	0	0	0	0	0	38	38	0	0	0	5	5
Краснодарский край	Частные; Заочная	    выбыло по другим причинам / 16.0	0	0	0	0	0	0	0	0	0	0	0	0	0	12	12	0	0	0	11	11
Краснодарский край	Частные; Заочная	"    добровольно прекратили образовательные отношения
    (бросили учебу) / 10.0"	0	0	0	0	0	0	0	0	0	0	0	0	0	68	68	0	0	0	32	32
Краснодарский край	Частные; Заочная	"    отчислено:
         по неуспеваемости / 11.0"	0	0	0	0	0	0	0	0	0	0	0	0	0	13	13	0	0	0	42	42
Краснодарский край	Частные; Заочная	"    переведено в другие образовательные организации
    на программы того же уровня / 8.0"	0	0	0	0	0	0	0	0	0	0	0	0	0	22	22	0	0	0	31	31
Краснодарский край	Частные; Заочная	"    переведено из других образовательных организаций 
    с программ того же уровня / 3.0"	0	0	0	0	0	0	0	0	0	0	0	0	0	71	71	0	0	0	12	12
Краснодарский край	Частные; Заочная	    по болезни / 9.0	0	0	0	0	0	0	0	0	0	0	0	0	0	0	0	0	0	0	4	4
Краснодарский край	Частные; Заочная	    прибыло по другим причинам / 5.0	0	0	0	0	0	0	0	0	0	0	0	0	0	30	30	0	0	0	21	21
Краснодарский край	Частные; Заочная	Выбыло студентов - всего (сумма стр. 07-11, 13-15) / 6.0	0	0	0	0	0	0	0	0	0	0	0	0	0	194	194	0	0	0	168	168
Краснодарский край	Частные; Заочная	Прибыло студентов - всего (сумма стр. 02-05) / 1.0	0	0	0	0	0	0	0	0	0	0	0	0	0	278	278	0	0	0	125	125
Краснодарский край	Частные; Заочная	"Численность студентов на начало прошлого учебного года
(на 1 октября) / 17.0"	0	0	0	0	0	0	0	0	0	0	24	0	0	875	899	0	0	0	799	799
Краснодарский край	Частные; Очная	            из стр. 11 - не прошли итоговую аттестацию / 12.0	0	0	0	0	0	0	0	0	0	0	0	0	0	19	19	0	0	0	3	3
Краснодарский край	Частные; Очная	"            из стр. 11 – лица с ограниченными возможностями здоровья,
            инвалиды, дети-инвалиды / 13.0"	0	0	0	0	0	0	0	0	0	0	0	0	0	0	0	0	0	0	0	0
Краснодарский край	Частные; Очная	         отчислено в виде меры дисциплинарного взыскания / 14.0	0	0	0	0	0	0	0	0	0	0	5	0	0	3	8	0	0	0	0	0
Краснодарский край	Частные; Очная	         отчислено из-за просрочки оплаты обучения / 15.0	0	0	0	0	0	0	0	0	7	7	0	0	0	315	315	0	0	0	42	42
Краснодарский край	Частные; Очная	"    в том числе:
    переведено на другие формы обучения данной
    организации на программы того же уровня / 7.0"	0	0	0	0	0	0	0	0	0	0	0	0	0	177	177	0	0	0	46	46
Краснодарский край	Частные; Очная	"    в том числе:
    переведено с других форм обучения данной
    образовательной организации с программ того же уровня / 2.0"	0	0	0	0	0	0	0	0	0	0	0	0	0	604	604	0	0	0	14	14
Краснодарский край	Частные; Очная	    восстановлены из числа ранее отчисленных / 4.0	0	0	0	0	0	0	0	0	1	1	0	0	0	199	199	0	0	0	28	28
Краснодарский край	Частные; Очная	    выбыло по другим причинам / 16.0	0	0	0	0	0	0	0	0	0	0	0	0	0	401	401	0	0	0	35	35
Краснодарский край	Частные; Очная	"    добровольно прекратили образовательные отношения
    (бросили учебу) / 10.0"	2	0	0	11	13	0	0	0	5	5	8	0	0	994	1002	3	0	2	151	156
Краснодарский край	Частные; Очная	"    отчислено:
         по неуспеваемости / 11.0"	0	0	0	25	25	0	0	0	1	1	1	0	0	675	676	0	0	4	119	123
Краснодарский край	Частные; Очная	"    переведено в другие образовательные организации
    на программы того же уровня / 8.0"	0	0	0	0	0	0	0	0	0	0	0	0	0	549	549	0	0	2	46	48
Краснодарский край	Частные; Очная	"    переведено из других образовательных организаций 
    с программ того же уровня / 3.0"	0	0	0	0	0	0	0	0	0	0	0	0	0	450	450	0	0	0	53	53
Краснодарский край	Частные; Очная	    по болезни / 9.0	0	0	0	0	0	0	0	0	0	0	0	0	0	14	14	0	0	0	1	1
Краснодарский край	Частные; Очная	    прибыло по другим причинам / 5.0	0	0	0	0	0	0	0	0	1	1	3	0	0	297	300	0	0	0	74	74
Краснодарский край	Частные; Очная	Выбыло студентов - всего (сумма стр. 07-11, 13-15) / 6.0	2	0	0	36	38	0	0	0	13	13	14	0	0	3128	3142	3	0	8	440	451
Краснодарский край	Частные; Очная	Прибыло студентов - всего (сумма стр. 02-05) / 1.0	0	0	0	0	0	0	0	0	2	2	3	0	0	1550	1553	0	0	0	169	169
Краснодарский край	Частные; Очная	"Численность студентов на начало прошлого учебного года
(на 1 октября) / 17.0"	75	0	0	251	326	0	0	0	125	125	352	545	75	24941	25913	69	18	46	3103	3236
Краснодарский край	Частные; Очно-заочная	            из стр. 11 - не прошли итоговую аттестацию / 12.0	0	0	0	0	0	0	0	0	0	0	0	0	0	0	0	0	0	0	0	0
Краснодарский край	Частные; Очно-заочная	"            из стр. 11 – лица с ограниченными возможностями здоровья,
            инвалиды, дети-инвалиды / 13.0"	0	0	0	0	0	0	0	0	0	0	0	0	0	0	0	0	0	0	0	0
Краснодарский край	Частные; Очно-заочная	         отчислено в виде меры дисциплинарного взыскания / 14.0	0	0	0	0	0	0	0	0	0	0	0	0	0	0	0	0	0	0	0	0
Краснодарский край	Частные; Очно-заочная	         отчислено из-за просрочки оплаты обучения / 15.0	0	0	0	0	0	0	0	0	0	0	0	0	0	0	0	0	0	0	10	10
Краснодарский край	Частные; Очно-заочная	"    в том числе:
    переведено на другие формы обучения данной
    организации на программы того же уровня / 7.0"	0	0	0	0	0	0	0	0	0	0	0	0	0	15	15	0	0	0	4	4
Краснодарский край	Частные; Очно-заочная	"    в том числе:
    переведено с других форм обучения данной
    образовательной организации с программ того же уровня / 2.0"	0	0	0	0	0	0	0	0	0	0	0	0	0	0	0	0	0	0	89	89
Краснодарский край	Частные; Очно-заочная	    восстановлены из числа ранее отчисленных / 4.0	0	0	0	0	0	0	0	0	0	0	0	0	0	0	0	0	1	0	11	12
Краснодарский край	Частные; Очно-заочная	    выбыло по другим причинам / 16.0	0	0	0	0	0	0	0	0	0	0	0	0	0	0	0	0	0	0	0	0
Краснодарский край	Частные; Очно-заочная	"    добровольно прекратили образовательные отношения
    (бросили учебу) / 10.0"	0	0	0	0	0	0	0	0	0	0	0	0	0	0	0	0	3	0	15	18
Краснодарский край	Частные; Очно-заочная	"    отчислено:
         по неуспеваемости / 11.0"	0	0	0	0	0	0	0	0	0	0	0	0	0	0	0	0	0	0	0	0
Краснодарский край	Частные; Очно-заочная	"    переведено в другие образовательные организации
    на программы того же уровня / 8.0"	0	0	0	0	0	0	0	0	0	0	0	0	0	0	0	0	3	0	2	5
Краснодарский край	Частные; Очно-заочная	"    переведено из других образовательных организаций 
    с программ того же уровня / 3.0"	0	0	0	0	0	0	0	0	0	0	0	0	0	4	4	0	0	0	1	1
Краснодарский край	Частные; Очно-заочная	    по болезни / 9.0	0	0	0	0	0	0	0	0	0	0	0	0	0	0	0	0	0	0	0	0
Краснодарский край	Частные; Очно-заочная	    прибыло по другим причинам / 5.0	0	0	0	0	0	0	0	0	0	0	0	0	0	0	0	0	0	0	18	18
Краснодарский край	Частные; Очно-заочная	Выбыло студентов - всего (сумма стр. 07-11, 13-15) / 6.0	0	0	0	0	0	0	0	0	0	0	0	0	0	15	15	0	6	0	31	37
Краснодарский край	Частные; Очно-заочная	Прибыло студентов - всего (сумма стр. 02-05) / 1.0	0	0	0	0	0	0	0	0	0	0	0	0	0	4	4	0	1	0	119	120
Краснодарский край	Частные; Очно-заочная	"Численность студентов на начало прошлого учебного года
(на 1 октября) / 17.0"	0	0	0	0	0	0	0	0	0	0	0	0	0	52	52	0	0	0	1062	1062
Красноярский край	Государственные, муниципальные (без учета организаций в ведении ФСИН); Заочная	            из стр. 11 - не прошли итоговую аттестацию / 12.0	0	0	0	0	0	0	0	0	0	0	0	0	0	0	0	2	0	0	14	16
Красноярский край	Государственные, муниципальные (без учета организаций в ведении ФСИН); Заочная	"            из стр. 11 – лица с ограниченными возможностями здоровья,
            инвалиды, дети-инвалиды / 13.0"	0	0	0	0	0	0	0	0	0	0	0	0	0	0	0	2	0	0	0	2
Красноярский край	Государственные, муниципальные (без учета организаций в ведении ФСИН); Заочная	         отчислено в виде меры дисциплинарного взыскания / 14.0	0	0	0	0	0	0	0	0	0	0	0	0	0	0	0	0	0	0	28	28
Красноярский край	Государственные, муниципальные (без учета организаций в ведении ФСИН); Заочная	         отчислено из-за просрочки оплаты обучения / 15.0	0	0	0	0	0	0	0	0	0	0	0	0	0	74	74	0	0	0	242	242
Красноярский край	Государственные, муниципальные (без учета организаций в ведении ФСИН); Заочная	"    в том числе:
    переведено на другие формы обучения данной
    организации на программы того же уровня / 7.0"	0	0	0	0	0	0	0	0	0	0	0	0	0	5	5	5	0	0	28	33
Красноярский край	Государственные, муниципальные (без учета организаций в ведении ФСИН); Заочная	"    в том числе:
    переведено с других форм обучения данной
    образовательной организации с программ того же уровня / 2.0"	0	0	0	0	0	0	0	0	0	0	2	0	1	27	30	96	0	0	135	231
Красноярский край	Государственные, муниципальные (без учета организаций в ведении ФСИН); Заочная	    восстановлены из числа ранее отчисленных / 4.0	0	0	0	0	0	0	0	0	0	0	0	0	0	15	15	60	0	0	119	179
Красноярский край	Государственные, муниципальные (без учета организаций в ведении ФСИН); Заочная	    выбыло по другим причинам / 16.0	0	0	0	0	0	0	0	0	0	0	0	0	0	9	9	75	0	1	106	182
Красноярский край	Государственные, муниципальные (без учета организаций в ведении ФСИН); Заочная	"    добровольно прекратили образовательные отношения
    (бросили учебу) / 10.0"	0	0	0	0	0	0	0	0	0	0	8	0	1	36	45	373	0	4	382	759
Красноярский край	Государственные, муниципальные (без учета организаций в ведении ФСИН); Заочная	"    отчислено:
         по неуспеваемости / 11.0"	0	0	0	0	0	0	0	0	0	0	13	0	2	29	44	199	0	7	98	304
Красноярский край	Государственные, муниципальные (без учета организаций в ведении ФСИН); Заочная	"    переведено в другие образовательные организации
    на программы того же уровня / 8.0"	0	0	0	0	0	0	0	0	0	0	0	0	0	6	6	7	0	0	27	34
Красноярский край	Государственные, муниципальные (без учета организаций в ведении ФСИН); Заочная	"    переведено из других образовательных организаций 
    с программ того же уровня / 3.0"	0	0	0	0	0	0	0	0	0	0	0	0	0	7	7	27	0	0	14	41
Красноярский край	Государственные, муниципальные (без учета организаций в ведении ФСИН); Заочная	    по болезни / 9.0	0	0	0	0	0	0	0	0	0	0	0	0	0	0	0	2	0	0	0	2
Красноярский край	Государственные, муниципальные (без учета организаций в ведении ФСИН); Заочная	    прибыло по другим причинам / 5.0	0	0	0	0	0	0	0	0	0	0	0	0	0	32	32	45	0	0	96	141
Красноярский край	Государственные, муниципальные (без учета организаций в ведении ФСИН); Заочная	Выбыло студентов - всего (сумма стр. 07-11, 13-15) / 6.0	0	0	0	0	0	0	0	0	0	0	21	0	3	159	183	661	0	12	911	1584
Красноярский край	Государственные, муниципальные (без учета организаций в ведении ФСИН); Заочная	Прибыло студентов - всего (сумма стр. 02-05) / 1.0	0	0	0	0	0	0	0	0	0	0	2	0	1	81	84	228	0	0	364	592
Красноярский край	Государственные, муниципальные (без учета организаций в ведении ФСИН); Заочная	"Численность студентов на начало прошлого учебного года
(на 1 октября) / 17.0"	0	0	0	0	0	0	0	0	0	0	178	0	26	671	875	4156	0	195	4352	8703
Красноярский край	Государственные, муниципальные (без учета организаций в ведении ФСИН); Очная	            из стр. 11 - не прошли итоговую аттестацию / 12.0	53	0	0	0	53	0	0	0	0	0	28	0	0	10	38	4	0	0	0	4
Красноярский край	Государственные, муниципальные (без учета организаций в ведении ФСИН); Очная	"            из стр. 11 – лица с ограниченными возможностями здоровья,
            инвалиды, дети-инвалиды / 13.0"	1	0	0	0	1	0	0	0	0	0	0	0	0	0	0	1	0	0	1	2
Красноярский край	Государственные, муниципальные (без учета организаций в ведении ФСИН); Очная	         отчислено в виде меры дисциплинарного взыскания / 14.0	2	0	0	0	2	0	0	0	0	0	6	0	1	34	41	3	0	8	21	32
Красноярский край	Государственные, муниципальные (без учета организаций в ведении ФСИН); Очная	         отчислено из-за просрочки оплаты обучения / 15.0	0	0	0	6	6	0	0	0	0	0	0	0	0	55	55	0	0	0	30	30
Красноярский край	Государственные, муниципальные (без учета организаций в ведении ФСИН); Очная	"    в том числе:
    переведено на другие формы обучения данной
    организации на программы того же уровня / 7.0"	38	0	0	7	45	0	0	0	0	0	154	0	15	97	266	53	0	8	76	137
Красноярский край	Государственные, муниципальные (без учета организаций в ведении ФСИН); Очная	"    в том числе:
    переведено с других форм обучения данной
    образовательной организации с программ того же уровня / 2.0"	47	0	0	10	57	24	0	0	0	24	103	0	0	54	157	35	0	0	4	39
Красноярский край	Государственные, муниципальные (без учета организаций в ведении ФСИН); Очная	    восстановлены из числа ранее отчисленных / 4.0	49	0	1	4	54	0	0	0	0	0	114	0	20	61	195	56	0	13	33	102
Красноярский край	Государственные, муниципальные (без учета организаций в ведении ФСИН); Очная	    выбыло по другим причинам / 16.0	127	0	0	17	144	11	0	0	1	12	306	0	20	150	476	57	0	12	86	155
Красноярский край	Государственные, муниципальные (без учета организаций в ведении ФСИН); Очная	"    добровольно прекратили образовательные отношения
    (бросили учебу) / 10.0"	840	0	7	86	933	20	0	0	5	25	1265	0	143	484	1892	746	0	109	284	1139
Красноярский край	Государственные, муниципальные (без учета организаций в ведении ФСИН); Очная	"    отчислено:
         по неуспеваемости / 11.0"	237	0	0	18	255	4	0	0	1	5	262	0	88	151	501	143	0	72	89	304
Красноярский край	Государственные, муниципальные (без учета организаций в ведении ФСИН); Очная	"    переведено в другие образовательные организации
    на программы того же уровня / 8.0"	80	0	3	11	94	0	0	0	0	0	230	0	63	131	424	49	0	9	31	89
Красноярский край	Государственные, муниципальные (без учета организаций в ведении ФСИН); Очная	"    переведено из других образовательных организаций 
    с программ того же уровня / 3.0"	90	0	0	3	93	0	0	0	0	0	185	0	35	105	325	35	0	1	13	49
Красноярский край	Государственные, муниципальные (без учета организаций в ведении ФСИН); Очная	    по болезни / 9.0	5	0	0	4	9	0	0	0	0	0	9	0	0	0	9	0	0	0	0	0
Красноярский край	Государственные, муниципальные (без учета организаций в ведении ФСИН); Очная	    прибыло по другим причинам / 5.0	235	0	1	16	252	4	0	0	2	6	350	0	50	117	517	122	0	20	47	189
Красноярский край	Государственные, муниципальные (без учета организаций в ведении ФСИН); Очная	Выбыло студентов - всего (сумма стр. 07-11, 13-15) / 6.0	1329	0	10	149	1488	35	0	0	7	42	2232	0	330	1102	3664	1051	0	218	617	1886
Красноярский край	Государственные, муниципальные (без учета организаций в ведении ФСИН); Очная	Прибыло студентов - всего (сумма стр. 02-05) / 1.0	421	0	2	33	456	28	0	0	2	30	752	0	105	337	1194	248	0	34	97	379
Красноярский край	Государственные, муниципальные (без учета организаций в ведении ФСИН); Очная	"Численность студентов на начало прошлого учебного года
(на 1 октября) / 17.0"	12959	0	233	1048	14240	396	0	0	83	479	19970	0	3968	7108	31046	8295	0	2163	3509	13967
Красноярский край	Очно-заочная; Государственные, муниципальные (без учета организаций в ведении ФСИН)	            из стр. 11 - не прошли итоговую аттестацию / 12.0	0	0	0	0	0	0	0	0	0	0	0	0	0	0	0	0	0	0	0	0
Красноярский край	Очно-заочная; Государственные, муниципальные (без учета организаций в ведении ФСИН)	"            из стр. 11 – лица с ограниченными возможностями здоровья,
            инвалиды, дети-инвалиды / 13.0"	0	0	0	0	0	0	0	0	0	0	0	0	0	0	0	0	0	0	0	0
Красноярский край	Очно-заочная; Государственные, муниципальные (без учета организаций в ведении ФСИН)	         отчислено в виде меры дисциплинарного взыскания / 14.0	0	0	0	0	0	0	0	0	0	0	0	0	0	0	0	0	0	0	0	0
Красноярский край	Очно-заочная; Государственные, муниципальные (без учета организаций в ведении ФСИН)	         отчислено из-за просрочки оплаты обучения / 15.0	0	0	0	0	0	0	0	0	0	0	0	0	0	0	0	0	0	0	2	2
Красноярский край	Очно-заочная; Государственные, муниципальные (без учета организаций в ведении ФСИН)	"    в том числе:
    переведено на другие формы обучения данной
    организации на программы того же уровня / 7.0"	0	0	0	0	0	0	0	0	0	0	0	0	0	0	0	0	0	0	0	0
Красноярский край	Очно-заочная; Государственные, муниципальные (без учета организаций в ведении ФСИН)	"    в том числе:
    переведено с других форм обучения данной
    образовательной организации с программ того же уровня / 2.0"	0	0	0	0	0	0	0	0	0	0	0	0	0	0	0	1	0	0	2	3
Красноярский край	Очно-заочная; Государственные, муниципальные (без учета организаций в ведении ФСИН)	    восстановлены из числа ранее отчисленных / 4.0	0	0	0	0	0	0	0	0	0	0	0	0	0	0	0	5	0	0	3	8
Красноярский край	Очно-заочная; Государственные, муниципальные (без учета организаций в ведении ФСИН)	    выбыло по другим причинам / 16.0	0	0	0	0	0	0	0	0	0	0	0	0	0	0	0	2	0	0	3	5
Красноярский край	Очно-заочная; Государственные, муниципальные (без учета организаций в ведении ФСИН)	"    добровольно прекратили образовательные отношения
    (бросили учебу) / 10.0"	0	0	0	0	0	11	0	0	0	11	0	0	0	0	0	58	0	0	20	78
Красноярский край	Очно-заочная; Государственные, муниципальные (без учета организаций в ведении ФСИН)	"    отчислено:
         по неуспеваемости / 11.0"	0	0	0	0	0	0	0	0	0	0	0	0	0	0	0	22	0	0	2	24
Красноярский край	Очно-заочная; Государственные, муниципальные (без учета организаций в ведении ФСИН)	"    переведено в другие образовательные организации
    на программы того же уровня / 8.0"	0	0	0	0	0	0	0	0	0	0	0	0	0	0	0	0	0	0	2	2
Красноярский край	Очно-заочная; Государственные, муниципальные (без учета организаций в ведении ФСИН)	"    переведено из других образовательных организаций 
    с программ того же уровня / 3.0"	0	0	0	0	0	0	0	0	0	0	0	0	0	0	0	0	0	0	2	2
Красноярский край	Очно-заочная; Государственные, муниципальные (без учета организаций в ведении ФСИН)	    по болезни / 9.0	0	0	0	0	0	0	0	0	0	0	0	0	0	0	0	0	0	0	0	0
Красноярский край	Очно-заочная; Государственные, муниципальные (без учета организаций в ведении ФСИН)	    прибыло по другим причинам / 5.0	0	0	0	0	0	0	0	0	0	0	0	0	0	0	0	10	0	0	3	13
Красноярский край	Очно-заочная; Государственные, муниципальные (без учета организаций в ведении ФСИН)	Выбыло студентов - всего (сумма стр. 07-11, 13-15) / 6.0	0	0	0	0	0	11	0	0	0	11	0	0	0	0	0	82	0	0	29	111
Красноярский край	Очно-заочная; Государственные, муниципальные (без учета организаций в ведении ФСИН)	Прибыло студентов - всего (сумма стр. 02-05) / 1.0	0	0	0	0	0	0	0	0	0	0	0	0	0	0	0	16	0	0	10	26
Красноярский край	Очно-заочная; Государственные, муниципальные (без учета организаций в ведении ФСИН)	"Численность студентов на начало прошлого учебного года
(на 1 октября) / 17.0"	25	0	0	12	37	25	0	0	0	25	0	0	0	0	0	589	0	0	252	841
Красноярский край	Частные; Заочная	            из стр. 11 - не прошли итоговую аттестацию / 12.0	0	0	0	0	0	0	0	0	0	0	0	0	0	0	0	0	0	0	0	0
Красноярский край	Частные; Заочная	"            из стр. 11 – лица с ограниченными возможностями здоровья,
            инвалиды, дети-инвалиды / 13.0"	0	0	0	0	0	0	0	0	0	0	0	0	0	0	0	0	0	0	0	0
Красноярский край	Частные; Заочная	         отчислено в виде меры дисциплинарного взыскания / 14.0	0	0	0	0	0	0	0	0	0	0	0	0	0	0	0	0	0	0	0	0
Красноярский край	Частные; Заочная	         отчислено из-за просрочки оплаты обучения / 15.0	0	0	0	0	0	0	0	0	0	0	0	0	0	0	0	0	0	0	4	4
Красноярский край	Частные; Заочная	"    в том числе:
    переведено на другие формы обучения данной
    организации на программы того же уровня / 7.0"	0	0	0	0	0	0	0	0	0	0	0	0	0	0	0	0	0	0	0	0
Красноярский край	Частные; Заочная	"    в том числе:
    переведено с других форм обучения данной
    образовательной организации с программ того же уровня / 2.0"	0	0	0	0	0	0	0	0	0	0	0	0	0	26	26	0	0	0	17	17
Красноярский край	Частные; Заочная	    восстановлены из числа ранее отчисленных / 4.0	0	0	0	0	0	0	0	0	0	0	0	0	0	1	1	0	0	0	3	3
Красноярский край	Частные; Заочная	    выбыло по другим причинам / 16.0	0	0	0	0	0	0	0	0	0	0	0	0	0	0	0	0	0	0	3	3
Красноярский край	Частные; Заочная	"    добровольно прекратили образовательные отношения
    (бросили учебу) / 10.0"	0	0	0	0	0	0	0	0	0	0	0	0	0	9	9	2	0	0	29	31
Красноярский край	Частные; Заочная	"    отчислено:
         по неуспеваемости / 11.0"	0	0	0	0	0	0	0	0	0	0	0	0	0	5	5	0	0	0	0	0
Красноярский край	Частные; Заочная	"    переведено в другие образовательные организации
    на программы того же уровня / 8.0"	0	0	0	0	0	0	0	0	0	0	0	0	0	2	2	0	0	0	0	0
Красноярский край	Частные; Заочная	"    переведено из других образовательных организаций 
    с программ того же уровня / 3.0"	0	0	0	0	0	0	0	0	0	0	0	0	0	13	13	0	0	0	3	3
Красноярский край	Частные; Заочная	    по болезни / 9.0	0	0	0	0	0	0	0	0	0	0	0	0	0	0	0	0	0	0	0	0
Красноярский край	Частные; Заочная	    прибыло по другим причинам / 5.0	0	0	0	0	0	0	0	0	0	0	0	0	0	5	5	0	0	0	11	11
Красноярский край	Частные; Заочная	Выбыло студентов - всего (сумма стр. 07-11, 13-15) / 6.0	0	0	0	0	0	0	0	0	0	0	0	0	0	16	16	2	0	0	36	38
Красноярский край	Частные; Заочная	Прибыло студентов - всего (сумма стр. 02-05) / 1.0	0	0	0	0	0	0	0	0	0	0	0	0	0	45	45	0	0	0	34	34
Красноярский край	Частные; Заочная	"Численность студентов на начало прошлого учебного года
(на 1 октября) / 17.0"	0	0	0	0	0	0	0	0	0	0	0	0	0	45	45	25	0	0	431	456
Красноярский край	Частные; Очная	            из стр. 11 - не прошли итоговую аттестацию / 12.0	0	0	0	0	0	0	0	0	0	0	0	0	0	1	1	0	0	0	0	0
Красноярский край	Частные; Очная	"            из стр. 11 – лица с ограниченными возможностями здоровья,
            инвалиды, дети-инвалиды / 13.0"	0	0	0	0	0	0	0	0	0	0	0	0	0	0	0	0	0	0	0	0
Красноярский край	Частные; Очная	         отчислено в виде меры дисциплинарного взыскания / 14.0	0	0	0	0	0	0	0	0	0	0	0	0	0	0	0	0	0	0	0	0
Красноярский край	Частные; Очная	         отчислено из-за просрочки оплаты обучения / 15.0	0	0	0	0	0	0	0	0	0	0	0	0	0	4	4	0	0	0	3	3
Красноярский край	Частные; Очная	"    в том числе:
    переведено на другие формы обучения данной
    организации на программы того же уровня / 7.0"	0	0	0	0	0	0	0	0	0	0	0	0	0	49	49	0	0	0	16	16
Красноярский край	Частные; Очная	"    в том числе:
    переведено с других форм обучения данной
    образовательной организации с программ того же уровня / 2.0"	0	0	0	0	0	0	0	0	0	0	0	0	0	0	0	0	0	0	1	1
Красноярский край	Частные; Очная	    восстановлены из числа ранее отчисленных / 4.0	0	0	0	0	0	0	0	0	0	0	0	0	0	15	15	0	0	0	10	10
Красноярский край	Частные; Очная	    выбыло по другим причинам / 16.0	0	0	0	0	0	0	0	0	0	0	0	0	0	20	20	0	0	0	8	8
Красноярский край	Частные; Очная	"    добровольно прекратили образовательные отношения
    (бросили учебу) / 10.0"	0	0	0	0	0	0	0	0	0	0	0	0	1	184	185	2	0	0	52	54
Красноярский край	Частные; Очная	"    отчислено:
         по неуспеваемости / 11.0"	0	0	0	0	0	0	0	0	0	0	0	0	0	27	27	0	0	0	24	24
Красноярский край	Частные; Очная	"    переведено в другие образовательные организации
    на программы того же уровня / 8.0"	0	0	0	0	0	0	0	0	0	0	0	0	0	30	30	0	0	0	3	3
Красноярский край	Частные; Очная	"    переведено из других образовательных организаций 
    с программ того же уровня / 3.0"	0	0	0	0	0	0	0	0	0	0	0	0	0	47	47	0	0	0	1	1
Красноярский край	Частные; Очная	    по болезни / 9.0	0	0	0	0	0	0	0	0	0	0	0	0	0	0	0	0	0	0	0	0
Красноярский край	Частные; Очная	    прибыло по другим причинам / 5.0	0	0	0	0	0	0	0	0	0	0	0	0	1	29	30	0	0	0	13	13
Красноярский край	Частные; Очная	Выбыло студентов - всего (сумма стр. 07-11, 13-15) / 6.0	0	0	0	0	0	0	0	0	0	0	0	0	1	314	315	2	0	0	106	108
Красноярский край	Частные; Очная	Прибыло студентов - всего (сумма стр. 02-05) / 1.0	0	0	0	0	0	0	0	0	0	0	0	0	1	91	92	0	0	0	25	25
Красноярский край	Частные; Очная	"Численность студентов на начало прошлого учебного года
(на 1 октября) / 17.0"	0	0	0	0	0	0	0	0	0	0	100	0	15	2269	2384	50	0	0	850	900
Курганская область	Государственные, муниципальные (без учета организаций в ведении ФСИН); Заочная	            из стр. 11 - не прошли итоговую аттестацию / 12.0	0	0	0	0	0	0	0	0	0	0	0	0	0	1	1	0	0	0	0	0
Курганская область	Государственные, муниципальные (без учета организаций в ведении ФСИН); Заочная	"            из стр. 11 – лица с ограниченными возможностями здоровья,
            инвалиды, дети-инвалиды / 13.0"	0	0	0	0	0	0	0	0	0	0	0	0	0	0	0	0	0	0	0	0
Курганская область	Государственные, муниципальные (без учета организаций в ведении ФСИН); Заочная	         отчислено в виде меры дисциплинарного взыскания / 14.0	0	0	0	0	0	0	0	0	0	0	0	0	0	0	0	4	0	0	1	5
Курганская область	Государственные, муниципальные (без учета организаций в ведении ФСИН); Заочная	         отчислено из-за просрочки оплаты обучения / 15.0	0	0	0	0	0	0	0	0	0	0	0	0	0	0	0	0	0	0	25	25
Курганская область	Государственные, муниципальные (без учета организаций в ведении ФСИН); Заочная	"    в том числе:
    переведено на другие формы обучения данной
    организации на программы того же уровня / 7.0"	0	0	0	0	0	0	0	0	0	0	0	0	0	0	0	1	0	0	3	4
Курганская область	Государственные, муниципальные (без учета организаций в ведении ФСИН); Заочная	"    в том числе:
    переведено с других форм обучения данной
    образовательной организации с программ того же уровня / 2.0"	0	0	0	0	0	0	0	0	0	0	0	0	1	27	28	15	0	0	66	81
Курганская область	Государственные, муниципальные (без учета организаций в ведении ФСИН); Заочная	    восстановлены из числа ранее отчисленных / 4.0	0	0	0	0	0	0	0	0	0	0	0	0	0	17	17	18	0	0	9	27
Курганская область	Государственные, муниципальные (без учета организаций в ведении ФСИН); Заочная	    выбыло по другим причинам / 16.0	0	0	0	0	0	0	0	0	0	0	0	0	0	2	2	11	0	8	9	28
Курганская область	Государственные, муниципальные (без учета организаций в ведении ФСИН); Заочная	"    добровольно прекратили образовательные отношения
    (бросили учебу) / 10.0"	0	0	0	0	0	0	0	0	0	0	3	0	1	19	23	51	0	8	51	110
Курганская область	Государственные, муниципальные (без учета организаций в ведении ФСИН); Заочная	"    отчислено:
         по неуспеваемости / 11.0"	0	0	0	0	0	0	0	0	0	0	7	0	0	19	26	58	0	2	34	94
Курганская область	Государственные, муниципальные (без учета организаций в ведении ФСИН); Заочная	"    переведено в другие образовательные организации
    на программы того же уровня / 8.0"	0	0	0	0	0	0	0	0	0	0	1	0	0	0	1	0	0	0	8	8
Курганская область	Государственные, муниципальные (без учета организаций в ведении ФСИН); Заочная	"    переведено из других образовательных организаций 
    с программ того же уровня / 3.0"	0	0	0	0	0	0	0	0	0	0	0	0	0	34	34	3	0	0	13	16
Курганская область	Государственные, муниципальные (без учета организаций в ведении ФСИН); Заочная	    по болезни / 9.0	0	0	0	0	0	0	0	0	0	0	0	0	0	0	0	0	0	0	0	0
Курганская область	Государственные, муниципальные (без учета организаций в ведении ФСИН); Заочная	    прибыло по другим причинам / 5.0	0	0	0	0	0	0	0	0	0	0	0	0	0	8	8	23	0	1	28	52
Курганская область	Государственные, муниципальные (без учета организаций в ведении ФСИН); Заочная	Выбыло студентов - всего (сумма стр. 07-11, 13-15) / 6.0	0	0	0	0	0	0	0	0	0	0	11	0	1	40	52	125	0	18	131	274
Курганская область	Государственные, муниципальные (без учета организаций в ведении ФСИН); Заочная	Прибыло студентов - всего (сумма стр. 02-05) / 1.0	0	0	0	0	0	0	0	0	0	0	0	0	1	86	87	59	0	1	116	176
Курганская область	Государственные, муниципальные (без учета организаций в ведении ФСИН); Заочная	"Численность студентов на начало прошлого учебного года
(на 1 октября) / 17.0"	0	0	0	0	0	0	0	0	0	0	148	0	22	365	535	763	0	115	902	1780
Курганская область	Государственные, муниципальные (без учета организаций в ведении ФСИН); Очная	            из стр. 11 - не прошли итоговую аттестацию / 12.0	2	0	0	0	2	0	0	0	0	0	4	0	0	0	4	0	0	0	0	0
Курганская область	Государственные, муниципальные (без учета организаций в ведении ФСИН); Очная	"            из стр. 11 – лица с ограниченными возможностями здоровья,
            инвалиды, дети-инвалиды / 13.0"	0	0	0	0	0	0	0	0	0	0	0	0	0	0	0	0	0	0	0	0
Курганская область	Государственные, муниципальные (без учета организаций в ведении ФСИН); Очная	         отчислено в виде меры дисциплинарного взыскания / 14.0	27	0	0	6	33	0	0	0	0	0	26	0	1	6	33	3	0	2	1	6
Курганская область	Государственные, муниципальные (без учета организаций в ведении ФСИН); Очная	         отчислено из-за просрочки оплаты обучения / 15.0	0	0	0	3	3	0	0	0	0	0	0	0	0	10	10	0	0	0	2	2
Курганская область	Государственные, муниципальные (без учета организаций в ведении ФСИН); Очная	"    в том числе:
    переведено на другие формы обучения данной
    организации на программы того же уровня / 7.0"	4	0	1	1	6	0	0	0	0	0	64	0	2	40	106	4	0	0	4	8
Курганская область	Государственные, муниципальные (без учета организаций в ведении ФСИН); Очная	"    в том числе:
    переведено с других форм обучения данной
    образовательной организации с программ того же уровня / 2.0"	9	0	1	2	12	0	0	0	0	0	3	0	0	11	14	0	0	0	0	0
Курганская область	Государственные, муниципальные (без учета организаций в ведении ФСИН); Очная	    восстановлены из числа ранее отчисленных / 4.0	23	0	1	1	25	0	0	0	0	0	34	0	2	34	70	0	0	0	1	1
Курганская область	Государственные, муниципальные (без учета организаций в ведении ФСИН); Очная	    выбыло по другим причинам / 16.0	225	0	0	31	256	0	0	0	0	0	206	0	10	142	358	36	0	0	18	54
Курганская область	Государственные, муниципальные (без учета организаций в ведении ФСИН); Очная	"    добровольно прекратили образовательные отношения
    (бросили учебу) / 10.0"	258	0	2	19	279	0	0	0	0	0	329	0	127	206	662	47	0	6	25	78
Курганская область	Государственные, муниципальные (без учета организаций в ведении ФСИН); Очная	"    отчислено:
         по неуспеваемости / 11.0"	117	0	0	3	120	0	0	0	0	0	115	0	14	63	192	22	0	0	12	34
Курганская область	Государственные, муниципальные (без учета организаций в ведении ФСИН); Очная	"    переведено в другие образовательные организации
    на программы того же уровня / 8.0"	102	0	0	3	105	0	0	0	0	0	130	0	8	52	190	14	0	0	1	15
Курганская область	Государственные, муниципальные (без учета организаций в ведении ФСИН); Очная	"    переведено из других образовательных организаций 
    с программ того же уровня / 3.0"	39	0	1	2	42	0	0	0	0	0	52	0	11	28	91	2	0	0	4	6
Курганская область	Государственные, муниципальные (без учета организаций в ведении ФСИН); Очная	    по болезни / 9.0	4	0	0	0	4	0	0	0	0	0	14	0	0	2	16	1	0	0	0	1
Курганская область	Государственные, муниципальные (без учета организаций в ведении ФСИН); Очная	    прибыло по другим причинам / 5.0	92	0	0	10	102	0	0	0	0	0	53	0	26	24	103	13	0	4	2	19
Курганская область	Государственные, муниципальные (без учета организаций в ведении ФСИН); Очная	Выбыло студентов - всего (сумма стр. 07-11, 13-15) / 6.0	737	0	3	66	806	0	0	0	0	0	884	0	162	521	1567	127	0	8	63	198
Курганская область	Государственные, муниципальные (без учета организаций в ведении ФСИН); Очная	Прибыло студентов - всего (сумма стр. 02-05) / 1.0	163	0	3	15	181	0	0	0	0	0	142	0	39	97	278	15	0	4	7	26
Курганская область	Государственные, муниципальные (без учета организаций в ведении ФСИН); Очная	"Численность студентов на начало прошлого учебного года
(на 1 октября) / 17.0"	3829	0	75	266	4170	0	0	0	0	0	8174	0	1547	3272	12993	863	0	111	443	1417
Курганская область	Очно-заочная; Государственные, муниципальные (без учета организаций в ведении ФСИН)	            из стр. 11 - не прошли итоговую аттестацию / 12.0	0	0	0	0	0	0	0	0	0	0	0	0	0	0	0	0	0	0	0	0
Курганская область	Очно-заочная; Государственные, муниципальные (без учета организаций в ведении ФСИН)	"            из стр. 11 – лица с ограниченными возможностями здоровья,
            инвалиды, дети-инвалиды / 13.0"	0	0	0	0	0	0	0	0	0	0	0	0	0	0	0	0	0	0	0	0
Курганская область	Очно-заочная; Государственные, муниципальные (без учета организаций в ведении ФСИН)	         отчислено в виде меры дисциплинарного взыскания / 14.0	0	0	0	0	0	0	0	0	0	0	0	0	0	0	0	0	0	0	0	0
Курганская область	Очно-заочная; Государственные, муниципальные (без учета организаций в ведении ФСИН)	         отчислено из-за просрочки оплаты обучения / 15.0	0	0	0	0	0	0	0	0	0	0	0	0	0	0	0	0	0	0	0	0
Курганская область	Очно-заочная; Государственные, муниципальные (без учета организаций в ведении ФСИН)	"    в том числе:
    переведено на другие формы обучения данной
    организации на программы того же уровня / 7.0"	0	0	0	0	0	0	0	0	0	0	0	0	0	3	3	0	0	0	0	0
Курганская область	Очно-заочная; Государственные, муниципальные (без учета организаций в ведении ФСИН)	"    в том числе:
    переведено с других форм обучения данной
    образовательной организации с программ того же уровня / 2.0"	0	0	0	0	0	0	0	0	0	0	0	0	0	0	0	0	0	0	2	2
Курганская область	Очно-заочная; Государственные, муниципальные (без учета организаций в ведении ФСИН)	    восстановлены из числа ранее отчисленных / 4.0	0	0	0	0	0	0	0	0	0	0	0	0	0	0	0	0	0	0	0	0
Курганская область	Очно-заочная; Государственные, муниципальные (без учета организаций в ведении ФСИН)	    выбыло по другим причинам / 16.0	0	0	0	0	0	0	0	0	0	0	0	0	0	0	0	0	0	0	11	11
Курганская область	Очно-заочная; Государственные, муниципальные (без учета организаций в ведении ФСИН)	"    добровольно прекратили образовательные отношения
    (бросили учебу) / 10.0"	0	0	0	0	0	0	0	0	0	0	0	0	0	7	7	0	0	0	34	34
Курганская область	Очно-заочная; Государственные, муниципальные (без учета организаций в ведении ФСИН)	"    отчислено:
         по неуспеваемости / 11.0"	0	0	0	0	0	0	0	0	0	0	0	0	0	0	0	0	0	0	5	5
Курганская область	Очно-заочная; Государственные, муниципальные (без учета организаций в ведении ФСИН)	"    переведено в другие образовательные организации
    на программы того же уровня / 8.0"	0	0	0	0	0	0	0	0	0	0	0	0	0	1	1	0	0	0	4	4
Курганская область	Очно-заочная; Государственные, муниципальные (без учета организаций в ведении ФСИН)	"    переведено из других образовательных организаций 
    с программ того же уровня / 3.0"	0	0	0	0	0	0	0	0	0	0	0	0	0	0	0	0	0	0	2	2
Курганская область	Очно-заочная; Государственные, муниципальные (без учета организаций в ведении ФСИН)	    по болезни / 9.0	0	0	0	0	0	0	0	0	0	0	0	0	0	0	0	0	0	0	0	0
Курганская область	Очно-заочная; Государственные, муниципальные (без учета организаций в ведении ФСИН)	    прибыло по другим причинам / 5.0	0	0	0	0	0	0	0	0	0	0	0	0	0	0	0	0	0	0	1	1
Курганская область	Очно-заочная; Государственные, муниципальные (без учета организаций в ведении ФСИН)	Выбыло студентов - всего (сумма стр. 07-11, 13-15) / 6.0	0	0	0	0	0	0	0	0	0	0	0	0	0	11	11	0	0	0	54	54
Курганская область	Очно-заочная; Государственные, муниципальные (без учета организаций в ведении ФСИН)	Прибыло студентов - всего (сумма стр. 02-05) / 1.0	0	0	0	0	0	0	0	0	0	0	0	0	0	0	0	0	0	0	5	5
Курганская область	Очно-заочная; Государственные, муниципальные (без учета организаций в ведении ФСИН)	"Численность студентов на начало прошлого учебного года
(на 1 октября) / 17.0"	0	0	0	0	0	0	0	0	0	0	0	0	0	13	13	0	0	0	295	295
Курганская область	Частные; Заочная	            из стр. 11 - не прошли итоговую аттестацию / 12.0	0	0	0	0	0	0	0	0	0	0	0	0	0	0	0	0	0	0	0	0
Курганская область	Частные; Заочная	"            из стр. 11 – лица с ограниченными возможностями здоровья,
            инвалиды, дети-инвалиды / 13.0"	0	0	0	0	0	0	0	0	0	0	0	0	0	0	0	0	0	0	0	0
Курганская область	Частные; Заочная	         отчислено в виде меры дисциплинарного взыскания / 14.0	0	0	0	0	0	0	0	0	0	0	0	0	0	0	0	0	0	0	0	0
Курганская область	Частные; Заочная	         отчислено из-за просрочки оплаты обучения / 15.0	0	0	0	0	0	0	0	0	0	0	0	0	0	0	0	0	0	0	0	0
Курганская область	Частные; Заочная	"    в том числе:
    переведено на другие формы обучения данной
    организации на программы того же уровня / 7.0"	0	0	0	0	0	0	0	0	0	0	0	0	0	0	0	0	0	0	0	0
Курганская область	Частные; Заочная	"    в том числе:
    переведено с других форм обучения данной
    образовательной организации с программ того же уровня / 2.0"	0	0	0	0	0	0	0	0	0	0	0	0	0	0	0	0	0	0	0	0
Курганская область	Частные; Заочная	    восстановлены из числа ранее отчисленных / 4.0	0	0	0	0	0	0	0	0	0	0	0	0	0	0	0	0	0	0	0	0
Курганская область	Частные; Заочная	    выбыло по другим причинам / 16.0	0	0	0	0	0	0	0	0	0	0	0	0	0	0	0	0	0	0	0	0
Курганская область	Частные; Заочная	"    добровольно прекратили образовательные отношения
    (бросили учебу) / 10.0"	0	0	0	0	0	0	0	0	0	0	0	0	0	0	0	0	0	0	0	0
Курганская область	Частные; Заочная	"    отчислено:
         по неуспеваемости / 11.0"	0	0	0	0	0	0	0	0	0	0	0	0	0	0	0	0	0	0	0	0
Курганская область	Частные; Заочная	"    переведено в другие образовательные организации
    на программы того же уровня / 8.0"	0	0	0	0	0	0	0	0	0	0	0	0	0	0	0	0	0	0	0	0
Курганская область	Частные; Заочная	"    переведено из других образовательных организаций 
    с программ того же уровня / 3.0"	0	0	0	0	0	0	0	0	0	0	0	0	0	0	0	0	0	0	0	0
Курганская область	Частные; Заочная	    по болезни / 9.0	0	0	0	0	0	0	0	0	0	0	0	0	0	0	0	0	0	0	0	0
Курганская область	Частные; Заочная	    прибыло по другим причинам / 5.0	0	0	0	0	0	0	0	0	0	0	0	0	0	0	0	0	0	0	0	0
Курганская область	Частные; Заочная	Выбыло студентов - всего (сумма стр. 07-11, 13-15) / 6.0	0	0	0	0	0	0	0	0	0	0	0	0	0	0	0	0	0	0	0	0
Курганская область	Частные; Заочная	Прибыло студентов - всего (сумма стр. 02-05) / 1.0	0	0	0	0	0	0	0	0	0	0	0	0	0	0	0	0	0	0	0	0
Курганская область	Частные; Заочная	"Численность студентов на начало прошлого учебного года
(на 1 октября) / 17.0"	0	0	0	0	0	0	0	0	0	0	0	0	0	5	5	0	0	0	8	8
Курганская область	Частные; Очная	            из стр. 11 - не прошли итоговую аттестацию / 12.0	0	0	0	0	0	0	0	0	0	0	0	0	0	0	0	0	0	0	0	0
Курганская область	Частные; Очная	"            из стр. 11 – лица с ограниченными возможностями здоровья,
            инвалиды, дети-инвалиды / 13.0"	0	0	0	0	0	0	0	0	0	0	0	0	0	0	0	0	0	0	0	0
Курганская область	Частные; Очная	         отчислено в виде меры дисциплинарного взыскания / 14.0	0	0	0	0	0	0	0	0	0	0	0	0	0	0	0	0	0	0	0	0
Курганская область	Частные; Очная	         отчислено из-за просрочки оплаты обучения / 15.0	0	0	0	0	0	0	0	0	0	0	0	0	0	0	0	0	0	0	0	0
Курганская область	Частные; Очная	"    в том числе:
    переведено на другие формы обучения данной
    организации на программы того же уровня / 7.0"	0	0	0	0	0	0	0	0	0	0	0	0	0	0	0	0	0	0	0	0
Курганская область	Частные; Очная	"    в том числе:
    переведено с других форм обучения данной
    образовательной организации с программ того же уровня / 2.0"	0	0	0	0	0	0	0	0	0	0	0	0	0	0	0	0	0	0	0	0
Курганская область	Частные; Очная	    восстановлены из числа ранее отчисленных / 4.0	0	0	0	0	0	0	0	0	0	0	0	0	0	0	0	0	0	0	0	0
Курганская область	Частные; Очная	    выбыло по другим причинам / 16.0	0	0	0	0	0	0	0	0	0	0	0	0	0	0	0	0	0	0	0	0
Курганская область	Частные; Очная	"    добровольно прекратили образовательные отношения
    (бросили учебу) / 10.0"	0	0	0	0	0	0	0	0	0	0	0	0	0	0	0	0	0	0	0	0
Курганская область	Частные; Очная	"    отчислено:
         по неуспеваемости / 11.0"	0	0	0	0	0	0	0	0	0	0	0	0	0	0	0	0	0	0	0	0
Курганская область	Частные; Очная	"    переведено в другие образовательные организации
    на программы того же уровня / 8.0"	0	0	0	0	0	0	0	0	0	0	0	0	0	0	0	0	0	0	0	0
Курганская область	Частные; Очная	"    переведено из других образовательных организаций 
    с программ того же уровня / 3.0"	0	0	0	0	0	0	0	0	0	0	0	0	0	0	0	0	0	0	0	0
Курганская область	Частные; Очная	    по болезни / 9.0	0	0	0	0	0	0	0	0	0	0	0	0	0	0	0	0	0	0	0	0
Курганская область	Частные; Очная	    прибыло по другим причинам / 5.0	0	0	0	0	0	0	0	0	0	0	0	0	0	0	0	0	0	0	0	0
Курганская область	Частные; Очная	Выбыло студентов - всего (сумма стр. 07-11, 13-15) / 6.0	0	0	0	0	0	0	0	0	0	0	0	0	0	0	0	0	0	0	0	0
Курганская область	Частные; Очная	Прибыло студентов - всего (сумма стр. 02-05) / 1.0	0	0	0	0	0	0	0	0	0	0	0	0	0	0	0	0	0	0	0	0
Курганская область	Частные; Очная	"Численность студентов на начало прошлого учебного года
(на 1 октября) / 17.0"	0	0	0	0	0	0	0	0	0	0	0	0	0	30	30	0	0	0	7	7
Курская область	Государственные, муниципальные (без учета организаций в ведении ФСИН); Заочная	            из стр. 11 - не прошли итоговую аттестацию / 12.0	0	0	0	0	0	0	0	0	0	0	0	0	0	0	0	0	0	0	0	0
Курская область	Государственные, муниципальные (без учета организаций в ведении ФСИН); Заочная	"            из стр. 11 – лица с ограниченными возможностями здоровья,
            инвалиды, дети-инвалиды / 13.0"	0	0	0	0	0	0	0	0	0	0	0	0	0	0	0	0	0	0	0	0
Курская область	Государственные, муниципальные (без учета организаций в ведении ФСИН); Заочная	         отчислено в виде меры дисциплинарного взыскания / 14.0	0	0	0	0	0	0	0	0	0	0	0	0	0	0	0	0	0	0	0	0
Курская область	Государственные, муниципальные (без учета организаций в ведении ФСИН); Заочная	         отчислено из-за просрочки оплаты обучения / 15.0	0	0	0	0	0	0	0	0	0	0	0	0	0	0	0	0	0	0	16	16
Курская область	Государственные, муниципальные (без учета организаций в ведении ФСИН); Заочная	"    в том числе:
    переведено на другие формы обучения данной
    организации на программы того же уровня / 7.0"	0	0	0	0	0	0	0	0	0	0	0	0	0	0	0	6	0	0	1	7
Курская область	Государственные, муниципальные (без учета организаций в ведении ФСИН); Заочная	"    в том числе:
    переведено с других форм обучения данной
    образовательной организации с программ того же уровня / 2.0"	0	0	0	0	0	0	0	0	0	0	0	0	0	0	0	24	0	0	35	59
Курская область	Государственные, муниципальные (без учета организаций в ведении ФСИН); Заочная	    восстановлены из числа ранее отчисленных / 4.0	0	0	0	0	0	0	0	0	0	0	0	0	0	0	0	15	0	0	15	30
Курская область	Государственные, муниципальные (без учета организаций в ведении ФСИН); Заочная	    выбыло по другим причинам / 16.0	0	0	0	0	0	0	0	0	0	0	0	0	0	0	0	5	0	0	0	5
Курская область	Государственные, муниципальные (без учета организаций в ведении ФСИН); Заочная	"    добровольно прекратили образовательные отношения
    (бросили учебу) / 10.0"	0	0	0	0	0	0	0	0	0	0	0	0	0	0	0	60	0	1	46	107
Курская область	Государственные, муниципальные (без учета организаций в ведении ФСИН); Заочная	"    отчислено:
         по неуспеваемости / 11.0"	0	0	0	0	0	0	0	0	0	0	0	0	0	0	0	41	0	0	22	63
Курская область	Государственные, муниципальные (без учета организаций в ведении ФСИН); Заочная	"    переведено в другие образовательные организации
    на программы того же уровня / 8.0"	0	0	0	0	0	0	0	0	0	0	0	0	0	0	0	0	0	0	1	1
Курская область	Государственные, муниципальные (без учета организаций в ведении ФСИН); Заочная	"    переведено из других образовательных организаций 
    с программ того же уровня / 3.0"	0	0	0	0	0	0	0	0	0	0	0	0	0	0	0	2	0	0	5	7
Курская область	Государственные, муниципальные (без учета организаций в ведении ФСИН); Заочная	    по болезни / 9.0	0	0	0	0	0	0	0	0	0	0	0	0	0	0	0	2	0	0	0	2
Курская область	Государственные, муниципальные (без учета организаций в ведении ФСИН); Заочная	    прибыло по другим причинам / 5.0	0	0	0	0	0	0	0	0	0	0	0	0	0	0	0	0	0	1	27	28
Курская область	Государственные, муниципальные (без учета организаций в ведении ФСИН); Заочная	Выбыло студентов - всего (сумма стр. 07-11, 13-15) / 6.0	0	0	0	0	0	0	0	0	0	0	0	0	0	0	0	114	0	1	86	201
Курская область	Государственные, муниципальные (без учета организаций в ведении ФСИН); Заочная	Прибыло студентов - всего (сумма стр. 02-05) / 1.0	0	0	0	0	0	0	0	0	0	0	0	0	0	0	0	41	0	1	82	124
Курская область	Государственные, муниципальные (без учета организаций в ведении ФСИН); Заочная	"Численность студентов на начало прошлого учебного года
(на 1 октября) / 17.0"	0	0	0	0	0	0	0	0	0	0	12	0	0	0	12	2003	0	8	460	2471
Курская область	Государственные, муниципальные (без учета организаций в ведении ФСИН); Очная	            из стр. 11 - не прошли итоговую аттестацию / 12.0	3	0	0	0	3	0	0	0	0	0	3	0	0	3	6	0	0	0	0	0
Курская область	Государственные, муниципальные (без учета организаций в ведении ФСИН); Очная	"            из стр. 11 – лица с ограниченными возможностями здоровья,
            инвалиды, дети-инвалиды / 13.0"	0	0	0	0	0	0	0	0	0	0	0	0	0	2	2	0	0	0	0	0
Курская область	Государственные, муниципальные (без учета организаций в ведении ФСИН); Очная	         отчислено в виде меры дисциплинарного взыскания / 14.0	0	0	0	0	0	0	0	0	0	0	0	0	6	4	10	0	0	1	0	1
Курская область	Государственные, муниципальные (без учета организаций в ведении ФСИН); Очная	         отчислено из-за просрочки оплаты обучения / 15.0	0	0	0	1	1	0	0	0	0	0	0	0	0	13	13	0	0	0	4	4
Курская область	Государственные, муниципальные (без учета организаций в ведении ФСИН); Очная	"    в том числе:
    переведено на другие формы обучения данной
    организации на программы того же уровня / 7.0"	9	0	0	2	11	0	0	0	0	0	52	0	2	44	98	7	0	0	6	13
Курская область	Государственные, муниципальные (без учета организаций в ведении ФСИН); Очная	"    в том числе:
    переведено с других форм обучения данной
    образовательной организации с программ того же уровня / 2.0"	22	0	0	1	23	1	0	0	0	1	41	0	6	1	48	2	0	0	1	3
Курская область	Государственные, муниципальные (без учета организаций в ведении ФСИН); Очная	    восстановлены из числа ранее отчисленных / 4.0	12	0	0	0	12	0	0	0	0	0	26	0	0	35	61	2	0	0	9	11
Курская область	Государственные, муниципальные (без учета организаций в ведении ФСИН); Очная	    выбыло по другим причинам / 16.0	36	0	1	0	37	0	0	0	0	0	65	0	7	9	81	4	0	1	2	7
Курская область	Государственные, муниципальные (без учета организаций в ведении ФСИН); Очная	"    добровольно прекратили образовательные отношения
    (бросили учебу) / 10.0"	164	0	0	14	178	20	0	0	0	20	252	0	73	132	457	44	0	19	53	116
Курская область	Государственные, муниципальные (без учета организаций в ведении ФСИН); Очная	"    отчислено:
         по неуспеваемости / 11.0"	65	0	5	2	72	3	0	0	0	3	122	0	14	61	197	11	0	8	22	41
Курская область	Государственные, муниципальные (без учета организаций в ведении ФСИН); Очная	"    переведено в другие образовательные организации
    на программы того же уровня / 8.0"	29	0	0	0	29	0	0	0	0	0	87	0	17	74	178	4	0	0	4	8
Курская область	Государственные, муниципальные (без учета организаций в ведении ФСИН); Очная	"    переведено из других образовательных организаций 
    с программ того же уровня / 3.0"	38	0	0	1	39	0	0	0	0	0	57	0	1	38	96	7	0	2	1	10
Курская область	Государственные, муниципальные (без учета организаций в ведении ФСИН); Очная	    по болезни / 9.0	7	0	0	0	7	0	0	0	0	0	2	0	0	0	2	0	0	0	0	0
Курская область	Государственные, муниципальные (без учета организаций в ведении ФСИН); Очная	    прибыло по другим причинам / 5.0	56	0	0	7	63	1	0	0	0	1	88	0	19	30	137	1	0	0	1	2
Курская область	Государственные, муниципальные (без учета организаций в ведении ФСИН); Очная	Выбыло студентов - всего (сумма стр. 07-11, 13-15) / 6.0	310	0	6	19	335	23	0	0	0	23	580	0	119	337	1036	70	0	29	91	190
Курская область	Государственные, муниципальные (без учета организаций в ведении ФСИН); Очная	Прибыло студентов - всего (сумма стр. 02-05) / 1.0	128	0	0	9	137	2	0	0	0	2	212	0	26	104	342	12	0	2	12	26
Курская область	Государственные, муниципальные (без учета организаций в ведении ФСИН); Очная	"Численность студентов на начало прошлого учебного года
(на 1 октября) / 17.0"	4728	0	42	85	4855	110	0	0	0	110	11026	0	2119	4339	17484	579	0	278	783	1640
Курская область	Очно-заочная; Государственные, муниципальные (без учета организаций в ведении ФСИН)	            из стр. 11 - не прошли итоговую аттестацию / 12.0	0	0	0	0	0	0	0	0	0	0	0	0	0	0	0	0	0	0	0	0
Курская область	Очно-заочная; Государственные, муниципальные (без учета организаций в ведении ФСИН)	"            из стр. 11 – лица с ограниченными возможностями здоровья,
            инвалиды, дети-инвалиды / 13.0"	0	0	0	0	0	0	0	0	0	0	0	0	0	0	0	0	0	0	0	0
Курская область	Очно-заочная; Государственные, муниципальные (без учета организаций в ведении ФСИН)	         отчислено в виде меры дисциплинарного взыскания / 14.0	0	0	0	0	0	0	0	0	0	0	0	0	0	0	0	0	0	0	0	0
Курская область	Очно-заочная; Государственные, муниципальные (без учета организаций в ведении ФСИН)	         отчислено из-за просрочки оплаты обучения / 15.0	0	0	0	0	0	0	0	0	0	0	0	0	0	0	0	0	0	0	0	0
Курская область	Очно-заочная; Государственные, муниципальные (без учета организаций в ведении ФСИН)	"    в том числе:
    переведено на другие формы обучения данной
    организации на программы того же уровня / 7.0"	0	0	0	0	0	0	0	0	0	0	0	0	0	24	24	2	0	0	0	2
Курская область	Очно-заочная; Государственные, муниципальные (без учета организаций в ведении ФСИН)	"    в том числе:
    переведено с других форм обучения данной
    образовательной организации с программ того же уровня / 2.0"	0	0	0	0	0	0	0	0	0	0	0	0	0	1	1	3	0	0	2	5
Курская область	Очно-заочная; Государственные, муниципальные (без учета организаций в ведении ФСИН)	    восстановлены из числа ранее отчисленных / 4.0	0	0	0	0	0	0	0	0	0	0	0	0	0	3	3	1	0	0	1	2
Курская область	Очно-заочная; Государственные, муниципальные (без учета организаций в ведении ФСИН)	    выбыло по другим причинам / 16.0	0	0	0	0	0	0	0	0	0	0	0	0	0	0	0	1	0	0	0	1
Курская область	Очно-заочная; Государственные, муниципальные (без учета организаций в ведении ФСИН)	"    добровольно прекратили образовательные отношения
    (бросили учебу) / 10.0"	0	0	0	0	0	0	0	0	0	0	0	0	0	0	0	26	0	0	14	40
Курская область	Очно-заочная; Государственные, муниципальные (без учета организаций в ведении ФСИН)	"    отчислено:
         по неуспеваемости / 11.0"	0	0	0	0	0	0	0	0	0	0	0	0	0	0	0	3	0	0	4	7
Курская область	Очно-заочная; Государственные, муниципальные (без учета организаций в ведении ФСИН)	"    переведено в другие образовательные организации
    на программы того же уровня / 8.0"	0	0	0	0	0	0	0	0	0	0	0	0	0	0	0	2	0	0	3	5
Курская область	Очно-заочная; Государственные, муниципальные (без учета организаций в ведении ФСИН)	"    переведено из других образовательных организаций 
    с программ того же уровня / 3.0"	0	0	0	0	0	0	0	0	0	0	0	0	0	1	1	3	0	0	4	7
Курская область	Очно-заочная; Государственные, муниципальные (без учета организаций в ведении ФСИН)	    по болезни / 9.0	0	0	0	0	0	0	0	0	0	0	0	0	0	0	0	0	0	0	0	0
Курская область	Очно-заочная; Государственные, муниципальные (без учета организаций в ведении ФСИН)	    прибыло по другим причинам / 5.0	0	0	0	0	0	0	0	0	0	0	0	0	0	0	0	0	0	0	0	0
Курская область	Очно-заочная; Государственные, муниципальные (без учета организаций в ведении ФСИН)	Выбыло студентов - всего (сумма стр. 07-11, 13-15) / 6.0	0	0	0	0	0	0	0	0	0	0	0	0	0	24	24	34	0	0	21	55
Курская область	Очно-заочная; Государственные, муниципальные (без учета организаций в ведении ФСИН)	Прибыло студентов - всего (сумма стр. 02-05) / 1.0	0	0	0	0	0	0	0	0	0	0	0	0	0	5	5	7	0	0	7	14
Курская область	Очно-заочная; Государственные, муниципальные (без учета организаций в ведении ФСИН)	"Численность студентов на начало прошлого учебного года
(на 1 октября) / 17.0"	0	0	0	0	0	0	0	0	0	0	0	0	0	0	0	209	0	0	101	310
Курская область	Частные; Заочная	            из стр. 11 - не прошли итоговую аттестацию / 12.0	0	0	0	0	0	0	0	0	0	0	0	0	0	0	0	0	0	0	0	0
Курская область	Частные; Заочная	"            из стр. 11 – лица с ограниченными возможностями здоровья,
            инвалиды, дети-инвалиды / 13.0"	0	0	0	0	0	0	0	0	0	0	0	0	0	0	0	0	0	0	0	0
Курская область	Частные; Заочная	         отчислено в виде меры дисциплинарного взыскания / 14.0	0	0	0	0	0	0	0	0	0	0	0	0	0	17	17	0	0	0	3	3
Курская область	Частные; Заочная	         отчислено из-за просрочки оплаты обучения / 15.0	0	0	0	0	0	0	0	0	0	0	0	0	0	5	5	0	0	0	0	0
Курская область	Частные; Заочная	"    в том числе:
    переведено на другие формы обучения данной
    организации на программы того же уровня / 7.0"	0	0	0	0	0	0	0	0	0	0	0	0	0	19	19	0	0	0	0	0
Курская область	Частные; Заочная	"    в том числе:
    переведено с других форм обучения данной
    образовательной организации с программ того же уровня / 2.0"	0	0	0	0	0	0	0	0	0	0	0	0	0	25	25	0	0	0	2	2
Курская область	Частные; Заочная	    восстановлены из числа ранее отчисленных / 4.0	0	0	0	0	0	0	0	0	0	0	0	0	0	12	12	0	0	0	2	2
Курская область	Частные; Заочная	    выбыло по другим причинам / 16.0	0	0	0	0	0	0	0	0	0	0	0	0	0	9	9	0	0	0	5	5
Курская область	Частные; Заочная	"    добровольно прекратили образовательные отношения
    (бросили учебу) / 10.0"	0	0	0	0	0	0	0	0	0	0	0	0	0	8	8	0	0	0	1	1
Курская область	Частные; Заочная	"    отчислено:
         по неуспеваемости / 11.0"	0	0	0	0	0	0	0	0	0	0	0	0	0	10	10	0	0	0	5	5
Курская область	Частные; Заочная	"    переведено в другие образовательные организации
    на программы того же уровня / 8.0"	0	0	0	0	0	0	0	0	0	0	0	0	0	0	0	0	0	0	0	0
Курская область	Частные; Заочная	"    переведено из других образовательных организаций 
    с программ того же уровня / 3.0"	0	0	0	0	0	0	0	0	0	0	0	0	0	9	9	0	0	0	0	0
Курская область	Частные; Заочная	    по болезни / 9.0	0	0	0	0	0	0	0	0	0	0	0	0	0	0	0	0	0	0	0	0
Курская область	Частные; Заочная	    прибыло по другим причинам / 5.0	0	0	0	0	0	0	0	0	0	0	0	0	0	0	0	0	0	0	0	0
Курская область	Частные; Заочная	Выбыло студентов - всего (сумма стр. 07-11, 13-15) / 6.0	0	0	0	0	0	0	0	0	0	0	0	0	0	68	68	0	0	0	14	14
Курская область	Частные; Заочная	Прибыло студентов - всего (сумма стр. 02-05) / 1.0	0	0	0	0	0	0	0	0	0	0	0	0	0	46	46	0	0	0	4	4
Курская область	Частные; Заочная	"Численность студентов на начало прошлого учебного года
(на 1 октября) / 17.0"	0	0	0	0	0	0	0	0	0	0	0	0	0	362	362	0	0	0	235	235
Курская область	Частные; Очная	            из стр. 11 - не прошли итоговую аттестацию / 12.0	0	0	0	0	0	0	0	0	0	0	0	0	0	0	0	0	0	0	0	0
Курская область	Частные; Очная	"            из стр. 11 – лица с ограниченными возможностями здоровья,
            инвалиды, дети-инвалиды / 13.0"	0	0	0	0	0	0	0	0	0	0	0	0	0	0	0	0	0	0	0	0
Курская область	Частные; Очная	         отчислено в виде меры дисциплинарного взыскания / 14.0	0	0	0	0	0	0	0	0	0	0	0	0	0	0	0	0	0	0	2	2
Курская область	Частные; Очная	         отчислено из-за просрочки оплаты обучения / 15.0	0	0	0	0	0	0	0	0	0	0	0	0	0	19	19	0	0	0	6	6
Курская область	Частные; Очная	"    в том числе:
    переведено на другие формы обучения данной
    организации на программы того же уровня / 7.0"	0	0	0	0	0	0	0	0	0	0	0	0	0	25	25	0	0	0	3	3
Курская область	Частные; Очная	"    в том числе:
    переведено с других форм обучения данной
    образовательной организации с программ того же уровня / 2.0"	0	0	0	0	0	0	0	0	0	0	0	0	0	19	19	0	0	0	0	0
Курская область	Частные; Очная	    восстановлены из числа ранее отчисленных / 4.0	0	0	0	0	0	0	0	0	0	0	0	0	0	7	7	0	0	0	3	3
Курская область	Частные; Очная	    выбыло по другим причинам / 16.0	0	0	0	0	0	0	0	0	0	0	0	0	0	0	0	0	0	0	0	0
Курская область	Частные; Очная	"    добровольно прекратили образовательные отношения
    (бросили учебу) / 10.0"	0	0	0	0	0	0	0	0	0	0	0	0	0	25	25	0	0	0	10	10
Курская область	Частные; Очная	"    отчислено:
         по неуспеваемости / 11.0"	0	0	0	0	0	0	0	0	0	0	0	0	0	9	9	0	0	0	3	3
Курская область	Частные; Очная	"    переведено в другие образовательные организации
    на программы того же уровня / 8.0"	0	0	0	0	0	0	0	0	0	0	0	0	0	10	10	0	0	0	0	0
Курская область	Частные; Очная	"    переведено из других образовательных организаций 
    с программ того же уровня / 3.0"	0	0	0	0	0	0	0	0	0	0	0	0	0	19	19	0	0	0	2	2
Курская область	Частные; Очная	    по болезни / 9.0	0	0	0	0	0	0	0	0	0	0	0	0	0	0	0	0	0	0	0	0
Курская область	Частные; Очная	    прибыло по другим причинам / 5.0	0	0	0	0	0	0	0	0	0	0	0	0	0	4	4	0	0	0	0	0
Курская область	Частные; Очная	Выбыло студентов - всего (сумма стр. 07-11, 13-15) / 6.0	0	0	0	0	0	0	0	0	0	0	0	0	0	88	88	0	0	0	24	24
Курская область	Частные; Очная	Прибыло студентов - всего (сумма стр. 02-05) / 1.0	0	0	0	0	0	0	0	0	0	0	0	0	0	49	49	0	0	0	5	5
Курская область	Частные; Очная	"Численность студентов на начало прошлого учебного года
(на 1 октября) / 17.0"	0	0	0	0	0	0	0	0	0	0	0	0	0	828	828	0	0	0	152	152
Ленинградская область	Государственные, муниципальные (без учета организаций в ведении ФСИН); Заочная	            из стр. 11 - не прошли итоговую аттестацию / 12.0	0	0	0	0	0	0	0	0	0	0	0	0	0	0	0	0	0	0	0	0
Ленинградская область	Государственные, муниципальные (без учета организаций в ведении ФСИН); Заочная	"            из стр. 11 – лица с ограниченными возможностями здоровья,
            инвалиды, дети-инвалиды / 13.0"	0	0	0	0	0	0	0	0	0	0	0	0	0	0	0	0	0	0	0	0
Ленинградская область	Государственные, муниципальные (без учета организаций в ведении ФСИН); Заочная	         отчислено в виде меры дисциплинарного взыскания / 14.0	0	0	0	0	0	0	0	0	0	0	0	0	0	0	0	0	0	0	0	0
Ленинградская область	Государственные, муниципальные (без учета организаций в ведении ФСИН); Заочная	         отчислено из-за просрочки оплаты обучения / 15.0	0	0	0	0	0	0	0	0	0	0	0	0	0	0	0	0	0	0	14	14
Ленинградская область	Государственные, муниципальные (без учета организаций в ведении ФСИН); Заочная	"    в том числе:
    переведено на другие формы обучения данной
    организации на программы того же уровня / 7.0"	0	0	0	0	0	0	0	0	0	0	0	0	0	0	0	0	0	0	1	1
Ленинградская область	Государственные, муниципальные (без учета организаций в ведении ФСИН); Заочная	"    в том числе:
    переведено с других форм обучения данной
    образовательной организации с программ того же уровня / 2.0"	0	0	0	0	0	0	0	0	0	0	4	0	0	4	8	1	0	0	2	3
Ленинградская область	Государственные, муниципальные (без учета организаций в ведении ФСИН); Заочная	    восстановлены из числа ранее отчисленных / 4.0	0	0	0	0	0	0	0	0	0	0	0	0	0	0	0	7	0	0	6	13
Ленинградская область	Государственные, муниципальные (без учета организаций в ведении ФСИН); Заочная	    выбыло по другим причинам / 16.0	0	0	0	0	0	0	0	0	0	0	0	0	0	0	0	11	0	0	20	31
Ленинградская область	Государственные, муниципальные (без учета организаций в ведении ФСИН); Заочная	"    добровольно прекратили образовательные отношения
    (бросили учебу) / 10.0"	0	0	0	0	0	0	0	0	0	0	1	0	0	0	1	33	0	0	32	65
Ленинградская область	Государственные, муниципальные (без учета организаций в ведении ФСИН); Заочная	"    отчислено:
         по неуспеваемости / 11.0"	0	0	0	0	0	0	0	0	0	0	0	0	0	0	0	37	0	0	10	47
Ленинградская область	Государственные, муниципальные (без учета организаций в ведении ФСИН); Заочная	"    переведено в другие образовательные организации
    на программы того же уровня / 8.0"	0	0	0	0	0	0	0	0	0	0	0	0	0	0	0	0	0	0	0	0
Ленинградская область	Государственные, муниципальные (без учета организаций в ведении ФСИН); Заочная	"    переведено из других образовательных организаций 
    с программ того же уровня / 3.0"	0	0	0	0	0	0	0	0	0	0	0	0	0	0	0	5	0	0	2	7
Ленинградская область	Государственные, муниципальные (без учета организаций в ведении ФСИН); Заочная	    по болезни / 9.0	0	0	0	0	0	0	0	0	0	0	0	0	0	0	0	0	0	0	0	0
Ленинградская область	Государственные, муниципальные (без учета организаций в ведении ФСИН); Заочная	    прибыло по другим причинам / 5.0	0	0	0	0	0	0	0	0	0	0	0	0	0	0	0	33	0	0	10	43
Ленинградская область	Государственные, муниципальные (без учета организаций в ведении ФСИН); Заочная	Выбыло студентов - всего (сумма стр. 07-11, 13-15) / 6.0	0	0	0	0	0	0	0	0	0	0	1	0	0	0	1	81	0	0	77	158
Ленинградская область	Государственные, муниципальные (без учета организаций в ведении ФСИН); Заочная	Прибыло студентов - всего (сумма стр. 02-05) / 1.0	0	0	0	0	0	0	0	0	0	0	4	0	0	4	8	46	0	0	20	66
Ленинградская область	Государственные, муниципальные (без учета организаций в ведении ФСИН); Заочная	"Численность студентов на начало прошлого учебного года
(на 1 октября) / 17.0"	0	0	0	0	0	0	0	0	0	0	9	0	0	0	9	967	0	0	521	1488
Ленинградская область	Государственные, муниципальные (без учета организаций в ведении ФСИН); Очная	            из стр. 11 - не прошли итоговую аттестацию / 12.0	4	0	0	0	4	0	0	0	0	0	18	0	0	1	19	6	0	0	2	8
Ленинградская область	Государственные, муниципальные (без учета организаций в ведении ФСИН); Очная	"            из стр. 11 – лица с ограниченными возможностями здоровья,
            инвалиды, дети-инвалиды / 13.0"	1	0	0	0	1	0	0	0	0	0	2	0	0	0	2	0	0	0	0	0
Ленинградская область	Государственные, муниципальные (без учета организаций в ведении ФСИН); Очная	         отчислено в виде меры дисциплинарного взыскания / 14.0	3	0	0	0	3	0	0	0	0	0	3	0	0	2	5	0	0	0	0	0
Ленинградская область	Государственные, муниципальные (без учета организаций в ведении ФСИН); Очная	         отчислено из-за просрочки оплаты обучения / 15.0	0	0	0	3	3	0	0	0	0	0	0	0	0	46	46	0	0	0	4	4
Ленинградская область	Государственные, муниципальные (без учета организаций в ведении ФСИН); Очная	"    в том числе:
    переведено на другие формы обучения данной
    организации на программы того же уровня / 7.0"	26	0	0	15	41	0	0	0	0	0	49	0	0	30	79	0	0	0	2	2
Ленинградская область	Государственные, муниципальные (без учета организаций в ведении ФСИН); Очная	"    в том числе:
    переведено с других форм обучения данной
    образовательной организации с программ того же уровня / 2.0"	39	0	0	1	40	0	0	0	0	0	48	0	0	24	72	2	0	0	0	2
Ленинградская область	Государственные, муниципальные (без учета организаций в ведении ФСИН); Очная	    восстановлены из числа ранее отчисленных / 4.0	33	0	0	0	33	0	0	0	0	0	49	0	1	19	69	13	0	0	3	16
Ленинградская область	Государственные, муниципальные (без учета организаций в ведении ФСИН); Очная	    выбыло по другим причинам / 16.0	140	0	0	15	155	0	0	0	0	0	569	0	0	46	615	5	0	0	9	14
Ленинградская область	Государственные, муниципальные (без учета организаций в ведении ФСИН); Очная	"    добровольно прекратили образовательные отношения
    (бросили учебу) / 10.0"	132	0	0	4	136	0	0	0	0	0	392	0	36	90	518	76	0	20	13	109
Ленинградская область	Государственные, муниципальные (без учета организаций в ведении ФСИН); Очная	"    отчислено:
         по неуспеваемости / 11.0"	139	0	0	2	141	0	0	0	0	0	166	0	8	50	224	33	0	0	7	40
Ленинградская область	Государственные, муниципальные (без учета организаций в ведении ФСИН); Очная	"    переведено в другие образовательные организации
    на программы того же уровня / 8.0"	69	0	0	2	71	0	0	0	0	0	238	0	23	101	362	5	0	3	143	151
Ленинградская область	Государственные, муниципальные (без учета организаций в ведении ФСИН); Очная	"    переведено из других образовательных организаций 
    с программ того же уровня / 3.0"	66	0	0	1	67	0	0	0	0	0	132	0	0	20	152	1	0	0	0	1
Ленинградская область	Государственные, муниципальные (без учета организаций в ведении ФСИН); Очная	    по болезни / 9.0	37	0	0	0	37	0	0	0	0	0	18	0	0	7	25	1	0	0	0	1
Ленинградская область	Государственные, муниципальные (без учета организаций в ведении ФСИН); Очная	    прибыло по другим причинам / 5.0	14	0	0	0	14	0	0	0	0	0	47	0	2	10	59	17	0	0	0	17
Ленинградская область	Государственные, муниципальные (без учета организаций в ведении ФСИН); Очная	Выбыло студентов - всего (сумма стр. 07-11, 13-15) / 6.0	546	0	0	41	587	0	0	0	0	0	1435	0	67	372	1874	120	0	23	178	321
Ленинградская область	Государственные, муниципальные (без учета организаций в ведении ФСИН); Очная	Прибыло студентов - всего (сумма стр. 02-05) / 1.0	152	0	0	2	154	0	0	0	0	0	276	0	3	73	352	33	0	0	3	36
Ленинградская область	Государственные, муниципальные (без учета организаций в ведении ФСИН); Очная	"Численность студентов на начало прошлого учебного года
(на 1 октября) / 17.0"	4648	0	0	150	4798	134	0	0	11	145	12268	0	481	1574	14323	717	0	102	272	1091
Ленинградская область	Очно-заочная; Государственные, муниципальные (без учета организаций в ведении ФСИН)	            из стр. 11 - не прошли итоговую аттестацию / 12.0	0	0	0	0	0	0	0	0	0	0	0	0	0	0	0	0	0	0	0	0
Ленинградская область	Очно-заочная; Государственные, муниципальные (без учета организаций в ведении ФСИН)	"            из стр. 11 – лица с ограниченными возможностями здоровья,
            инвалиды, дети-инвалиды / 13.0"	0	0	0	0	0	0	0	0	0	0	0	0	0	0	0	0	0	0	0	0
Ленинградская область	Очно-заочная; Государственные, муниципальные (без учета организаций в ведении ФСИН)	         отчислено в виде меры дисциплинарного взыскания / 14.0	0	0	0	0	0	0	0	0	0	0	0	0	0	0	0	0	0	0	0	0
Ленинградская область	Очно-заочная; Государственные, муниципальные (без учета организаций в ведении ФСИН)	         отчислено из-за просрочки оплаты обучения / 15.0	0	0	0	0	0	0	0	0	0	0	0	0	0	0	0	0	0	0	0	0
Ленинградская область	Очно-заочная; Государственные, муниципальные (без учета организаций в ведении ФСИН)	"    в том числе:
    переведено на другие формы обучения данной
    организации на программы того же уровня / 7.0"	0	0	0	0	0	0	0	0	0	0	0	0	0	0	0	0	0	0	0	0
Ленинградская область	Очно-заочная; Государственные, муниципальные (без учета организаций в ведении ФСИН)	"    в том числе:
    переведено с других форм обучения данной
    образовательной организации с программ того же уровня / 2.0"	0	0	0	0	0	0	0	0	0	0	0	0	0	0	0	0	0	0	0	0
Ленинградская область	Очно-заочная; Государственные, муниципальные (без учета организаций в ведении ФСИН)	    восстановлены из числа ранее отчисленных / 4.0	0	0	0	0	0	0	0	0	0	0	0	0	0	0	0	0	0	0	0	0
Ленинградская область	Очно-заочная; Государственные, муниципальные (без учета организаций в ведении ФСИН)	    выбыло по другим причинам / 16.0	0	0	0	0	0	0	0	0	0	0	0	0	0	0	0	0	0	0	0	0
Ленинградская область	Очно-заочная; Государственные, муниципальные (без учета организаций в ведении ФСИН)	"    добровольно прекратили образовательные отношения
    (бросили учебу) / 10.0"	0	0	0	0	0	0	0	0	0	0	0	0	0	0	0	0	0	0	0	0
Ленинградская область	Очно-заочная; Государственные, муниципальные (без учета организаций в ведении ФСИН)	"    отчислено:
         по неуспеваемости / 11.0"	0	0	0	0	0	0	0	0	0	0	0	0	0	0	0	0	0	0	0	0
Ленинградская область	Очно-заочная; Государственные, муниципальные (без учета организаций в ведении ФСИН)	"    переведено в другие образовательные организации
    на программы того же уровня / 8.0"	0	0	0	0	0	0	0	0	0	0	0	0	0	0	0	0	0	0	0	0
Ленинградская область	Очно-заочная; Государственные, муниципальные (без учета организаций в ведении ФСИН)	"    переведено из других образовательных организаций 
    с программ того же уровня / 3.0"	0	0	0	0	0	0	0	0	0	0	0	0	0	0	0	0	0	0	0	0
Ленинградская область	Очно-заочная; Государственные, муниципальные (без учета организаций в ведении ФСИН)	    по болезни / 9.0	0	0	0	0	0	0	0	0	0	0	0	0	0	0	0	0	0	0	0	0
Ленинградская область	Очно-заочная; Государственные, муниципальные (без учета организаций в ведении ФСИН)	    прибыло по другим причинам / 5.0	0	0	0	0	0	0	0	0	0	0	0	0	0	0	0	0	0	0	0	0
Ленинградская область	Очно-заочная; Государственные, муниципальные (без учета организаций в ведении ФСИН)	Выбыло студентов - всего (сумма стр. 07-11, 13-15) / 6.0	0	0	0	0	0	0	0	0	0	0	0	0	0	0	0	0	0	0	0	0
Ленинградская область	Очно-заочная; Государственные, муниципальные (без учета организаций в ведении ФСИН)	Прибыло студентов - всего (сумма стр. 02-05) / 1.0	0	0	0	0	0	0	0	0	0	0	0	0	0	0	0	0	0	0	0	0
Ленинградская область	Очно-заочная; Государственные, муниципальные (без учета организаций в ведении ФСИН)	"Численность студентов на начало прошлого учебного года
(на 1 октября) / 17.0"	0	0	0	0	0	0	0	0	0	0	0	0	0	0	0	0	0	0	38	38
Ленинградская область	Частные; Заочная	            из стр. 11 - не прошли итоговую аттестацию / 12.0	0	0	0	0	0	0	0	0	0	0	0	0	0	0	0	0	0	0	0	0
Ленинградская область	Частные; Заочная	"            из стр. 11 – лица с ограниченными возможностями здоровья,
            инвалиды, дети-инвалиды / 13.0"	0	0	0	0	0	0	0	0	0	0	0	0	0	0	0	0	0	0	0	0
Ленинградская область	Частные; Заочная	         отчислено в виде меры дисциплинарного взыскания / 14.0	0	0	0	0	0	0	0	0	0	0	0	0	0	0	0	0	0	0	0	0
Ленинградская область	Частные; Заочная	         отчислено из-за просрочки оплаты обучения / 15.0	0	0	0	0	0	0	0	0	0	0	0	0	0	0	0	0	0	0	7	7
Ленинградская область	Частные; Заочная	"    в том числе:
    переведено на другие формы обучения данной
    организации на программы того же уровня / 7.0"	0	0	0	0	0	0	0	0	0	0	0	0	0	0	0	0	0	0	0	0
Ленинградская область	Частные; Заочная	"    в том числе:
    переведено с других форм обучения данной
    образовательной организации с программ того же уровня / 2.0"	0	0	0	0	0	0	0	0	0	0	0	0	0	0	0	0	0	0	0	0
Ленинградская область	Частные; Заочная	    восстановлены из числа ранее отчисленных / 4.0	0	0	0	0	0	0	0	0	0	0	0	0	0	0	0	0	0	0	0	0
Ленинградская область	Частные; Заочная	    выбыло по другим причинам / 16.0	0	0	0	0	0	0	0	0	0	0	0	0	0	0	0	0	0	0	0	0
Ленинградская область	Частные; Заочная	"    добровольно прекратили образовательные отношения
    (бросили учебу) / 10.0"	0	0	0	0	0	0	0	0	0	0	0	0	0	0	0	0	0	0	0	0
Ленинградская область	Частные; Заочная	"    отчислено:
         по неуспеваемости / 11.0"	0	0	0	0	0	0	0	0	0	0	0	0	0	0	0	0	0	0	0	0
Ленинградская область	Частные; Заочная	"    переведено в другие образовательные организации
    на программы того же уровня / 8.0"	0	0	0	0	0	0	0	0	0	0	0	0	0	0	0	0	0	0	0	0
Ленинградская область	Частные; Заочная	"    переведено из других образовательных организаций 
    с программ того же уровня / 3.0"	0	0	0	0	0	0	0	0	0	0	0	0	0	0	0	0	0	0	0	0
Ленинградская область	Частные; Заочная	    по болезни / 9.0	0	0	0	0	0	0	0	0	0	0	0	0	0	0	0	0	0	0	0	0
Ленинградская область	Частные; Заочная	    прибыло по другим причинам / 5.0	0	0	0	0	0	0	0	0	0	0	0	0	0	0	0	0	0	0	0	0
Ленинградская область	Частные; Заочная	Выбыло студентов - всего (сумма стр. 07-11, 13-15) / 6.0	0	0	0	0	0	0	0	0	0	0	0	0	0	0	0	0	0	0	7	7
Ленинградская область	Частные; Заочная	Прибыло студентов - всего (сумма стр. 02-05) / 1.0	0	0	0	0	0	0	0	0	0	0	0	0	0	0	0	0	0	0	0	0
Ленинградская область	Частные; Заочная	"Численность студентов на начало прошлого учебного года
(на 1 октября) / 17.0"	0	0	0	0	0	0	0	0	0	0	0	0	0	0	0	0	0	0	30	30
Ленинградская область	Частные; Очная	            из стр. 11 - не прошли итоговую аттестацию / 12.0	0	0	0	0	0	0	0	0	0	0	0	0	0	0	0	0	0	0	0	0
Ленинградская область	Частные; Очная	"            из стр. 11 – лица с ограниченными возможностями здоровья,
            инвалиды, дети-инвалиды / 13.0"	0	0	0	0	0	0	0	0	0	0	0	0	0	0	0	0	0	0	0	0
Ленинградская область	Частные; Очная	         отчислено в виде меры дисциплинарного взыскания / 14.0	0	0	0	0	0	0	0	0	0	0	0	0	0	0	0	0	0	0	0	0
Ленинградская область	Частные; Очная	         отчислено из-за просрочки оплаты обучения / 15.0	0	0	0	0	0	0	0	0	0	0	0	0	0	16	16	0	0	0	0	0
Ленинградская область	Частные; Очная	"    в том числе:
    переведено на другие формы обучения данной
    организации на программы того же уровня / 7.0"	0	0	0	0	0	0	0	0	0	0	0	0	0	1	1	0	0	0	0	0
Ленинградская область	Частные; Очная	"    в том числе:
    переведено с других форм обучения данной
    образовательной организации с программ того же уровня / 2.0"	0	0	0	0	0	0	0	0	0	0	0	0	0	1	1	0	0	0	0	0
Ленинградская область	Частные; Очная	    восстановлены из числа ранее отчисленных / 4.0	0	0	0	0	0	0	0	0	0	0	0	0	0	1	1	0	0	0	0	0
Ленинградская область	Частные; Очная	    выбыло по другим причинам / 16.0	0	0	0	0	0	0	0	0	0	0	0	0	0	0	0	0	0	0	0	0
Ленинградская область	Частные; Очная	"    добровольно прекратили образовательные отношения
    (бросили учебу) / 10.0"	0	0	0	0	0	0	0	0	0	0	0	0	0	2	2	0	0	0	0	0
Ленинградская область	Частные; Очная	"    отчислено:
         по неуспеваемости / 11.0"	0	0	0	0	0	0	0	0	0	0	0	0	0	0	0	0	0	0	0	0
Ленинградская область	Частные; Очная	"    переведено в другие образовательные организации
    на программы того же уровня / 8.0"	0	0	0	0	0	0	0	0	0	0	0	0	0	3	3	0	0	0	0	0
Ленинградская область	Частные; Очная	"    переведено из других образовательных организаций 
    с программ того же уровня / 3.0"	0	0	0	0	0	0	0	0	0	0	0	0	0	0	0	0	0	0	0	0
Ленинградская область	Частные; Очная	    по болезни / 9.0	0	0	0	0	0	0	0	0	0	0	0	0	0	0	0	0	0	0	0	0
Ленинградская область	Частные; Очная	    прибыло по другим причинам / 5.0	0	0	0	0	0	0	0	0	0	0	0	0	0	4	4	0	0	0	0	0
Ленинградская область	Частные; Очная	Выбыло студентов - всего (сумма стр. 07-11, 13-15) / 6.0	0	0	0	0	0	0	0	0	0	0	0	0	0	22	22	0	0	0	0	0
Ленинградская область	Частные; Очная	Прибыло студентов - всего (сумма стр. 02-05) / 1.0	0	0	0	0	0	0	0	0	0	0	0	0	0	6	6	0	0	0	0	0
Ленинградская область	Частные; Очная	"Численность студентов на начало прошлого учебного года
(на 1 октября) / 17.0"	0	0	0	0	0	0	0	0	0	0	0	0	0	299	299	0	0	0	0	0
Липецкая область	Государственные, муниципальные (без учета организаций в ведении ФСИН); Заочная	            из стр. 11 - не прошли итоговую аттестацию / 12.0	0	0	0	0	0	0	0	0	0	0	0	0	0	0	0	4	0	0	0	4
Липецкая область	Государственные, муниципальные (без учета организаций в ведении ФСИН); Заочная	"            из стр. 11 – лица с ограниченными возможностями здоровья,
            инвалиды, дети-инвалиды / 13.0"	0	0	0	0	0	0	0	0	0	0	0	0	0	0	0	0	0	0	0	0
Липецкая область	Государственные, муниципальные (без учета организаций в ведении ФСИН); Заочная	         отчислено в виде меры дисциплинарного взыскания / 14.0	0	0	0	0	0	0	0	0	0	0	0	0	0	0	0	0	0	0	0	0
Липецкая область	Государственные, муниципальные (без учета организаций в ведении ФСИН); Заочная	         отчислено из-за просрочки оплаты обучения / 15.0	0	0	0	0	0	0	0	0	0	0	0	0	0	19	19	0	0	0	11	11
Липецкая область	Государственные, муниципальные (без учета организаций в ведении ФСИН); Заочная	"    в том числе:
    переведено на другие формы обучения данной
    организации на программы того же уровня / 7.0"	0	0	0	0	0	0	0	0	0	0	0	0	0	3	3	1	0	0	7	8
Липецкая область	Государственные, муниципальные (без учета организаций в ведении ФСИН); Заочная	"    в том числе:
    переведено с других форм обучения данной
    образовательной организации с программ того же уровня / 2.0"	0	0	0	0	0	0	0	0	0	0	0	0	0	33	33	16	0	0	3	19
Липецкая область	Государственные, муниципальные (без учета организаций в ведении ФСИН); Заочная	    восстановлены из числа ранее отчисленных / 4.0	0	0	0	0	0	0	0	0	0	0	0	0	0	7	7	10	0	0	7	17
Липецкая область	Государственные, муниципальные (без учета организаций в ведении ФСИН); Заочная	    выбыло по другим причинам / 16.0	0	0	0	0	0	0	0	0	0	0	0	0	0	12	12	11	0	0	11	22
Липецкая область	Государственные, муниципальные (без учета организаций в ведении ФСИН); Заочная	"    добровольно прекратили образовательные отношения
    (бросили учебу) / 10.0"	0	0	0	0	0	0	0	0	0	0	0	0	0	18	18	79	0	0	16	95
Липецкая область	Государственные, муниципальные (без учета организаций в ведении ФСИН); Заочная	"    отчислено:
         по неуспеваемости / 11.0"	0	0	0	0	0	0	0	0	0	0	0	0	0	13	13	55	0	0	14	69
Липецкая область	Государственные, муниципальные (без учета организаций в ведении ФСИН); Заочная	"    переведено в другие образовательные организации
    на программы того же уровня / 8.0"	0	0	0	0	0	0	0	0	0	0	0	0	0	0	0	0	0	0	0	0
Липецкая область	Государственные, муниципальные (без учета организаций в ведении ФСИН); Заочная	"    переведено из других образовательных организаций 
    с программ того же уровня / 3.0"	0	0	0	0	0	0	0	0	0	0	0	0	0	6	6	0	0	0	0	0
Липецкая область	Государственные, муниципальные (без учета организаций в ведении ФСИН); Заочная	    по болезни / 9.0	0	0	0	0	0	0	0	0	0	0	0	0	0	0	0	0	0	0	1	1
Липецкая область	Государственные, муниципальные (без учета организаций в ведении ФСИН); Заочная	    прибыло по другим причинам / 5.0	0	0	0	0	0	0	0	0	0	0	0	0	0	17	17	12	0	0	4	16
Липецкая область	Государственные, муниципальные (без учета организаций в ведении ФСИН); Заочная	Выбыло студентов - всего (сумма стр. 07-11, 13-15) / 6.0	0	0	0	0	0	0	0	0	0	0	0	0	0	65	65	146	0	0	60	206
Липецкая область	Государственные, муниципальные (без учета организаций в ведении ФСИН); Заочная	Прибыло студентов - всего (сумма стр. 02-05) / 1.0	0	0	0	0	0	0	0	0	0	0	0	0	0	63	63	38	0	0	14	52
Липецкая область	Государственные, муниципальные (без учета организаций в ведении ФСИН); Заочная	"Численность студентов на начало прошлого учебного года
(на 1 октября) / 17.0"	0	0	0	0	0	0	0	0	0	0	25	0	2	265	292	1654	0	7	392	2053
Липецкая область	Государственные, муниципальные (без учета организаций в ведении ФСИН); Очная	            из стр. 11 - не прошли итоговую аттестацию / 12.0	8	0	0	0	8	0	0	0	0	0	0	0	0	0	0	0	0	0	0	0
Липецкая область	Государственные, муниципальные (без учета организаций в ведении ФСИН); Очная	"            из стр. 11 – лица с ограниченными возможностями здоровья,
            инвалиды, дети-инвалиды / 13.0"	4	0	0	0	4	0	0	0	0	0	1	0	1	1	3	0	0	0	0	0
Липецкая область	Государственные, муниципальные (без учета организаций в ведении ФСИН); Очная	         отчислено в виде меры дисциплинарного взыскания / 14.0	0	0	0	0	0	0	0	0	0	0	1	0	1	2	4	1	0	0	0	1
Липецкая область	Государственные, муниципальные (без учета организаций в ведении ФСИН); Очная	         отчислено из-за просрочки оплаты обучения / 15.0	0	0	0	0	0	0	0	0	0	0	0	0	0	19	19	0	0	0	2	2
Липецкая область	Государственные, муниципальные (без учета организаций в ведении ФСИН); Очная	"    в том числе:
    переведено на другие формы обучения данной
    организации на программы того же уровня / 7.0"	1	0	0	0	1	0	0	0	0	0	38	0	0	25	63	0	0	0	6	6
Липецкая область	Государственные, муниципальные (без учета организаций в ведении ФСИН); Очная	"    в том числе:
    переведено с других форм обучения данной
    образовательной организации с программ того же уровня / 2.0"	2	0	0	0	2	0	0	0	0	0	6	0	0	6	12	2	0	0	0	2
Липецкая область	Государственные, муниципальные (без учета организаций в ведении ФСИН); Очная	    восстановлены из числа ранее отчисленных / 4.0	19	0	0	3	22	0	0	0	0	0	30	0	1	19	50	0	0	0	0	0
Липецкая область	Государственные, муниципальные (без учета организаций в ведении ФСИН); Очная	    выбыло по другим причинам / 16.0	13	0	0	0	13	0	0	0	0	0	58	0	17	63	138	2	0	0	8	10
Липецкая область	Государственные, муниципальные (без учета организаций в ведении ФСИН); Очная	"    добровольно прекратили образовательные отношения
    (бросили учебу) / 10.0"	267	0	0	33	300	4	0	0	0	4	411	0	28	151	590	33	0	0	18	51
Липецкая область	Государственные, муниципальные (без учета организаций в ведении ФСИН); Очная	"    отчислено:
         по неуспеваемости / 11.0"	69	0	0	4	73	3	0	0	0	3	70	0	26	44	140	5	0	0	5	10
Липецкая область	Государственные, муниципальные (без учета организаций в ведении ФСИН); Очная	"    переведено в другие образовательные организации
    на программы того же уровня / 8.0"	21	0	0	6	27	0	0	0	0	0	75	0	15	48	138	6	0	0	0	6
Липецкая область	Государственные, муниципальные (без учета организаций в ведении ФСИН); Очная	"    переведено из других образовательных организаций 
    с программ того же уровня / 3.0"	32	0	0	2	34	0	0	0	0	0	68	0	3	39	110	0	0	0	0	0
Липецкая область	Государственные, муниципальные (без учета организаций в ведении ФСИН); Очная	    по болезни / 9.0	61	0	0	1	62	0	0	0	0	0	0	0	0	0	0	0	0	0	0	0
Липецкая область	Государственные, муниципальные (без учета организаций в ведении ФСИН); Очная	    прибыло по другим причинам / 5.0	69	0	0	9	78	8	0	0	0	8	73	0	0	35	108	0	0	0	1	1
Липецкая область	Государственные, муниципальные (без учета организаций в ведении ФСИН); Очная	Выбыло студентов - всего (сумма стр. 07-11, 13-15) / 6.0	432	0	0	44	476	7	0	0	0	7	653	0	87	352	1092	47	0	0	39	86
Липецкая область	Государственные, муниципальные (без учета организаций в ведении ФСИН); Очная	Прибыло студентов - всего (сумма стр. 02-05) / 1.0	122	0	0	14	136	8	0	0	0	8	177	0	4	99	280	2	0	0	1	3
Липецкая область	Государственные, муниципальные (без учета организаций в ведении ФСИН); Очная	"Численность студентов на начало прошлого учебного года
(на 1 октября) / 17.0"	5045	0	0	415	5460	88	0	0	0	88	10883	0	1750	4327	16960	546	36	29	360	971
Липецкая область	Очно-заочная; Государственные, муниципальные (без учета организаций в ведении ФСИН)	            из стр. 11 - не прошли итоговую аттестацию / 12.0	0	0	0	0	0	0	0	0	0	0	0	0	0	0	0	0	0	0	0	0
Липецкая область	Очно-заочная; Государственные, муниципальные (без учета организаций в ведении ФСИН)	"            из стр. 11 – лица с ограниченными возможностями здоровья,
            инвалиды, дети-инвалиды / 13.0"	0	0	0	0	0	0	0	0	0	0	0	0	0	0	0	0	0	0	0	0
Липецкая область	Очно-заочная; Государственные, муниципальные (без учета организаций в ведении ФСИН)	         отчислено в виде меры дисциплинарного взыскания / 14.0	0	0	0	0	0	0	0	0	0	0	0	0	0	0	0	0	0	0	0	0
Липецкая область	Очно-заочная; Государственные, муниципальные (без учета организаций в ведении ФСИН)	         отчислено из-за просрочки оплаты обучения / 15.0	0	0	0	0	0	0	0	0	0	0	0	0	0	0	0	0	0	0	2	2
Липецкая область	Очно-заочная; Государственные, муниципальные (без учета организаций в ведении ФСИН)	"    в том числе:
    переведено на другие формы обучения данной
    организации на программы того же уровня / 7.0"	0	0	0	0	0	0	0	0	0	0	0	0	0	0	0	0	0	0	0	0
Липецкая область	Очно-заочная; Государственные, муниципальные (без учета организаций в ведении ФСИН)	"    в том числе:
    переведено с других форм обучения данной
    образовательной организации с программ того же уровня / 2.0"	0	0	0	0	0	0	0	0	0	0	0	0	0	0	0	0	0	0	0	0
Липецкая область	Очно-заочная; Государственные, муниципальные (без учета организаций в ведении ФСИН)	    восстановлены из числа ранее отчисленных / 4.0	0	0	0	0	0	0	0	0	0	0	0	0	0	0	0	0	0	0	2	2
Липецкая область	Очно-заочная; Государственные, муниципальные (без учета организаций в ведении ФСИН)	    выбыло по другим причинам / 16.0	0	0	0	0	0	0	0	0	0	0	0	0	0	0	0	0	0	0	0	0
Липецкая область	Очно-заочная; Государственные, муниципальные (без учета организаций в ведении ФСИН)	"    добровольно прекратили образовательные отношения
    (бросили учебу) / 10.0"	0	0	0	0	0	0	0	0	0	0	0	0	0	0	0	0	0	0	17	17
Липецкая область	Очно-заочная; Государственные, муниципальные (без учета организаций в ведении ФСИН)	"    отчислено:
         по неуспеваемости / 11.0"	0	0	0	0	0	0	0	0	0	0	0	0	0	0	0	0	0	0	1	1
Липецкая область	Очно-заочная; Государственные, муниципальные (без учета организаций в ведении ФСИН)	"    переведено в другие образовательные организации
    на программы того же уровня / 8.0"	0	0	0	0	0	0	0	0	0	0	0	0	0	0	0	0	0	0	1	1
Липецкая область	Очно-заочная; Государственные, муниципальные (без учета организаций в ведении ФСИН)	"    переведено из других образовательных организаций 
    с программ того же уровня / 3.0"	0	0	0	0	0	0	0	0	0	0	0	0	0	0	0	0	0	0	0	0
Липецкая область	Очно-заочная; Государственные, муниципальные (без учета организаций в ведении ФСИН)	    по болезни / 9.0	0	0	0	0	0	0	0	0	0	0	0	0	0	0	0	0	0	0	0	0
Липецкая область	Очно-заочная; Государственные, муниципальные (без учета организаций в ведении ФСИН)	    прибыло по другим причинам / 5.0	0	0	0	0	0	0	0	0	0	0	0	0	0	0	0	0	0	0	8	8
Липецкая область	Очно-заочная; Государственные, муниципальные (без учета организаций в ведении ФСИН)	Выбыло студентов - всего (сумма стр. 07-11, 13-15) / 6.0	0	0	0	0	0	0	0	0	0	0	0	0	0	0	0	0	0	0	21	21
Липецкая область	Очно-заочная; Государственные, муниципальные (без учета организаций в ведении ФСИН)	Прибыло студентов - всего (сумма стр. 02-05) / 1.0	0	0	0	0	0	0	0	0	0	0	0	0	0	0	0	0	0	0	10	10
Липецкая область	Очно-заочная; Государственные, муниципальные (без учета организаций в ведении ФСИН)	"Численность студентов на начало прошлого учебного года
(на 1 октября) / 17.0"	0	0	0	0	0	0	0	0	0	0	0	0	0	8	8	0	0	0	446	446
Липецкая область	Частные; Заочная	            из стр. 11 - не прошли итоговую аттестацию / 12.0	0	0	0	0	0	0	0	0	0	0	0	0	0	0	0	0	0	0	0	0
Липецкая область	Частные; Заочная	"            из стр. 11 – лица с ограниченными возможностями здоровья,
            инвалиды, дети-инвалиды / 13.0"	0	0	0	0	0	0	0	0	0	0	0	0	0	0	0	0	0	0	0	0
Липецкая область	Частные; Заочная	         отчислено в виде меры дисциплинарного взыскания / 14.0	0	0	0	0	0	0	0	0	0	0	0	0	0	0	0	0	0	0	0	0
Липецкая область	Частные; Заочная	         отчислено из-за просрочки оплаты обучения / 15.0	0	0	0	0	0	0	0	0	0	0	0	0	0	4	4	0	0	0	3	3
Липецкая область	Частные; Заочная	"    в том числе:
    переведено на другие формы обучения данной
    организации на программы того же уровня / 7.0"	0	0	0	0	0	0	0	0	0	0	0	0	0	25	25	0	0	0	1	1
Липецкая область	Частные; Заочная	"    в том числе:
    переведено с других форм обучения данной
    образовательной организации с программ того же уровня / 2.0"	0	0	0	0	0	0	0	0	0	0	0	0	0	6	6	0	0	0	2	2
Липецкая область	Частные; Заочная	    восстановлены из числа ранее отчисленных / 4.0	0	0	0	0	0	0	0	0	0	0	0	0	0	0	0	0	0	0	0	0
Липецкая область	Частные; Заочная	    выбыло по другим причинам / 16.0	0	0	0	0	0	0	0	0	0	0	0	0	0	2	2	0	0	0	2	2
Липецкая область	Частные; Заочная	"    добровольно прекратили образовательные отношения
    (бросили учебу) / 10.0"	0	0	0	0	0	0	0	0	0	0	0	0	0	2	2	0	0	0	1	1
Липецкая область	Частные; Заочная	"    отчислено:
         по неуспеваемости / 11.0"	0	0	0	0	0	0	0	0	0	0	0	0	0	0	0	0	0	0	0	0
Липецкая область	Частные; Заочная	"    переведено в другие образовательные организации
    на программы того же уровня / 8.0"	0	0	0	0	0	0	0	0	0	0	0	0	0	0	0	0	0	0	0	0
Липецкая область	Частные; Заочная	"    переведено из других образовательных организаций 
    с программ того же уровня / 3.0"	0	0	0	0	0	0	0	0	0	0	0	0	0	0	0	0	0	0	0	0
Липецкая область	Частные; Заочная	    по болезни / 9.0	0	0	0	0	0	0	0	0	0	0	0	0	0	0	0	0	0	0	0	0
Липецкая область	Частные; Заочная	    прибыло по другим причинам / 5.0	0	0	0	0	0	0	0	0	0	0	0	0	0	0	0	0	0	0	0	0
Липецкая область	Частные; Заочная	Выбыло студентов - всего (сумма стр. 07-11, 13-15) / 6.0	0	0	0	0	0	0	0	0	0	0	0	0	0	33	33	0	0	0	7	7
Липецкая область	Частные; Заочная	Прибыло студентов - всего (сумма стр. 02-05) / 1.0	0	0	0	0	0	0	0	0	0	0	0	0	0	6	6	0	0	0	2	2
Липецкая область	Частные; Заочная	"Численность студентов на начало прошлого учебного года
(на 1 октября) / 17.0"	0	0	0	0	0	0	0	0	0	0	0	0	0	61	61	0	0	0	38	38
Липецкая область	Частные; Очная	            из стр. 11 - не прошли итоговую аттестацию / 12.0	0	0	0	0	0	0	0	0	0	0	0	0	0	0	0	0	0	0	0	0
Липецкая область	Частные; Очная	"            из стр. 11 – лица с ограниченными возможностями здоровья,
            инвалиды, дети-инвалиды / 13.0"	0	0	0	0	0	0	0	0	0	0	0	0	0	0	0	0	0	0	0	0
Липецкая область	Частные; Очная	         отчислено в виде меры дисциплинарного взыскания / 14.0	0	0	0	0	0	0	0	0	0	0	0	0	0	0	0	0	0	0	0	0
Липецкая область	Частные; Очная	         отчислено из-за просрочки оплаты обучения / 15.0	0	0	0	0	0	0	0	0	0	0	0	0	0	13	13	0	0	0	3	3
Липецкая область	Частные; Очная	"    в том числе:
    переведено на другие формы обучения данной
    организации на программы того же уровня / 7.0"	0	0	0	0	0	0	0	0	0	0	0	0	0	7	7	0	0	0	1	1
Липецкая область	Частные; Очная	"    в том числе:
    переведено с других форм обучения данной
    образовательной организации с программ того же уровня / 2.0"	0	0	0	0	0	0	0	0	0	0	0	0	0	25	25	0	0	0	1	1
Липецкая область	Частные; Очная	    восстановлены из числа ранее отчисленных / 4.0	0	0	0	0	0	0	0	0	0	0	0	0	0	5	5	0	0	0	0	0
Липецкая область	Частные; Очная	    выбыло по другим причинам / 16.0	0	0	0	0	0	0	0	0	0	0	0	0	0	3	3	0	0	0	2	2
Липецкая область	Частные; Очная	"    добровольно прекратили образовательные отношения
    (бросили учебу) / 10.0"	0	0	0	0	0	0	0	0	0	0	0	0	0	3	3	0	0	0	4	4
Липецкая область	Частные; Очная	"    отчислено:
         по неуспеваемости / 11.0"	0	0	0	0	0	0	0	0	0	0	0	0	0	6	6	0	0	0	0	0
Липецкая область	Частные; Очная	"    переведено в другие образовательные организации
    на программы того же уровня / 8.0"	0	0	0	0	0	0	0	0	0	0	0	0	0	1	1	0	0	0	1	1
Липецкая область	Частные; Очная	"    переведено из других образовательных организаций 
    с программ того же уровня / 3.0"	0	0	0	0	0	0	0	0	0	0	0	0	0	1	1	0	0	0	1	1
Липецкая область	Частные; Очная	    по болезни / 9.0	0	0	0	0	0	0	0	0	0	0	0	0	0	0	0	0	0	0	0	0
Липецкая область	Частные; Очная	    прибыло по другим причинам / 5.0	0	0	0	0	0	0	0	0	0	0	0	0	0	0	0	0	0	0	0	0
Липецкая область	Частные; Очная	Выбыло студентов - всего (сумма стр. 07-11, 13-15) / 6.0	0	0	0	0	0	0	0	0	0	0	0	0	0	33	33	0	0	0	11	11
Липецкая область	Частные; Очная	Прибыло студентов - всего (сумма стр. 02-05) / 1.0	0	0	0	0	0	0	0	0	0	0	0	0	0	31	31	0	0	0	2	2
Липецкая область	Частные; Очная	"Численность студентов на начало прошлого учебного года
(на 1 октября) / 17.0"	0	0	0	0	0	0	0	0	0	0	0	0	0	581	581	0	0	0	151	151
Магаданская область	Государственные, муниципальные (без учета организаций в ведении ФСИН); Заочная	            из стр. 11 - не прошли итоговую аттестацию / 12.0	0	0	0	0	0	0	0	0	0	0	0	0	0	0	0	0	0	0	0	0
Магаданская область	Государственные, муниципальные (без учета организаций в ведении ФСИН); Заочная	"            из стр. 11 – лица с ограниченными возможностями здоровья,
            инвалиды, дети-инвалиды / 13.0"	0	0	0	0	0	0	0	0	0	0	0	0	0	0	0	0	0	0	0	0
Магаданская область	Государственные, муниципальные (без учета организаций в ведении ФСИН); Заочная	         отчислено в виде меры дисциплинарного взыскания / 14.0	0	0	0	0	0	0	0	0	0	0	0	0	0	0	0	5	0	0	0	5
Магаданская область	Государственные, муниципальные (без учета организаций в ведении ФСИН); Заочная	         отчислено из-за просрочки оплаты обучения / 15.0	0	0	0	0	0	0	0	0	0	0	0	0	0	0	0	0	0	0	1	1
Магаданская область	Государственные, муниципальные (без учета организаций в ведении ФСИН); Заочная	"    в том числе:
    переведено на другие формы обучения данной
    организации на программы того же уровня / 7.0"	0	0	0	0	0	0	0	0	0	0	0	0	0	0	0	8	0	0	1	9
Магаданская область	Государственные, муниципальные (без учета организаций в ведении ФСИН); Заочная	"    в том числе:
    переведено с других форм обучения данной
    образовательной организации с программ того же уровня / 2.0"	0	0	0	0	0	0	0	0	0	0	0	0	0	0	0	22	0	0	4	26
Магаданская область	Государственные, муниципальные (без учета организаций в ведении ФСИН); Заочная	    восстановлены из числа ранее отчисленных / 4.0	0	0	0	0	0	0	0	0	0	0	0	0	0	0	0	13	0	0	1	14
Магаданская область	Государственные, муниципальные (без учета организаций в ведении ФСИН); Заочная	    выбыло по другим причинам / 16.0	0	0	0	0	0	0	0	0	0	0	0	0	0	0	0	17	0	0	4	21
Магаданская область	Государственные, муниципальные (без учета организаций в ведении ФСИН); Заочная	"    добровольно прекратили образовательные отношения
    (бросили учебу) / 10.0"	0	0	0	0	0	0	0	0	0	0	0	0	0	0	0	28	0	0	3	31
Магаданская область	Государственные, муниципальные (без учета организаций в ведении ФСИН); Заочная	"    отчислено:
         по неуспеваемости / 11.0"	0	0	0	0	0	0	0	0	0	0	0	0	0	0	0	79	0	0	3	82
Магаданская область	Государственные, муниципальные (без учета организаций в ведении ФСИН); Заочная	"    переведено в другие образовательные организации
    на программы того же уровня / 8.0"	0	0	0	0	0	0	0	0	0	0	0	0	0	0	0	1	0	0	1	2
Магаданская область	Государственные, муниципальные (без учета организаций в ведении ФСИН); Заочная	"    переведено из других образовательных организаций 
    с программ того же уровня / 3.0"	0	0	0	0	0	0	0	0	0	0	0	0	0	0	0	4	0	0	0	4
Магаданская область	Государственные, муниципальные (без учета организаций в ведении ФСИН); Заочная	    по болезни / 9.0	0	0	0	0	0	0	0	0	0	0	0	0	0	0	0	0	0	0	0	0
Магаданская область	Государственные, муниципальные (без учета организаций в ведении ФСИН); Заочная	    прибыло по другим причинам / 5.0	0	0	0	0	0	0	0	0	0	0	0	0	0	0	0	111	0	0	4	115
Магаданская область	Государственные, муниципальные (без учета организаций в ведении ФСИН); Заочная	Выбыло студентов - всего (сумма стр. 07-11, 13-15) / 6.0	0	0	0	0	0	0	0	0	0	0	0	0	0	0	0	138	0	0	13	151
Магаданская область	Государственные, муниципальные (без учета организаций в ведении ФСИН); Заочная	Прибыло студентов - всего (сумма стр. 02-05) / 1.0	0	0	0	0	0	0	0	0	0	0	0	0	0	0	0	150	0	0	9	159
Магаданская область	Государственные, муниципальные (без учета организаций в ведении ФСИН); Заочная	"Численность студентов на начало прошлого учебного года
(на 1 октября) / 17.0"	0	0	0	0	0	0	0	0	0	0	0	0	0	0	0	741	0	0	68	809
Магаданская область	Государственные, муниципальные (без учета организаций в ведении ФСИН); Очная	            из стр. 11 - не прошли итоговую аттестацию / 12.0	3	0	0	0	3	0	0	0	0	0	1	0	0	0	1	0	0	0	0	0
Магаданская область	Государственные, муниципальные (без учета организаций в ведении ФСИН); Очная	"            из стр. 11 – лица с ограниченными возможностями здоровья,
            инвалиды, дети-инвалиды / 13.0"	0	0	0	0	0	0	0	0	0	0	1	0	0	0	1	0	0	0	0	0
Магаданская область	Государственные, муниципальные (без учета организаций в ведении ФСИН); Очная	         отчислено в виде меры дисциплинарного взыскания / 14.0	0	0	0	0	0	0	0	0	0	0	14	0	0	1	15	5	0	0	0	5
Магаданская область	Государственные, муниципальные (без учета организаций в ведении ФСИН); Очная	         отчислено из-за просрочки оплаты обучения / 15.0	0	0	0	0	0	0	0	0	0	0	0	0	0	0	0	0	0	0	1	1
Магаданская область	Государственные, муниципальные (без учета организаций в ведении ФСИН); Очная	"    в том числе:
    переведено на другие формы обучения данной
    организации на программы того же уровня / 7.0"	1	0	0	0	1	0	0	0	0	0	25	0	0	0	25	1	0	0	5	6
Магаданская область	Государственные, муниципальные (без учета организаций в ведении ФСИН); Очная	"    в том числе:
    переведено с других форм обучения данной
    образовательной организации с программ того же уровня / 2.0"	3	0	0	0	3	0	0	0	0	0	2	0	0	1	3	7	0	0	0	7
Магаданская область	Государственные, муниципальные (без учета организаций в ведении ФСИН); Очная	    восстановлены из числа ранее отчисленных / 4.0	21	0	0	0	21	0	0	0	0	0	16	3	0	3	22	1	0	0	0	1
Магаданская область	Государственные, муниципальные (без учета организаций в ведении ФСИН); Очная	    выбыло по другим причинам / 16.0	15	0	0	0	15	0	0	0	0	0	6	0	0	0	6	14	0	0	4	18
Магаданская область	Государственные, муниципальные (без учета организаций в ведении ФСИН); Очная	"    добровольно прекратили образовательные отношения
    (бросили учебу) / 10.0"	66	0	1	0	67	0	0	0	0	0	151	0	0	18	169	45	0	0	3	48
Магаданская область	Государственные, муниципальные (без учета организаций в ведении ФСИН); Очная	"    отчислено:
         по неуспеваемости / 11.0"	52	0	0	0	52	0	0	0	0	0	51	0	0	0	51	1	0	0	0	1
Магаданская область	Государственные, муниципальные (без учета организаций в ведении ФСИН); Очная	"    переведено в другие образовательные организации
    на программы того же уровня / 8.0"	11	0	0	0	11	0	0	0	0	0	30	0	0	0	30	0	0	0	1	1
Магаданская область	Государственные, муниципальные (без учета организаций в ведении ФСИН); Очная	"    переведено из других образовательных организаций 
    с программ того же уровня / 3.0"	9	0	1	0	10	0	0	0	0	0	17	12	0	0	29	1	0	0	0	1
Магаданская область	Государственные, муниципальные (без учета организаций в ведении ФСИН); Очная	    по болезни / 9.0	0	0	0	0	0	0	0	0	0	0	0	0	0	0	0	0	0	0	0	0
Магаданская область	Государственные, муниципальные (без учета организаций в ведении ФСИН); Очная	    прибыло по другим причинам / 5.0	4	0	0	0	4	0	0	0	0	0	5	11	0	0	16	3	0	0	0	3
Магаданская область	Государственные, муниципальные (без учета организаций в ведении ФСИН); Очная	Выбыло студентов - всего (сумма стр. 07-11, 13-15) / 6.0	145	0	1	0	146	0	0	0	0	0	277	0	0	19	296	66	0	0	14	80
Магаданская область	Государственные, муниципальные (без учета организаций в ведении ФСИН); Очная	Прибыло студентов - всего (сумма стр. 02-05) / 1.0	37	0	1	0	38	0	0	0	0	0	40	26	0	4	70	12	0	0	0	12
Магаданская область	Государственные, муниципальные (без учета организаций в ведении ФСИН); Очная	"Численность студентов на начало прошлого учебного года
(на 1 октября) / 17.0"	938	0	29	4	971	0	0	0	0	0	646	605	201	123	1575	345	0	0	48	393
Магаданская область	Очно-заочная; Государственные, муниципальные (без учета организаций в ведении ФСИН)	            из стр. 11 - не прошли итоговую аттестацию / 12.0	0	0	0	0	0	0	0	0	0	0	0	0	0	0	0	0	0	0	0	0
Магаданская область	Очно-заочная; Государственные, муниципальные (без учета организаций в ведении ФСИН)	"            из стр. 11 – лица с ограниченными возможностями здоровья,
            инвалиды, дети-инвалиды / 13.0"	0	0	0	0	0	0	0	0	0	0	0	0	0	0	0	0	0	0	0	0
Магаданская область	Очно-заочная; Государственные, муниципальные (без учета организаций в ведении ФСИН)	         отчислено в виде меры дисциплинарного взыскания / 14.0	0	0	0	0	0	0	0	0	0	0	0	0	0	0	0	6	0	0	1	7
Магаданская область	Очно-заочная; Государственные, муниципальные (без учета организаций в ведении ФСИН)	         отчислено из-за просрочки оплаты обучения / 15.0	0	0	0	0	0	0	0	0	0	0	0	0	0	0	0	0	0	0	0	0
Магаданская область	Очно-заочная; Государственные, муниципальные (без учета организаций в ведении ФСИН)	"    в том числе:
    переведено на другие формы обучения данной
    организации на программы того же уровня / 7.0"	0	0	0	0	0	0	0	0	0	0	0	0	0	0	0	1	0	0	0	1
Магаданская область	Очно-заочная; Государственные, муниципальные (без учета организаций в ведении ФСИН)	"    в том числе:
    переведено с других форм обучения данной
    образовательной организации с программ того же уровня / 2.0"	0	0	0	0	0	0	0	0	0	0	0	0	0	0	0	1	0	0	0	1
Магаданская область	Очно-заочная; Государственные, муниципальные (без учета организаций в ведении ФСИН)	    восстановлены из числа ранее отчисленных / 4.0	0	0	0	0	0	0	0	0	0	0	0	0	0	0	0	0	0	0	0	0
Магаданская область	Очно-заочная; Государственные, муниципальные (без учета организаций в ведении ФСИН)	    выбыло по другим причинам / 16.0	0	0	0	0	0	0	0	0	0	0	0	0	0	0	0	12	0	0	2	14
Магаданская область	Очно-заочная; Государственные, муниципальные (без учета организаций в ведении ФСИН)	"    добровольно прекратили образовательные отношения
    (бросили учебу) / 10.0"	0	0	0	0	0	0	0	0	0	0	0	0	0	0	0	5	0	0	0	5
Магаданская область	Очно-заочная; Государственные, муниципальные (без учета организаций в ведении ФСИН)	"    отчислено:
         по неуспеваемости / 11.0"	0	0	0	0	0	0	0	0	0	0	0	0	0	0	0	0	0	0	0	0
Магаданская область	Очно-заочная; Государственные, муниципальные (без учета организаций в ведении ФСИН)	"    переведено в другие образовательные организации
    на программы того же уровня / 8.0"	0	0	0	0	0	0	0	0	0	0	0	0	0	0	0	0	0	0	0	0
Магаданская область	Очно-заочная; Государственные, муниципальные (без учета организаций в ведении ФСИН)	"    переведено из других образовательных организаций 
    с программ того же уровня / 3.0"	0	0	0	0	0	0	0	0	0	0	0	0	0	0	0	0	0	0	0	0
Магаданская область	Очно-заочная; Государственные, муниципальные (без учета организаций в ведении ФСИН)	    по болезни / 9.0	0	0	0	0	0	0	0	0	0	0	0	0	0	0	0	0	0	0	0	0
Магаданская область	Очно-заочная; Государственные, муниципальные (без учета организаций в ведении ФСИН)	    прибыло по другим причинам / 5.0	0	0	0	0	0	0	0	0	0	0	0	0	0	0	0	0	0	0	6	6
Магаданская область	Очно-заочная; Государственные, муниципальные (без учета организаций в ведении ФСИН)	Выбыло студентов - всего (сумма стр. 07-11, 13-15) / 6.0	0	0	0	0	0	0	0	0	0	0	0	0	0	0	0	24	0	0	3	27
Магаданская область	Очно-заочная; Государственные, муниципальные (без учета организаций в ведении ФСИН)	Прибыло студентов - всего (сумма стр. 02-05) / 1.0	0	0	0	0	0	0	0	0	0	0	0	0	0	0	0	1	0	0	6	7
Магаданская область	Очно-заочная; Государственные, муниципальные (без учета организаций в ведении ФСИН)	"Численность студентов на начало прошлого учебного года
(на 1 октября) / 17.0"	0	0	0	0	0	0	0	0	0	0	0	0	0	0	0	105	0	0	14	119
Московская область	Государственные, муниципальные (без учета организаций в ведении ФСИН); Заочная	            из стр. 11 - не прошли итоговую аттестацию / 12.0	0	0	0	0	0	0	0	0	0	0	0	0	2	0	2	0	0	4	1	5
Московская область	Государственные, муниципальные (без учета организаций в ведении ФСИН); Заочная	"            из стр. 11 – лица с ограниченными возможностями здоровья,
            инвалиды, дети-инвалиды / 13.0"	0	0	0	0	0	0	0	0	0	0	0	0	0	0	0	0	0	0	0	0
Московская область	Государственные, муниципальные (без учета организаций в ведении ФСИН); Заочная	         отчислено в виде меры дисциплинарного взыскания / 14.0	0	0	0	0	0	0	0	0	0	0	0	0	0	0	0	0	0	0	0	0
Московская область	Государственные, муниципальные (без учета организаций в ведении ФСИН); Заочная	         отчислено из-за просрочки оплаты обучения / 15.0	0	0	0	0	0	0	0	0	0	0	0	0	0	75	75	0	0	0	72	72
Московская область	Государственные, муниципальные (без учета организаций в ведении ФСИН); Заочная	"    в том числе:
    переведено на другие формы обучения данной
    организации на программы того же уровня / 7.0"	0	0	0	0	0	0	0	0	0	0	0	0	2	7	9	0	0	0	22	22
Московская область	Государственные, муниципальные (без учета организаций в ведении ФСИН); Заочная	"    в том числе:
    переведено с других форм обучения данной
    образовательной организации с программ того же уровня / 2.0"	0	0	0	0	0	0	0	0	0	0	1	0	15	26	42	12	0	10	103	125
Московская область	Государственные, муниципальные (без учета организаций в ведении ФСИН); Заочная	    восстановлены из числа ранее отчисленных / 4.0	0	0	0	0	0	0	0	0	0	0	0	0	7	16	23	3	0	2	15	20
Московская область	Государственные, муниципальные (без учета организаций в ведении ФСИН); Заочная	    выбыло по другим причинам / 16.0	0	0	0	0	0	0	0	0	0	0	1	0	26	20	47	16	0	2	50	68
Московская область	Государственные, муниципальные (без учета организаций в ведении ФСИН); Заочная	"    добровольно прекратили образовательные отношения
    (бросили учебу) / 10.0"	0	0	0	0	0	0	0	0	0	0	3	0	33	56	92	40	0	41	106	187
Московская область	Государственные, муниципальные (без учета организаций в ведении ФСИН); Заочная	"    отчислено:
         по неуспеваемости / 11.0"	0	0	0	0	0	0	0	0	0	0	4	0	33	46	83	20	0	24	75	119
Московская область	Государственные, муниципальные (без учета организаций в ведении ФСИН); Заочная	"    переведено в другие образовательные организации
    на программы того же уровня / 8.0"	0	0	0	0	0	0	0	0	0	0	0	0	0	5	5	1	0	0	9	10
Московская область	Государственные, муниципальные (без учета организаций в ведении ФСИН); Заочная	"    переведено из других образовательных организаций 
    с программ того же уровня / 3.0"	0	0	0	0	0	0	0	0	0	0	0	0	0	36	36	7	0	0	16	23
Московская область	Государственные, муниципальные (без учета организаций в ведении ФСИН); Заочная	    по болезни / 9.0	0	0	0	0	0	0	0	0	0	0	0	0	0	0	0	1	0	0	0	1
Московская область	Государственные, муниципальные (без учета организаций в ведении ФСИН); Заочная	    прибыло по другим причинам / 5.0	0	0	0	0	0	0	0	0	0	0	0	0	8	17	25	1	0	0	21	22
Московская область	Государственные, муниципальные (без учета организаций в ведении ФСИН); Заочная	Выбыло студентов - всего (сумма стр. 07-11, 13-15) / 6.0	0	0	0	0	0	0	0	0	0	0	8	0	94	209	311	78	0	67	334	479
Московская область	Государственные, муниципальные (без учета организаций в ведении ФСИН); Заочная	Прибыло студентов - всего (сумма стр. 02-05) / 1.0	0	0	0	0	0	0	0	0	0	0	1	0	30	95	126	23	0	12	155	190
Московская область	Государственные, муниципальные (без учета организаций в ведении ФСИН); Заочная	"Численность студентов на начало прошлого учебного года
(на 1 октября) / 17.0"	0	0	0	0	0	0	0	0	0	0	87	0	387	1164	1638	1093	0	566	2204	3863
Московская область	Государственные, муниципальные (без учета организаций в ведении ФСИН); Очная	            из стр. 11 - не прошли итоговую аттестацию / 12.0	9	0	0	0	9	0	0	0	0	0	24	0	7	8	39	1	0	0	0	1
Московская область	Государственные, муниципальные (без учета организаций в ведении ФСИН); Очная	"            из стр. 11 – лица с ограниченными возможностями здоровья,
            инвалиды, дети-инвалиды / 13.0"	0	0	0	0	0	0	0	0	0	0	1	0	2	1	4	0	0	0	1	1
Московская область	Государственные, муниципальные (без учета организаций в ведении ФСИН); Очная	         отчислено в виде меры дисциплинарного взыскания / 14.0	2	0	0	0	2	0	0	0	0	0	3	0	16	8	27	0	0	2	0	2
Московская область	Государственные, муниципальные (без учета организаций в ведении ФСИН); Очная	         отчислено из-за просрочки оплаты обучения / 15.0	0	0	0	9	9	0	0	0	0	0	0	0	0	168	168	0	0	0	16	16
Московская область	Государственные, муниципальные (без учета организаций в ведении ФСИН); Очная	"    в том числе:
    переведено на другие формы обучения данной
    организации на программы того же уровня / 7.0"	13	0	0	1	14	0	0	0	0	0	128	0	17	213	358	4	0	1	21	26
Московская область	Государственные, муниципальные (без учета организаций в ведении ФСИН); Очная	"    в том числе:
    переведено с других форм обучения данной
    образовательной организации с программ того же уровня / 2.0"	30	2	0	2	34	0	0	0	0	0	146	0	17	72	235	11	0	2	3	16
Московская область	Государственные, муниципальные (без учета организаций в ведении ФСИН); Очная	    восстановлены из числа ранее отчисленных / 4.0	15	0	0	6	21	0	0	0	0	0	84	1	10	112	207	7	0	0	12	19
Московская область	Государственные, муниципальные (без учета организаций в ведении ФСИН); Очная	    выбыло по другим причинам / 16.0	126	10	0	36	172	0	0	0	0	0	348	12	47	262	669	24	0	3	13	40
Московская область	Государственные, муниципальные (без учета организаций в ведении ФСИН); Очная	"    добровольно прекратили образовательные отношения
    (бросили учебу) / 10.0"	279	5	0	52	336	0	0	0	0	0	910	13	242	869	2034	132	0	21	68	221
Московская область	Государственные, муниципальные (без учета организаций в ведении ФСИН); Очная	"    отчислено:
         по неуспеваемости / 11.0"	96	0	0	8	104	0	0	0	0	0	209	0	160	198	567	12	0	7	13	32
Московская область	Государственные, муниципальные (без учета организаций в ведении ФСИН); Очная	"    переведено в другие образовательные организации
    на программы того же уровня / 8.0"	106	8	0	6	120	0	0	0	0	0	306	6	122	251	685	19	0	1	15	35
Московская область	Государственные, муниципальные (без учета организаций в ведении ФСИН); Очная	"    переведено из других образовательных организаций 
    с программ того же уровня / 3.0"	94	0	0	12	106	0	0	0	0	0	294	0	14	233	541	11	0	1	39	51
Московская область	Государственные, муниципальные (без учета организаций в ведении ФСИН); Очная	    по болезни / 9.0	6	0	0	1	7	0	0	0	0	0	23	0	0	9	32	0	0	0	0	0
Московская область	Государственные, муниципальные (без учета организаций в ведении ФСИН); Очная	    прибыло по другим причинам / 5.0	71	0	0	23	94	0	0	0	0	0	209	0	23	333	565	11	0	1	18	30
Московская область	Государственные, муниципальные (без учета организаций в ведении ФСИН); Очная	Выбыло студентов - всего (сумма стр. 07-11, 13-15) / 6.0	628	23	0	113	764	0	0	0	0	0	1927	31	604	1978	4540	191	0	35	146	372
Московская область	Государственные, муниципальные (без учета организаций в ведении ФСИН); Очная	Прибыло студентов - всего (сумма стр. 02-05) / 1.0	210	2	0	43	255	0	0	0	0	0	733	1	64	750	1548	40	0	4	72	116
Московская область	Государственные, муниципальные (без учета организаций в ведении ФСИН); Очная	"Численность студентов на начало прошлого учебного года
(на 1 октября) / 17.0"	17309	656	0	1018	18983	23	0	0	8	31	50290	0	7027	20415	77732	2363	0	234	868	3465
Московская область	Очно-заочная; Государственные, муниципальные (без учета организаций в ведении ФСИН)	            из стр. 11 - не прошли итоговую аттестацию / 12.0	0	0	0	0	0	0	0	0	0	0	0	0	0	2	2	1	0	0	0	1
Московская область	Очно-заочная; Государственные, муниципальные (без учета организаций в ведении ФСИН)	"            из стр. 11 – лица с ограниченными возможностями здоровья,
            инвалиды, дети-инвалиды / 13.0"	0	0	0	0	0	0	0	0	0	0	0	0	0	0	0	0	0	0	0	0
Московская область	Очно-заочная; Государственные, муниципальные (без учета организаций в ведении ФСИН)	         отчислено в виде меры дисциплинарного взыскания / 14.0	0	0	0	0	0	0	0	0	0	0	0	0	0	0	0	0	0	0	0	0
Московская область	Очно-заочная; Государственные, муниципальные (без учета организаций в ведении ФСИН)	         отчислено из-за просрочки оплаты обучения / 15.0	0	0	0	0	0	0	0	0	0	0	0	0	0	26	26	0	0	0	40	40
Московская область	Очно-заочная; Государственные, муниципальные (без учета организаций в ведении ФСИН)	"    в том числе:
    переведено на другие формы обучения данной
    организации на программы того же уровня / 7.0"	0	0	0	0	0	0	0	0	0	0	1	0	0	1	2	5	0	0	3	8
Московская область	Очно-заочная; Государственные, муниципальные (без учета организаций в ведении ФСИН)	"    в том числе:
    переведено с других форм обучения данной
    образовательной организации с программ того же уровня / 2.0"	0	0	0	0	0	0	0	0	0	0	4	0	0	1	5	1	0	0	5	6
Московская область	Очно-заочная; Государственные, муниципальные (без учета организаций в ведении ФСИН)	    восстановлены из числа ранее отчисленных / 4.0	0	0	0	0	0	0	0	0	0	0	2	0	0	3	5	4	0	0	3	7
Московская область	Очно-заочная; Государственные, муниципальные (без учета организаций в ведении ФСИН)	    выбыло по другим причинам / 16.0	0	0	0	0	0	0	0	0	0	0	4	0	0	23	27	7	0	0	25	32
Московская область	Очно-заочная; Государственные, муниципальные (без учета организаций в ведении ФСИН)	"    добровольно прекратили образовательные отношения
    (бросили учебу) / 10.0"	0	0	0	5	5	2	0	0	3	5	32	0	0	14	46	38	0	0	66	104
Московская область	Очно-заочная; Государственные, муниципальные (без учета организаций в ведении ФСИН)	"    отчислено:
         по неуспеваемости / 11.0"	0	0	0	0	0	0	0	0	0	0	8	0	0	4	12	5	0	0	8	13
Московская область	Очно-заочная; Государственные, муниципальные (без учета организаций в ведении ФСИН)	"    переведено в другие образовательные организации
    на программы того же уровня / 8.0"	0	0	0	0	0	0	0	0	0	0	0	0	0	3	3	3	0	0	5	8
Московская область	Очно-заочная; Государственные, муниципальные (без учета организаций в ведении ФСИН)	"    переведено из других образовательных организаций 
    с программ того же уровня / 3.0"	0	0	0	0	0	0	0	0	0	0	0	0	0	0	0	5	0	0	2	7
Московская область	Очно-заочная; Государственные, муниципальные (без учета организаций в ведении ФСИН)	    по болезни / 9.0	0	0	0	0	0	0	0	0	0	0	0	0	0	0	0	0	0	0	0	0
Московская область	Очно-заочная; Государственные, муниципальные (без учета организаций в ведении ФСИН)	    прибыло по другим причинам / 5.0	0	0	0	0	0	0	0	0	0	0	30	0	0	41	71	11	0	0	62	73
Московская область	Очно-заочная; Государственные, муниципальные (без учета организаций в ведении ФСИН)	Выбыло студентов - всего (сумма стр. 07-11, 13-15) / 6.0	0	0	0	5	5	2	0	0	3	5	45	0	0	71	116	58	0	0	147	205
Московская область	Очно-заочная; Государственные, муниципальные (без учета организаций в ведении ФСИН)	Прибыло студентов - всего (сумма стр. 02-05) / 1.0	0	0	0	0	0	0	0	0	0	0	36	0	0	45	81	21	0	0	72	93
Московская область	Очно-заочная; Государственные, муниципальные (без учета организаций в ведении ФСИН)	"Численность студентов на начало прошлого учебного года
(на 1 октября) / 17.0"	0	0	0	85	85	65	0	0	40	105	120	0	0	651	771	419	0	17	1434	1870
Московская область	Частные; Заочная	            из стр. 11 - не прошли итоговую аттестацию / 12.0	0	0	0	0	0	0	0	0	0	0	0	0	0	1	1	0	0	0	1	1
Московская область	Частные; Заочная	"            из стр. 11 – лица с ограниченными возможностями здоровья,
            инвалиды, дети-инвалиды / 13.0"	0	0	0	0	0	0	0	0	0	0	0	0	0	0	0	0	0	0	0	0
Московская область	Частные; Заочная	         отчислено в виде меры дисциплинарного взыскания / 14.0	0	0	0	0	0	0	0	0	0	0	0	0	0	0	0	0	0	0	0	0
Московская область	Частные; Заочная	         отчислено из-за просрочки оплаты обучения / 15.0	0	0	0	0	0	0	0	0	0	0	0	0	0	33	33	0	0	0	10	10
Московская область	Частные; Заочная	"    в том числе:
    переведено на другие формы обучения данной
    организации на программы того же уровня / 7.0"	0	0	0	0	0	0	0	0	0	0	0	0	0	12	12	0	0	0	3	3
Московская область	Частные; Заочная	"    в том числе:
    переведено с других форм обучения данной
    образовательной организации с программ того же уровня / 2.0"	0	0	0	0	0	0	0	0	0	0	0	0	0	60	60	0	0	0	13	13
Московская область	Частные; Заочная	    восстановлены из числа ранее отчисленных / 4.0	0	0	0	0	0	0	0	0	0	0	0	0	0	13	13	0	0	0	3	3
Московская область	Частные; Заочная	    выбыло по другим причинам / 16.0	0	0	0	0	0	0	0	0	0	0	0	0	0	23	23	0	0	0	80	80
Московская область	Частные; Заочная	"    добровольно прекратили образовательные отношения
    (бросили учебу) / 10.0"	0	0	0	0	0	0	0	0	0	0	0	0	0	23	23	0	0	0	54	54
Московская область	Частные; Заочная	"    отчислено:
         по неуспеваемости / 11.0"	0	0	0	0	0	0	0	0	0	0	0	0	0	28	28	0	0	0	14	14
Московская область	Частные; Заочная	"    переведено в другие образовательные организации
    на программы того же уровня / 8.0"	0	0	0	0	0	0	0	0	0	0	0	0	0	6	6	0	0	0	0	0
Московская область	Частные; Заочная	"    переведено из других образовательных организаций 
    с программ того же уровня / 3.0"	0	0	0	0	0	0	0	0	0	0	0	0	0	144	144	0	0	0	127	127
Московская область	Частные; Заочная	    по болезни / 9.0	0	0	0	0	0	0	0	0	0	0	0	0	0	0	0	0	0	0	0	0
Московская область	Частные; Заочная	    прибыло по другим причинам / 5.0	0	0	0	0	0	0	0	0	0	0	0	0	0	58	58	0	0	0	11	11
Московская область	Частные; Заочная	Выбыло студентов - всего (сумма стр. 07-11, 13-15) / 6.0	0	0	0	0	0	0	0	0	0	0	0	0	0	125	125	0	0	0	161	161
Московская область	Частные; Заочная	Прибыло студентов - всего (сумма стр. 02-05) / 1.0	0	0	0	0	0	0	0	0	0	0	0	0	0	275	275	0	0	0	154	154
Московская область	Частные; Заочная	"Численность студентов на начало прошлого учебного года
(на 1 октября) / 17.0"	0	0	0	0	0	0	0	0	0	0	0	0	0	1500	1500	0	0	0	1019	1019
Московская область	Частные; Очная	            из стр. 11 - не прошли итоговую аттестацию / 12.0	0	0	0	0	0	0	0	0	12	12	0	0	0	12	12	0	0	0	1	1
Московская область	Частные; Очная	"            из стр. 11 – лица с ограниченными возможностями здоровья,
            инвалиды, дети-инвалиды / 13.0"	0	0	0	0	0	0	0	0	0	0	0	0	0	0	0	0	0	0	0	0
Московская область	Частные; Очная	         отчислено в виде меры дисциплинарного взыскания / 14.0	0	0	0	0	0	0	0	0	0	0	0	0	0	0	0	0	0	0	0	0
Московская область	Частные; Очная	         отчислено из-за просрочки оплаты обучения / 15.0	0	0	0	0	0	0	0	0	11	11	0	0	0	67	67	0	0	0	27	27
Московская область	Частные; Очная	"    в том числе:
    переведено на другие формы обучения данной
    организации на программы того же уровня / 7.0"	0	0	0	0	0	0	0	0	0	0	0	0	0	63	63	0	0	0	22	22
Московская область	Частные; Очная	"    в том числе:
    переведено с других форм обучения данной
    образовательной организации с программ того же уровня / 2.0"	0	0	0	0	0	0	0	0	0	0	0	0	3	38	41	0	0	0	15	15
Московская область	Частные; Очная	    восстановлены из числа ранее отчисленных / 4.0	0	0	0	1	1	0	0	0	1	1	0	0	0	69	69	0	0	0	11	11
Московская область	Частные; Очная	    выбыло по другим причинам / 16.0	0	0	0	0	0	0	0	0	13	13	0	0	0	365	365	0	0	0	110	110
Московская область	Частные; Очная	"    добровольно прекратили образовательные отношения
    (бросили учебу) / 10.0"	0	0	0	5	5	0	0	0	7	7	0	0	3	347	350	0	0	0	50	50
Московская область	Частные; Очная	"    отчислено:
         по неуспеваемости / 11.0"	0	0	0	0	0	0	0	0	43	43	0	0	0	148	148	0	0	0	35	35
Московская область	Частные; Очная	"    переведено в другие образовательные организации
    на программы того же уровня / 8.0"	0	0	0	0	0	0	0	0	1	1	0	0	0	150	150	0	0	0	19	19
Московская область	Частные; Очная	"    переведено из других образовательных организаций 
    с программ того же уровня / 3.0"	0	0	0	0	0	0	0	0	1	1	0	0	0	163	163	0	0	0	43	43
Московская область	Частные; Очная	    по болезни / 9.0	0	0	0	0	0	0	0	0	0	0	0	0	0	2	2	0	0	0	0	0
Московская область	Частные; Очная	    прибыло по другим причинам / 5.0	0	0	0	0	0	0	0	0	44	44	0	0	0	297	297	0	0	0	54	54
Московская область	Частные; Очная	Выбыло студентов - всего (сумма стр. 07-11, 13-15) / 6.0	0	0	0	5	5	0	0	0	75	75	0	0	3	1142	1145	0	0	0	263	263
Московская область	Частные; Очная	Прибыло студентов - всего (сумма стр. 02-05) / 1.0	0	0	0	1	1	0	0	0	46	46	0	0	3	567	570	0	0	0	123	123
Московская область	Частные; Очная	"Численность студентов на начало прошлого учебного года
(на 1 октября) / 17.0"	0	0	0	49	49	0	0	0	259	259	0	0	85	9228	9313	0	0	0	1335	1335
Московская область	Частные; Очно-заочная	            из стр. 11 - не прошли итоговую аттестацию / 12.0	0	0	0	0	0	0	0	0	0	0	0	0	0	0	0	0	0	0	0	0
Московская область	Частные; Очно-заочная	"            из стр. 11 – лица с ограниченными возможностями здоровья,
            инвалиды, дети-инвалиды / 13.0"	0	0	0	0	0	0	0	0	0	0	0	0	0	0	0	0	0	0	0	0
Московская область	Частные; Очно-заочная	         отчислено в виде меры дисциплинарного взыскания / 14.0	0	0	0	0	0	0	0	0	0	0	0	0	0	0	0	0	0	0	0	0
Московская область	Частные; Очно-заочная	         отчислено из-за просрочки оплаты обучения / 15.0	0	0	0	0	0	0	0	0	0	0	0	0	0	0	0	0	0	0	0	0
Московская область	Частные; Очно-заочная	"    в том числе:
    переведено на другие формы обучения данной
    организации на программы того же уровня / 7.0"	0	0	0	0	0	0	0	0	4	4	0	0	0	1	1	0	0	0	2	2
Московская область	Частные; Очно-заочная	"    в том числе:
    переведено с других форм обучения данной
    образовательной организации с программ того же уровня / 2.0"	0	0	0	0	0	0	0	0	43	43	0	0	0	8	8	0	0	0	0	0
Московская область	Частные; Очно-заочная	    восстановлены из числа ранее отчисленных / 4.0	0	0	0	0	0	0	0	0	1	1	0	0	0	0	0	0	0	0	2	2
Московская область	Частные; Очно-заочная	    выбыло по другим причинам / 16.0	0	0	0	0	0	0	0	0	0	0	0	0	0	1	1	0	0	0	1	1
Московская область	Частные; Очно-заочная	"    добровольно прекратили образовательные отношения
    (бросили учебу) / 10.0"	0	0	0	0	0	0	0	0	5	5	0	0	0	6	6	0	0	0	8	8
Московская область	Частные; Очно-заочная	"    отчислено:
         по неуспеваемости / 11.0"	0	0	0	0	0	0	0	0	14	14	0	0	0	0	0	0	0	0	0	0
Московская область	Частные; Очно-заочная	"    переведено в другие образовательные организации
    на программы того же уровня / 8.0"	0	0	0	0	0	0	0	0	0	0	0	0	0	1	1	0	0	0	0	0
Московская область	Частные; Очно-заочная	"    переведено из других образовательных организаций 
    с программ того же уровня / 3.0"	0	0	0	0	0	0	0	0	0	0	0	0	0	2	2	0	0	0	0	0
Московская область	Частные; Очно-заочная	    по болезни / 9.0	0	0	0	0	0	0	0	0	0	0	0	0	0	0	0	0	0	0	0	0
Московская область	Частные; Очно-заочная	    прибыло по другим причинам / 5.0	0	0	0	0	0	0	0	0	0	0	0	0	0	27	27	0	0	0	32	32
Московская область	Частные; Очно-заочная	Выбыло студентов - всего (сумма стр. 07-11, 13-15) / 6.0	0	0	0	0	0	0	0	0	23	23	0	0	0	9	9	0	0	0	11	11
Московская область	Частные; Очно-заочная	Прибыло студентов - всего (сумма стр. 02-05) / 1.0	0	0	0	0	0	0	0	0	44	44	0	0	0	37	37	0	0	0	34	34
Московская область	Частные; Очно-заочная	"Численность студентов на начало прошлого учебного года
(на 1 октября) / 17.0"	0	0	0	0	0	0	0	0	22	22	0	0	0	251	251	0	0	0	190	190
Мурманская область	Государственные, муниципальные (без учета организаций в ведении ФСИН); Заочная	            из стр. 11 - не прошли итоговую аттестацию / 12.0	0	0	0	0	0	0	0	0	0	0	0	0	0	0	0	3	0	0	1	4
Мурманская область	Государственные, муниципальные (без учета организаций в ведении ФСИН); Заочная	"            из стр. 11 – лица с ограниченными возможностями здоровья,
            инвалиды, дети-инвалиды / 13.0"	0	0	0	0	0	0	0	0	0	0	0	0	0	0	0	0	0	0	0	0
Мурманская область	Государственные, муниципальные (без учета организаций в ведении ФСИН); Заочная	         отчислено в виде меры дисциплинарного взыскания / 14.0	0	0	0	0	0	0	0	0	0	0	0	0	0	0	0	0	0	0	0	0
Мурманская область	Государственные, муниципальные (без учета организаций в ведении ФСИН); Заочная	         отчислено из-за просрочки оплаты обучения / 15.0	0	0	0	0	0	0	0	0	0	0	0	0	0	5	5	0	0	0	44	44
Мурманская область	Государственные, муниципальные (без учета организаций в ведении ФСИН); Заочная	"    в том числе:
    переведено на другие формы обучения данной
    организации на программы того же уровня / 7.0"	0	0	0	0	0	0	0	0	0	0	0	0	0	4	4	0	0	0	10	10
Мурманская область	Государственные, муниципальные (без учета организаций в ведении ФСИН); Заочная	"    в том числе:
    переведено с других форм обучения данной
    образовательной организации с программ того же уровня / 2.0"	0	0	0	0	0	0	0	0	0	0	0	0	0	18	18	0	0	0	10	10
Мурманская область	Государственные, муниципальные (без учета организаций в ведении ФСИН); Заочная	    восстановлены из числа ранее отчисленных / 4.0	0	0	0	0	0	0	0	0	0	0	1	0	0	5	6	2	0	0	51	53
Мурманская область	Государственные, муниципальные (без учета организаций в ведении ФСИН); Заочная	    выбыло по другим причинам / 16.0	0	0	0	0	0	0	0	0	0	0	0	0	0	5	5	90	0	0	47	137
Мурманская область	Государственные, муниципальные (без учета организаций в ведении ФСИН); Заочная	"    добровольно прекратили образовательные отношения
    (бросили учебу) / 10.0"	0	0	0	0	0	0	0	0	0	0	1	0	0	16	17	34	0	1	78	113
Мурманская область	Государственные, муниципальные (без учета организаций в ведении ФСИН); Заочная	"    отчислено:
         по неуспеваемости / 11.0"	0	0	0	0	0	0	0	0	0	0	0	0	0	15	15	10	0	0	53	63
Мурманская область	Государственные, муниципальные (без учета организаций в ведении ФСИН); Заочная	"    переведено в другие образовательные организации
    на программы того же уровня / 8.0"	0	0	0	0	0	0	0	0	0	0	0	0	0	0	0	1	0	0	3	4
Мурманская область	Государственные, муниципальные (без учета организаций в ведении ФСИН); Заочная	"    переведено из других образовательных организаций 
    с программ того же уровня / 3.0"	0	0	0	0	0	0	0	0	0	0	0	0	0	12	12	0	0	0	8	8
Мурманская область	Государственные, муниципальные (без учета организаций в ведении ФСИН); Заочная	    по болезни / 9.0	0	0	0	0	0	0	0	0	0	0	0	0	0	0	0	0	0	0	0	0
Мурманская область	Государственные, муниципальные (без учета организаций в ведении ФСИН); Заочная	    прибыло по другим причинам / 5.0	0	0	0	0	0	0	0	0	0	0	0	0	0	5	5	96	0	0	34	130
Мурманская область	Государственные, муниципальные (без учета организаций в ведении ФСИН); Заочная	Выбыло студентов - всего (сумма стр. 07-11, 13-15) / 6.0	0	0	0	0	0	0	0	0	0	0	1	0	0	45	46	135	0	1	235	371
Мурманская область	Государственные, муниципальные (без учета организаций в ведении ФСИН); Заочная	Прибыло студентов - всего (сумма стр. 02-05) / 1.0	0	0	0	0	0	0	0	0	0	0	1	0	0	40	41	98	0	0	103	201
Мурманская область	Государственные, муниципальные (без учета организаций в ведении ФСИН); Заочная	"Численность студентов на начало прошлого учебного года
(на 1 октября) / 17.0"	0	0	0	0	0	0	0	0	0	0	10	0	0	174	184	565	0	15	1771	2351
Мурманская область	Государственные, муниципальные (без учета организаций в ведении ФСИН); Очная	            из стр. 11 - не прошли итоговую аттестацию / 12.0	1	0	0	0	1	0	0	0	0	0	2	0	1	0	3	3	0	0	0	3
Мурманская область	Государственные, муниципальные (без учета организаций в ведении ФСИН); Очная	"            из стр. 11 – лица с ограниченными возможностями здоровья,
            инвалиды, дети-инвалиды / 13.0"	0	0	0	0	0	0	0	0	0	0	0	0	1	0	1	0	0	0	0	0
Мурманская область	Государственные, муниципальные (без учета организаций в ведении ФСИН); Очная	         отчислено в виде меры дисциплинарного взыскания / 14.0	5	0	0	0	5	0	0	0	0	0	2	0	0	0	2	0	0	0	0	0
Мурманская область	Государственные, муниципальные (без учета организаций в ведении ФСИН); Очная	         отчислено из-за просрочки оплаты обучения / 15.0	0	0	0	5	5	0	0	0	0	0	0	0	0	2	2	0	0	0	2	2
Мурманская область	Государственные, муниципальные (без учета организаций в ведении ФСИН); Очная	"    в том числе:
    переведено на другие формы обучения данной
    организации на программы того же уровня / 7.0"	3	0	0	0	3	0	0	0	0	0	12	0	37	61	110	2	0	0	7	9
Мурманская область	Государственные, муниципальные (без учета организаций в ведении ФСИН); Очная	"    в том числе:
    переведено с других форм обучения данной
    образовательной организации с программ того же уровня / 2.0"	3	0	0	1	4	0	0	0	0	0	55	0	29	6	90	4	0	0	0	4
Мурманская область	Государственные, муниципальные (без учета организаций в ведении ФСИН); Очная	    восстановлены из числа ранее отчисленных / 4.0	13	0	0	1	14	1	0	0	0	1	52	0	26	11	89	17	0	0	5	22
Мурманская область	Государственные, муниципальные (без учета организаций в ведении ФСИН); Очная	    выбыло по другим причинам / 16.0	160	0	0	4	164	20	0	0	0	20	261	0	0	56	317	7	0	0	2	9
Мурманская область	Государственные, муниципальные (без учета организаций в ведении ФСИН); Очная	"    добровольно прекратили образовательные отношения
    (бросили учебу) / 10.0"	258	0	0	1	259	4	0	0	0	4	503	0	185	103	791	87	0	0	25	112
Мурманская область	Государственные, муниципальные (без учета организаций в ведении ФСИН); Очная	"    отчислено:
         по неуспеваемости / 11.0"	112	0	0	0	112	2	0	0	0	2	113	0	32	25	170	17	0	8	2	27
Мурманская область	Государственные, муниципальные (без учета организаций в ведении ФСИН); Очная	"    переведено в другие образовательные организации
    на программы того же уровня / 8.0"	21	0	0	0	21	0	0	0	0	0	75	0	31	29	135	8	0	1	0	9
Мурманская область	Государственные, муниципальные (без учета организаций в ведении ФСИН); Очная	"    переведено из других образовательных организаций 
    с программ того же уровня / 3.0"	22	0	0	1	23	0	0	0	0	0	68	0	14	36	118	6	0	0	0	6
Мурманская область	Государственные, муниципальные (без учета организаций в ведении ФСИН); Очная	    по болезни / 9.0	0	0	0	0	0	0	0	0	0	0	0	0	0	0	0	0	0	0	0	0
Мурманская область	Государственные, муниципальные (без учета организаций в ведении ФСИН); Очная	    прибыло по другим причинам / 5.0	82	0	0	1	83	0	0	0	0	0	79	0	2	23	104	0	0	0	2	2
Мурманская область	Государственные, муниципальные (без учета организаций в ведении ФСИН); Очная	Выбыло студентов - всего (сумма стр. 07-11, 13-15) / 6.0	559	0	0	10	569	26	0	0	0	26	966	0	285	276	1527	121	0	9	38	168
Мурманская область	Государственные, муниципальные (без учета организаций в ведении ФСИН); Очная	Прибыло студентов - всего (сумма стр. 02-05) / 1.0	120	0	0	4	124	1	0	0	0	1	254	0	71	76	401	27	0	0	7	34
Мурманская область	Государственные, муниципальные (без учета организаций в ведении ФСИН); Очная	"Численность студентов на начало прошлого учебного года
(на 1 октября) / 17.0"	2862	0	0	31	2893	52	0	0	0	52	7428	0	2022	1202	10652	660	0	59	252	971
Мурманская область	Очно-заочная; Государственные, муниципальные (без учета организаций в ведении ФСИН)	            из стр. 11 - не прошли итоговую аттестацию / 12.0	0	0	0	0	0	0	0	0	0	0	0	0	0	0	0	0	0	0	0	0
Мурманская область	Очно-заочная; Государственные, муниципальные (без учета организаций в ведении ФСИН)	"            из стр. 11 – лица с ограниченными возможностями здоровья,
            инвалиды, дети-инвалиды / 13.0"	0	0	0	0	0	0	0	0	0	0	0	0	0	0	0	0	0	0	0	0
Мурманская область	Очно-заочная; Государственные, муниципальные (без учета организаций в ведении ФСИН)	         отчислено в виде меры дисциплинарного взыскания / 14.0	0	0	0	0	0	0	0	0	0	0	0	0	0	0	0	0	0	0	0	0
Мурманская область	Очно-заочная; Государственные, муниципальные (без учета организаций в ведении ФСИН)	         отчислено из-за просрочки оплаты обучения / 15.0	0	0	0	0	0	0	0	0	0	0	0	0	0	0	0	0	0	0	0	0
Мурманская область	Очно-заочная; Государственные, муниципальные (без учета организаций в ведении ФСИН)	"    в том числе:
    переведено на другие формы обучения данной
    организации на программы того же уровня / 7.0"	0	0	0	0	0	0	0	0	0	0	1	0	0	0	1	0	0	0	0	0
Мурманская область	Очно-заочная; Государственные, муниципальные (без учета организаций в ведении ФСИН)	"    в том числе:
    переведено с других форм обучения данной
    образовательной организации с программ того же уровня / 2.0"	0	0	0	0	0	0	0	0	0	0	0	0	0	0	0	0	0	0	4	4
Мурманская область	Очно-заочная; Государственные, муниципальные (без учета организаций в ведении ФСИН)	    восстановлены из числа ранее отчисленных / 4.0	0	0	0	0	0	0	0	0	0	0	0	0	0	0	0	0	0	0	3	3
Мурманская область	Очно-заочная; Государственные, муниципальные (без учета организаций в ведении ФСИН)	    выбыло по другим причинам / 16.0	0	0	0	0	0	0	0	0	0	0	0	0	0	0	0	0	0	0	2	2
Мурманская область	Очно-заочная; Государственные, муниципальные (без учета организаций в ведении ФСИН)	"    добровольно прекратили образовательные отношения
    (бросили учебу) / 10.0"	0	0	0	0	0	0	0	0	0	0	0	0	0	1	1	3	0	0	36	39
Мурманская область	Очно-заочная; Государственные, муниципальные (без учета организаций в ведении ФСИН)	"    отчислено:
         по неуспеваемости / 11.0"	0	0	0	0	0	0	0	0	0	0	0	0	0	0	0	0	0	0	3	3
Мурманская область	Очно-заочная; Государственные, муниципальные (без учета организаций в ведении ФСИН)	"    переведено в другие образовательные организации
    на программы того же уровня / 8.0"	0	0	0	0	0	0	0	0	0	0	0	0	0	0	0	0	0	0	0	0
Мурманская область	Очно-заочная; Государственные, муниципальные (без учета организаций в ведении ФСИН)	"    переведено из других образовательных организаций 
    с программ того же уровня / 3.0"	0	0	0	0	0	0	0	0	0	0	0	0	0	0	0	0	0	0	1	1
Мурманская область	Очно-заочная; Государственные, муниципальные (без учета организаций в ведении ФСИН)	    по болезни / 9.0	0	0	0	0	0	0	0	0	0	0	0	0	0	0	0	0	0	0	0	0
Мурманская область	Очно-заочная; Государственные, муниципальные (без учета организаций в ведении ФСИН)	    прибыло по другим причинам / 5.0	0	0	0	0	0	0	0	0	0	0	0	0	0	0	0	0	0	0	0	0
Мурманская область	Очно-заочная; Государственные, муниципальные (без учета организаций в ведении ФСИН)	Выбыло студентов - всего (сумма стр. 07-11, 13-15) / 6.0	0	0	0	0	0	0	0	0	0	0	1	0	0	1	2	3	0	0	41	44
Мурманская область	Очно-заочная; Государственные, муниципальные (без учета организаций в ведении ФСИН)	Прибыло студентов - всего (сумма стр. 02-05) / 1.0	0	0	0	0	0	0	0	0	0	0	0	0	0	0	0	0	0	0	8	8
Мурманская область	Очно-заочная; Государственные, муниципальные (без учета организаций в ведении ФСИН)	"Численность студентов на начало прошлого учебного года
(на 1 октября) / 17.0"	0	0	0	0	0	0	0	0	0	0	10	0	0	11	21	0	0	1	331	332
Мурманская область	Частные; Заочная	            из стр. 11 - не прошли итоговую аттестацию / 12.0	0	0	0	0	0	0	0	0	0	0	0	0	0	0	0	0	0	0	0	0
Мурманская область	Частные; Заочная	"            из стр. 11 – лица с ограниченными возможностями здоровья,
            инвалиды, дети-инвалиды / 13.0"	0	0	0	0	0	0	0	0	0	0	0	0	0	0	0	0	0	0	0	0
Мурманская область	Частные; Заочная	         отчислено в виде меры дисциплинарного взыскания / 14.0	0	0	0	0	0	0	0	0	0	0	0	0	0	0	0	0	0	0	0	0
Мурманская область	Частные; Заочная	         отчислено из-за просрочки оплаты обучения / 15.0	0	0	0	0	0	0	0	0	0	0	0	0	0	8	8	0	0	0	6	6
Мурманская область	Частные; Заочная	"    в том числе:
    переведено на другие формы обучения данной
    организации на программы того же уровня / 7.0"	0	0	0	0	0	0	0	0	0	0	0	0	0	0	0	0	0	0	0	0
Мурманская область	Частные; Заочная	"    в том числе:
    переведено с других форм обучения данной
    образовательной организации с программ того же уровня / 2.0"	0	0	0	0	0	0	0	0	0	0	0	0	0	5	5	0	0	0	0	0
Мурманская область	Частные; Заочная	    восстановлены из числа ранее отчисленных / 4.0	0	0	0	0	0	0	0	0	0	0	0	0	0	3	3	0	0	0	2	2
Мурманская область	Частные; Заочная	    выбыло по другим причинам / 16.0	0	0	0	0	0	0	0	0	0	0	0	0	0	0	0	0	0	0	0	0
Мурманская область	Частные; Заочная	"    добровольно прекратили образовательные отношения
    (бросили учебу) / 10.0"	0	0	0	0	0	0	0	0	0	0	0	0	0	6	6	0	0	0	6	6
Мурманская область	Частные; Заочная	"    отчислено:
         по неуспеваемости / 11.0"	0	0	0	0	0	0	0	0	0	0	0	0	0	4	4	0	0	0	1	1
Мурманская область	Частные; Заочная	"    переведено в другие образовательные организации
    на программы того же уровня / 8.0"	0	0	0	0	0	0	0	0	0	0	0	0	0	1	1	0	0	0	0	0
Мурманская область	Частные; Заочная	"    переведено из других образовательных организаций 
    с программ того же уровня / 3.0"	0	0	0	0	0	0	0	0	0	0	0	0	0	5	5	0	0	0	20	20
Мурманская область	Частные; Заочная	    по болезни / 9.0	0	0	0	0	0	0	0	0	0	0	0	0	0	0	0	0	0	0	0	0
Мурманская область	Частные; Заочная	    прибыло по другим причинам / 5.0	0	0	0	0	0	0	0	0	0	0	0	0	0	2	2	0	0	0	0	0
Мурманская область	Частные; Заочная	Выбыло студентов - всего (сумма стр. 07-11, 13-15) / 6.0	0	0	0	0	0	0	0	0	0	0	0	0	0	19	19	0	0	0	13	13
Мурманская область	Частные; Заочная	Прибыло студентов - всего (сумма стр. 02-05) / 1.0	0	0	0	0	0	0	0	0	0	0	0	0	0	15	15	0	0	0	22	22
Мурманская область	Частные; Заочная	"Численность студентов на начало прошлого учебного года
(на 1 октября) / 17.0"	0	0	0	0	0	0	0	0	0	0	0	0	0	73	73	0	0	0	90	90
Мурманская область	Частные; Очная	            из стр. 11 - не прошли итоговую аттестацию / 12.0	0	0	0	0	0	0	0	0	0	0	0	0	0	0	0	0	0	0	0	0
Мурманская область	Частные; Очная	"            из стр. 11 – лица с ограниченными возможностями здоровья,
            инвалиды, дети-инвалиды / 13.0"	0	0	0	0	0	0	0	0	0	0	0	0	0	0	0	0	0	0	0	0
Мурманская область	Частные; Очная	         отчислено в виде меры дисциплинарного взыскания / 14.0	0	0	0	0	0	0	0	0	0	0	0	0	0	0	0	0	0	0	0	0
Мурманская область	Частные; Очная	         отчислено из-за просрочки оплаты обучения / 15.0	0	0	0	0	0	0	0	0	0	0	0	0	0	9	9	0	0	0	1	1
Мурманская область	Частные; Очная	"    в том числе:
    переведено на другие формы обучения данной
    организации на программы того же уровня / 7.0"	0	0	0	0	0	0	0	0	0	0	0	0	0	5	5	0	0	0	0	0
Мурманская область	Частные; Очная	"    в том числе:
    переведено с других форм обучения данной
    образовательной организации с программ того же уровня / 2.0"	0	0	0	0	0	0	0	0	0	0	0	0	0	0	0	0	0	0	0	0
Мурманская область	Частные; Очная	    восстановлены из числа ранее отчисленных / 4.0	0	0	0	0	0	0	0	0	0	0	0	0	0	1	1	0	0	0	1	1
Мурманская область	Частные; Очная	    выбыло по другим причинам / 16.0	0	0	0	0	0	0	0	0	0	0	0	0	0	2	2	0	0	0	0	0
Мурманская область	Частные; Очная	"    добровольно прекратили образовательные отношения
    (бросили учебу) / 10.0"	0	0	0	0	0	0	0	0	0	0	0	0	0	35	35	0	0	0	8	8
Мурманская область	Частные; Очная	"    отчислено:
         по неуспеваемости / 11.0"	0	0	0	0	0	0	0	0	0	0	0	0	0	1	1	0	0	0	3	3
Мурманская область	Частные; Очная	"    переведено в другие образовательные организации
    на программы того же уровня / 8.0"	0	0	0	0	0	0	0	0	0	0	0	0	0	8	8	0	0	0	0	0
Мурманская область	Частные; Очная	"    переведено из других образовательных организаций 
    с программ того же уровня / 3.0"	0	0	0	0	0	0	0	0	0	0	0	0	0	12	12	0	0	0	3	3
Мурманская область	Частные; Очная	    по болезни / 9.0	0	0	0	0	0	0	0	0	0	0	0	0	0	0	0	0	0	0	0	0
Мурманская область	Частные; Очная	    прибыло по другим причинам / 5.0	0	0	0	0	0	0	0	0	0	0	0	0	0	8	8	0	0	0	17	17
Мурманская область	Частные; Очная	Выбыло студентов - всего (сумма стр. 07-11, 13-15) / 6.0	0	0	0	0	0	0	0	0	0	0	0	0	0	60	60	0	0	0	12	12
Мурманская область	Частные; Очная	Прибыло студентов - всего (сумма стр. 02-05) / 1.0	0	0	0	0	0	0	0	0	0	0	0	0	0	21	21	0	0	0	21	21
Мурманская область	Частные; Очная	"Численность студентов на начало прошлого учебного года
(на 1 октября) / 17.0"	0	0	0	0	0	0	0	0	0	0	0	0	0	543	543	0	0	0	73	73
Ненецкий автономный округ	Государственные, муниципальные (без учета организаций в ведении ФСИН); Заочная	            из стр. 11 - не прошли итоговую аттестацию / 12.0	0	0	0	0	0	0	0	0	0	0	0	0	0	0	0	0	0	0	0	0
Ненецкий автономный округ	Государственные, муниципальные (без учета организаций в ведении ФСИН); Заочная	"            из стр. 11 – лица с ограниченными возможностями здоровья,
            инвалиды, дети-инвалиды / 13.0"	0	0	0	0	0	0	0	0	0	0	0	0	0	0	0	0	0	0	0	0
Ненецкий автономный округ	Государственные, муниципальные (без учета организаций в ведении ФСИН); Заочная	         отчислено в виде меры дисциплинарного взыскания / 14.0	0	0	0	0	0	0	0	0	0	0	0	0	0	0	0	0	0	0	0	0
Ненецкий автономный округ	Государственные, муниципальные (без учета организаций в ведении ФСИН); Заочная	         отчислено из-за просрочки оплаты обучения / 15.0	0	0	0	0	0	0	0	0	0	0	0	0	0	0	0	0	0	0	0	0
Ненецкий автономный округ	Государственные, муниципальные (без учета организаций в ведении ФСИН); Заочная	"    в том числе:
    переведено на другие формы обучения данной
    организации на программы того же уровня / 7.0"	0	0	0	0	0	0	0	0	0	0	0	0	0	0	0	0	0	0	0	0
Ненецкий автономный округ	Государственные, муниципальные (без учета организаций в ведении ФСИН); Заочная	"    в том числе:
    переведено с других форм обучения данной
    образовательной организации с программ того же уровня / 2.0"	0	0	0	0	0	0	0	0	0	0	0	0	0	0	0	0	0	0	0	0
Ненецкий автономный округ	Государственные, муниципальные (без учета организаций в ведении ФСИН); Заочная	    восстановлены из числа ранее отчисленных / 4.0	0	0	0	0	0	0	0	0	0	0	0	0	0	0	0	0	0	0	0	0
Ненецкий автономный округ	Государственные, муниципальные (без учета организаций в ведении ФСИН); Заочная	    выбыло по другим причинам / 16.0	0	0	0	0	0	0	0	0	0	0	0	0	0	4	4	0	0	0	1	1
Ненецкий автономный округ	Государственные, муниципальные (без учета организаций в ведении ФСИН); Заочная	"    добровольно прекратили образовательные отношения
    (бросили учебу) / 10.0"	0	0	0	0	0	0	0	0	0	0	0	0	0	0	0	0	0	0	0	0
Ненецкий автономный округ	Государственные, муниципальные (без учета организаций в ведении ФСИН); Заочная	"    отчислено:
         по неуспеваемости / 11.0"	0	0	0	0	0	0	0	0	0	0	0	0	0	0	0	0	0	0	0	0
Ненецкий автономный округ	Государственные, муниципальные (без учета организаций в ведении ФСИН); Заочная	"    переведено в другие образовательные организации
    на программы того же уровня / 8.0"	0	0	0	0	0	0	0	0	0	0	0	0	0	0	0	0	0	0	0	0
Ненецкий автономный округ	Государственные, муниципальные (без учета организаций в ведении ФСИН); Заочная	"    переведено из других образовательных организаций 
    с программ того же уровня / 3.0"	0	0	0	0	0	0	0	0	0	0	0	0	0	1	1	0	0	0	0	0
Ненецкий автономный округ	Государственные, муниципальные (без учета организаций в ведении ФСИН); Заочная	    по болезни / 9.0	0	0	0	0	0	0	0	0	0	0	0	0	0	0	0	0	0	0	0	0
Ненецкий автономный округ	Государственные, муниципальные (без учета организаций в ведении ФСИН); Заочная	    прибыло по другим причинам / 5.0	0	0	0	0	0	0	0	0	0	0	0	0	0	0	0	0	0	0	0	0
Ненецкий автономный округ	Государственные, муниципальные (без учета организаций в ведении ФСИН); Заочная	Выбыло студентов - всего (сумма стр. 07-11, 13-15) / 6.0	0	0	0	0	0	0	0	0	0	0	0	0	0	4	4	0	0	0	1	1
Ненецкий автономный округ	Государственные, муниципальные (без учета организаций в ведении ФСИН); Заочная	Прибыло студентов - всего (сумма стр. 02-05) / 1.0	0	0	0	0	0	0	0	0	0	0	0	0	0	1	1	0	0	0	0	0
Ненецкий автономный округ	Государственные, муниципальные (без учета организаций в ведении ФСИН); Заочная	"Численность студентов на начало прошлого учебного года
(на 1 октября) / 17.0"	0	0	0	0	0	0	0	0	0	0	0	0	0	38	38	0	0	0	16	16
Ненецкий автономный округ	Государственные, муниципальные (без учета организаций в ведении ФСИН); Очная	            из стр. 11 - не прошли итоговую аттестацию / 12.0	0	0	0	0	0	0	0	0	0	0	0	0	0	0	0	0	0	0	0	0
Ненецкий автономный округ	Государственные, муниципальные (без учета организаций в ведении ФСИН); Очная	"            из стр. 11 – лица с ограниченными возможностями здоровья,
            инвалиды, дети-инвалиды / 13.0"	0	0	0	0	0	0	0	0	0	0	0	0	0	1	1	1	0	0	0	1
Ненецкий автономный округ	Государственные, муниципальные (без учета организаций в ведении ФСИН); Очная	         отчислено в виде меры дисциплинарного взыскания / 14.0	0	0	0	0	0	0	0	0	0	0	0	0	0	0	0	0	0	0	0	0
Ненецкий автономный округ	Государственные, муниципальные (без учета организаций в ведении ФСИН); Очная	         отчислено из-за просрочки оплаты обучения / 15.0	0	0	0	0	0	0	0	0	0	0	0	0	0	0	0	0	0	0	0	0
Ненецкий автономный округ	Государственные, муниципальные (без учета организаций в ведении ФСИН); Очная	"    в том числе:
    переведено на другие формы обучения данной
    организации на программы того же уровня / 7.0"	0	2	0	0	2	0	0	0	0	0	2	0	0	4	6	0	0	0	0	0
Ненецкий автономный округ	Государственные, муниципальные (без учета организаций в ведении ФСИН); Очная	"    в том числе:
    переведено с других форм обучения данной
    образовательной организации с программ того же уровня / 2.0"	1	7	0	0	8	0	0	0	0	0	4	0	0	0	4	1	0	0	0	1
Ненецкий автономный округ	Государственные, муниципальные (без учета организаций в ведении ФСИН); Очная	    восстановлены из числа ранее отчисленных / 4.0	0	1	0	0	1	0	0	0	0	0	10	0	0	5	15	0	0	0	0	0
Ненецкий автономный округ	Государственные, муниципальные (без учета организаций в ведении ФСИН); Очная	    выбыло по другим причинам / 16.0	0	1	0	0	1	0	0	0	0	0	4	1	0	0	5	0	0	0	0	0
Ненецкий автономный округ	Государственные, муниципальные (без учета организаций в ведении ФСИН); Очная	"    добровольно прекратили образовательные отношения
    (бросили учебу) / 10.0"	2	13	0	2	17	0	0	0	0	0	34	6	0	28	68	8	0	0	11	19
Ненецкий автономный округ	Государственные, муниципальные (без учета организаций в ведении ФСИН); Очная	"    отчислено:
         по неуспеваемости / 11.0"	0	36	0	0	36	0	0	0	0	0	19	7	0	7	33	2	0	0	2	4
Ненецкий автономный округ	Государственные, муниципальные (без учета организаций в ведении ФСИН); Очная	"    переведено в другие образовательные организации
    на программы того же уровня / 8.0"	0	0	0	0	0	0	0	0	0	0	3	1	0	5	9	0	0	0	0	0
Ненецкий автономный округ	Государственные, муниципальные (без учета организаций в ведении ФСИН); Очная	"    переведено из других образовательных организаций 
    с программ того же уровня / 3.0"	0	4	0	0	4	0	0	0	0	0	4	0	0	0	4	0	0	0	2	2
Ненецкий автономный округ	Государственные, муниципальные (без учета организаций в ведении ФСИН); Очная	    по болезни / 9.0	0	0	0	0	0	0	0	0	0	0	0	0	0	0	0	0	0	0	0	0
Ненецкий автономный округ	Государственные, муниципальные (без учета организаций в ведении ФСИН); Очная	    прибыло по другим причинам / 5.0	0	3	0	0	3	0	0	0	0	0	0	0	0	0	0	0	0	0	0	0
Ненецкий автономный округ	Государственные, муниципальные (без учета организаций в ведении ФСИН); Очная	Выбыло студентов - всего (сумма стр. 07-11, 13-15) / 6.0	2	52	0	2	56	0	0	0	0	0	62	15	0	44	121	10	0	0	13	23
Ненецкий автономный округ	Государственные, муниципальные (без учета организаций в ведении ФСИН); Очная	Прибыло студентов - всего (сумма стр. 02-05) / 1.0	1	15	0	0	16	0	0	0	0	0	18	0	0	5	23	1	0	0	2	3
Ненецкий автономный округ	Государственные, муниципальные (без учета организаций в ведении ФСИН); Очная	"Численность студентов на начало прошлого учебного года
(на 1 октября) / 17.0"	25	245	0	7	277	0	0	0	0	0	471	68	0	168	707	60	0	0	30	90
Нижегородская область	Государственные, муниципальные (без учета организаций в ведении ФСИН); Заочная	            из стр. 11 - не прошли итоговую аттестацию / 12.0	0	0	0	0	0	0	0	0	0	0	0	0	0	0	0	9	0	2	1	12
Нижегородская область	Государственные, муниципальные (без учета организаций в ведении ФСИН); Заочная	"            из стр. 11 – лица с ограниченными возможностями здоровья,
            инвалиды, дети-инвалиды / 13.0"	0	0	0	0	0	0	0	0	0	0	0	0	0	0	0	0	0	0	0	0
Нижегородская область	Государственные, муниципальные (без учета организаций в ведении ФСИН); Заочная	         отчислено в виде меры дисциплинарного взыскания / 14.0	0	0	0	0	0	0	0	0	0	0	0	0	0	0	0	0	0	0	0	0
Нижегородская область	Государственные, муниципальные (без учета организаций в ведении ФСИН); Заочная	         отчислено из-за просрочки оплаты обучения / 15.0	0	0	0	0	0	0	0	0	0	0	0	0	0	13	13	0	0	0	29	29
Нижегородская область	Государственные, муниципальные (без учета организаций в ведении ФСИН); Заочная	"    в том числе:
    переведено на другие формы обучения данной
    организации на программы того же уровня / 7.0"	0	0	0	0	0	0	0	0	0	0	0	0	0	0	0	7	0	1	5	13
Нижегородская область	Государственные, муниципальные (без учета организаций в ведении ФСИН); Заочная	"    в том числе:
    переведено с других форм обучения данной
    образовательной организации с программ того же уровня / 2.0"	0	0	0	0	0	0	0	0	0	0	1	0	0	12	13	18	0	5	23	46
Нижегородская область	Государственные, муниципальные (без учета организаций в ведении ФСИН); Заочная	    восстановлены из числа ранее отчисленных / 4.0	0	0	0	0	0	0	0	0	0	0	1	0	0	9	10	17	0	5	15	37
Нижегородская область	Государственные, муниципальные (без учета организаций в ведении ФСИН); Заочная	    выбыло по другим причинам / 16.0	0	0	0	0	0	0	0	0	0	0	0	0	0	20	20	77	0	0	56	133
Нижегородская область	Государственные, муниципальные (без учета организаций в ведении ФСИН); Заочная	"    добровольно прекратили образовательные отношения
    (бросили учебу) / 10.0"	0	0	0	0	0	0	0	0	0	0	1	0	0	9	10	146	0	24	54	224
Нижегородская область	Государственные, муниципальные (без учета организаций в ведении ФСИН); Заочная	"    отчислено:
         по неуспеваемости / 11.0"	0	0	0	0	0	0	0	0	0	0	2	0	0	6	8	100	0	46	31	177
Нижегородская область	Государственные, муниципальные (без учета организаций в ведении ФСИН); Заочная	"    переведено в другие образовательные организации
    на программы того же уровня / 8.0"	0	0	0	0	0	0	0	0	0	0	0	0	0	2	2	4	0	0	1	5
Нижегородская область	Государственные, муниципальные (без учета организаций в ведении ФСИН); Заочная	"    переведено из других образовательных организаций 
    с программ того же уровня / 3.0"	0	0	0	0	0	0	0	0	0	0	0	0	0	0	0	4	0	1	9	14
Нижегородская область	Государственные, муниципальные (без учета организаций в ведении ФСИН); Заочная	    по болезни / 9.0	0	0	0	0	0	0	0	0	0	0	0	0	0	0	0	0	0	0	0	0
Нижегородская область	Государственные, муниципальные (без учета организаций в ведении ФСИН); Заочная	    прибыло по другим причинам / 5.0	0	0	0	0	0	0	0	0	0	0	0	0	0	0	0	52	0	0	19	71
Нижегородская область	Государственные, муниципальные (без учета организаций в ведении ФСИН); Заочная	Выбыло студентов - всего (сумма стр. 07-11, 13-15) / 6.0	0	0	0	0	0	0	0	0	0	0	3	0	0	50	53	334	0	71	176	581
Нижегородская область	Государственные, муниципальные (без учета организаций в ведении ФСИН); Заочная	Прибыло студентов - всего (сумма стр. 02-05) / 1.0	0	0	0	0	0	0	0	0	0	0	2	0	0	21	23	91	0	11	66	168
Нижегородская область	Государственные, муниципальные (без учета организаций в ведении ФСИН); Заочная	"Численность студентов на начало прошлого учебного года
(на 1 октября) / 17.0"	0	0	0	0	0	0	0	0	0	0	50	0	0	469	519	2844	0	270	1343	4457
Нижегородская область	Государственные, муниципальные (без учета организаций в ведении ФСИН); Очная	            из стр. 11 - не прошли итоговую аттестацию / 12.0	3	0	0	0	3	0	0	0	0	0	3	0	1	7	11	0	0	0	4	4
Нижегородская область	Государственные, муниципальные (без учета организаций в ведении ФСИН); Очная	"            из стр. 11 – лица с ограниченными возможностями здоровья,
            инвалиды, дети-инвалиды / 13.0"	0	0	0	0	0	0	0	0	0	0	1	0	0	1	2	0	0	0	0	0
Нижегородская область	Государственные, муниципальные (без учета организаций в ведении ФСИН); Очная	         отчислено в виде меры дисциплинарного взыскания / 14.0	3	0	0	0	3	0	0	0	0	0	4	0	0	1	5	0	0	0	0	0
Нижегородская область	Государственные, муниципальные (без учета организаций в ведении ФСИН); Очная	         отчислено из-за просрочки оплаты обучения / 15.0	0	0	0	1	1	0	0	0	0	0	0	0	0	36	36	0	0	0	14	14
Нижегородская область	Государственные, муниципальные (без учета организаций в ведении ФСИН); Очная	"    в том числе:
    переведено на другие формы обучения данной
    организации на программы того же уровня / 7.0"	21	0	0	3	24	0	0	0	0	0	83	0	4	82	169	4	0	1	10	15
Нижегородская область	Государственные, муниципальные (без учета организаций в ведении ФСИН); Очная	"    в том числе:
    переведено с других форм обучения данной
    образовательной организации с программ того же уровня / 2.0"	52	0	0	0	52	1	0	0	0	1	87	0	21	11	119	2	0	4	4	10
Нижегородская область	Государственные, муниципальные (без учета организаций в ведении ФСИН); Очная	    восстановлены из числа ранее отчисленных / 4.0	24	0	0	0	24	0	0	0	0	0	97	0	19	118	234	1	0	1	20	22
Нижегородская область	Государственные, муниципальные (без учета организаций в ведении ФСИН); Очная	    выбыло по другим причинам / 16.0	286	0	0	7	293	7	0	0	0	7	443	0	0	78	521	6	0	0	13	19
Нижегородская область	Государственные, муниципальные (без учета организаций в ведении ФСИН); Очная	"    добровольно прекратили образовательные отношения
    (бросили учебу) / 10.0"	392	0	0	2	394	4	0	0	0	4	1195	0	159	523	1877	127	0	12	124	263
Нижегородская область	Государственные, муниципальные (без учета организаций в ведении ФСИН); Очная	"    отчислено:
         по неуспеваемости / 11.0"	74	0	0	0	74	1	0	0	0	1	172	0	15	123	310	6	0	7	50	63
Нижегородская область	Государственные, муниципальные (без учета организаций в ведении ФСИН); Очная	"    переведено в другие образовательные организации
    на программы того же уровня / 8.0"	72	0	0	0	72	1	0	0	0	1	320	0	17	153	490	13	0	0	19	32
Нижегородская область	Государственные, муниципальные (без учета организаций в ведении ФСИН); Очная	"    переведено из других образовательных организаций 
    с программ того же уровня / 3.0"	55	0	0	0	55	0	0	0	0	0	263	0	11	75	349	3	0	0	6	9
Нижегородская область	Государственные, муниципальные (без учета организаций в ведении ФСИН); Очная	    по болезни / 9.0	1	0	0	0	1	0	0	0	0	0	4	0	0	1	5	0	0	0	0	0
Нижегородская область	Государственные, муниципальные (без учета организаций в ведении ФСИН); Очная	    прибыло по другим причинам / 5.0	64	0	0	2	66	3	0	0	0	3	190	0	2	63	255	2	0	0	11	13
Нижегородская область	Государственные, муниципальные (без учета организаций в ведении ФСИН); Очная	Выбыло студентов - всего (сумма стр. 07-11, 13-15) / 6.0	849	0	0	13	862	13	0	0	0	13	2221	0	195	997	3413	156	0	20	230	406
Нижегородская область	Государственные, муниципальные (без учета организаций в ведении ФСИН); Очная	Прибыло студентов - всего (сумма стр. 02-05) / 1.0	195	0	0	2	197	4	0	0	0	4	637	0	53	267	957	8	0	5	41	54
Нижегородская область	Государственные, муниципальные (без учета организаций в ведении ФСИН); Очная	"Численность студентов на начало прошлого учебного года
(на 1 октября) / 17.0"	10932	0	0	89	11021	160	0	0	0	160	34815	189	3583	9224	47811	1793	0	180	2356	4329
Нижегородская область	Очно-заочная; Государственные, муниципальные (без учета организаций в ведении ФСИН)	            из стр. 11 - не прошли итоговую аттестацию / 12.0	0	0	0	0	0	0	0	0	0	0	0	0	0	0	0	0	0	0	0	0
Нижегородская область	Очно-заочная; Государственные, муниципальные (без учета организаций в ведении ФСИН)	"            из стр. 11 – лица с ограниченными возможностями здоровья,
            инвалиды, дети-инвалиды / 13.0"	0	0	0	0	0	0	0	0	0	0	0	0	0	0	0	0	0	0	0	0
Нижегородская область	Очно-заочная; Государственные, муниципальные (без учета организаций в ведении ФСИН)	         отчислено в виде меры дисциплинарного взыскания / 14.0	0	0	0	0	0	0	0	0	0	0	0	0	0	0	0	0	0	0	0	0
Нижегородская область	Очно-заочная; Государственные, муниципальные (без учета организаций в ведении ФСИН)	         отчислено из-за просрочки оплаты обучения / 15.0	0	0	0	0	0	0	0	0	0	0	0	0	0	0	0	0	0	0	19	19
Нижегородская область	Очно-заочная; Государственные, муниципальные (без учета организаций в ведении ФСИН)	"    в том числе:
    переведено на другие формы обучения данной
    организации на программы того же уровня / 7.0"	0	0	0	0	0	0	0	0	0	0	0	0	0	0	0	0	0	0	0	0
Нижегородская область	Очно-заочная; Государственные, муниципальные (без учета организаций в ведении ФСИН)	"    в том числе:
    переведено с других форм обучения данной
    образовательной организации с программ того же уровня / 2.0"	0	0	0	0	0	0	0	0	0	0	0	0	0	0	0	0	0	0	5	5
Нижегородская область	Очно-заочная; Государственные, муниципальные (без учета организаций в ведении ФСИН)	    восстановлены из числа ранее отчисленных / 4.0	0	0	0	0	0	0	0	0	0	0	0	0	0	0	0	2	0	0	9	11
Нижегородская область	Очно-заочная; Государственные, муниципальные (без учета организаций в ведении ФСИН)	    выбыло по другим причинам / 16.0	0	0	0	0	0	5	0	0	0	5	0	0	0	0	0	12	0	0	1	13
Нижегородская область	Очно-заочная; Государственные, муниципальные (без учета организаций в ведении ФСИН)	"    добровольно прекратили образовательные отношения
    (бросили учебу) / 10.0"	0	0	0	0	0	0	0	0	0	0	0	0	0	0	0	21	0	0	23	44
Нижегородская область	Очно-заочная; Государственные, муниципальные (без учета организаций в ведении ФСИН)	"    отчислено:
         по неуспеваемости / 11.0"	0	0	0	0	0	0	0	0	0	0	0	0	0	0	0	5	0	0	3	8
Нижегородская область	Очно-заочная; Государственные, муниципальные (без учета организаций в ведении ФСИН)	"    переведено в другие образовательные организации
    на программы того же уровня / 8.0"	0	0	0	0	0	0	0	0	0	0	0	0	0	0	0	1	0	0	2	3
Нижегородская область	Очно-заочная; Государственные, муниципальные (без учета организаций в ведении ФСИН)	"    переведено из других образовательных организаций 
    с программ того же уровня / 3.0"	0	0	0	0	0	0	0	0	0	0	0	0	0	0	0	0	0	0	1	1
Нижегородская область	Очно-заочная; Государственные, муниципальные (без учета организаций в ведении ФСИН)	    по болезни / 9.0	0	0	0	0	0	0	0	0	0	0	0	0	0	0	0	0	0	0	0	0
Нижегородская область	Очно-заочная; Государственные, муниципальные (без учета организаций в ведении ФСИН)	    прибыло по другим причинам / 5.0	0	0	0	0	0	0	0	0	0	0	0	0	0	0	0	8	0	0	2	10
Нижегородская область	Очно-заочная; Государственные, муниципальные (без учета организаций в ведении ФСИН)	Выбыло студентов - всего (сумма стр. 07-11, 13-15) / 6.0	0	0	0	0	0	5	0	0	0	5	0	0	0	0	0	39	0	0	48	87
Нижегородская область	Очно-заочная; Государственные, муниципальные (без учета организаций в ведении ФСИН)	Прибыло студентов - всего (сумма стр. 02-05) / 1.0	0	0	0	0	0	0	0	0	0	0	0	0	0	0	0	10	0	0	17	27
Нижегородская область	Очно-заочная; Государственные, муниципальные (без учета организаций в ведении ФСИН)	"Численность студентов на начало прошлого учебного года
(на 1 октября) / 17.0"	0	0	0	0	0	25	0	0	0	25	0	0	0	0	0	544	0	0	684	1228
Нижегородская область	Частные; Заочная	            из стр. 11 - не прошли итоговую аттестацию / 12.0	0	0	0	0	0	0	0	0	0	0	0	0	0	0	0	0	0	0	0	0
Нижегородская область	Частные; Заочная	"            из стр. 11 – лица с ограниченными возможностями здоровья,
            инвалиды, дети-инвалиды / 13.0"	0	0	0	0	0	0	0	0	0	0	0	0	0	0	0	0	0	0	0	0
Нижегородская область	Частные; Заочная	         отчислено в виде меры дисциплинарного взыскания / 14.0	0	0	0	0	0	0	0	0	0	0	0	0	0	0	0	0	0	0	0	0
Нижегородская область	Частные; Заочная	         отчислено из-за просрочки оплаты обучения / 15.0	0	0	0	0	0	0	0	0	0	0	0	0	0	76	76	0	0	0	43	43
Нижегородская область	Частные; Заочная	"    в том числе:
    переведено на другие формы обучения данной
    организации на программы того же уровня / 7.0"	0	0	0	0	0	0	0	0	0	0	0	0	0	17	17	0	0	0	104	104
Нижегородская область	Частные; Заочная	"    в том числе:
    переведено с других форм обучения данной
    образовательной организации с программ того же уровня / 2.0"	0	0	0	0	0	0	0	0	0	0	0	0	0	90	90	0	0	0	99	99
Нижегородская область	Частные; Заочная	    восстановлены из числа ранее отчисленных / 4.0	0	0	0	0	0	0	0	0	0	0	0	0	0	30	30	0	0	0	34	34
Нижегородская область	Частные; Заочная	    выбыло по другим причинам / 16.0	0	0	0	0	0	0	0	0	0	0	0	0	0	19	19	0	0	0	26	26
Нижегородская область	Частные; Заочная	"    добровольно прекратили образовательные отношения
    (бросили учебу) / 10.0"	0	0	0	0	0	0	0	0	0	0	0	0	0	61	61	0	0	0	25	25
Нижегородская область	Частные; Заочная	"    отчислено:
         по неуспеваемости / 11.0"	0	0	0	0	0	0	0	0	0	0	0	0	0	193	193	0	0	0	135	135
Нижегородская область	Частные; Заочная	"    переведено в другие образовательные организации
    на программы того же уровня / 8.0"	0	0	0	0	0	0	0	0	0	0	0	0	0	22	22	0	0	0	6	6
Нижегородская область	Частные; Заочная	"    переведено из других образовательных организаций 
    с программ того же уровня / 3.0"	0	0	0	0	0	0	0	0	0	0	0	0	0	57	57	0	0	0	34	34
Нижегородская область	Частные; Заочная	    по болезни / 9.0	0	0	0	0	0	0	0	0	0	0	0	0	0	0	0	0	0	0	0	0
Нижегородская область	Частные; Заочная	    прибыло по другим причинам / 5.0	0	0	0	0	0	0	0	0	0	0	0	0	0	4	4	0	0	0	0	0
Нижегородская область	Частные; Заочная	Выбыло студентов - всего (сумма стр. 07-11, 13-15) / 6.0	0	0	0	0	0	0	0	0	0	0	0	0	0	388	388	0	0	0	339	339
Нижегородская область	Частные; Заочная	Прибыло студентов - всего (сумма стр. 02-05) / 1.0	0	0	0	0	0	0	0	0	0	0	0	0	0	181	181	0	0	0	167	167
Нижегородская область	Частные; Заочная	"Численность студентов на начало прошлого учебного года
(на 1 октября) / 17.0"	0	0	0	0	0	0	0	0	0	0	0	0	0	2461	2461	0	0	0	1919	1919
Нижегородская область	Частные; Очная	            из стр. 11 - не прошли итоговую аттестацию / 12.0	0	0	0	0	0	0	0	0	0	0	0	0	0	1	1	0	0	0	0	0
Нижегородская область	Частные; Очная	"            из стр. 11 – лица с ограниченными возможностями здоровья,
            инвалиды, дети-инвалиды / 13.0"	0	0	0	0	0	0	0	0	0	0	0	0	0	0	0	0	0	0	0	0
Нижегородская область	Частные; Очная	         отчислено в виде меры дисциплинарного взыскания / 14.0	0	0	0	0	0	0	0	0	0	0	0	0	0	1	1	0	0	0	0	0
Нижегородская область	Частные; Очная	         отчислено из-за просрочки оплаты обучения / 15.0	0	0	0	0	0	0	0	0	0	0	0	0	0	62	62	0	0	0	8	8
Нижегородская область	Частные; Очная	"    в том числе:
    переведено на другие формы обучения данной
    организации на программы того же уровня / 7.0"	0	0	0	0	0	0	0	0	0	0	0	0	0	72	72	0	0	0	17	17
Нижегородская область	Частные; Очная	"    в том числе:
    переведено с других форм обучения данной
    образовательной организации с программ того же уровня / 2.0"	0	0	0	0	0	0	0	0	0	0	0	0	0	17	17	0	0	0	2	2
Нижегородская область	Частные; Очная	    восстановлены из числа ранее отчисленных / 4.0	0	0	0	0	0	0	0	0	0	0	0	0	0	10	10	0	0	0	5	5
Нижегородская область	Частные; Очная	    выбыло по другим причинам / 16.0	0	0	0	0	0	0	0	0	0	0	0	0	0	2	2	0	0	0	3	3
Нижегородская область	Частные; Очная	"    добровольно прекратили образовательные отношения
    (бросили учебу) / 10.0"	0	0	0	0	0	0	0	0	0	0	0	0	0	51	51	0	0	0	12	12
Нижегородская область	Частные; Очная	"    отчислено:
         по неуспеваемости / 11.0"	0	0	0	0	0	0	0	0	0	0	0	0	0	45	45	0	0	0	12	12
Нижегородская область	Частные; Очная	"    переведено в другие образовательные организации
    на программы того же уровня / 8.0"	0	0	0	0	0	0	0	0	0	0	0	0	0	22	22	0	0	0	0	0
Нижегородская область	Частные; Очная	"    переведено из других образовательных организаций 
    с программ того же уровня / 3.0"	0	0	0	0	0	0	0	0	0	0	0	0	0	35	35	0	0	0	3	3
Нижегородская область	Частные; Очная	    по болезни / 9.0	0	0	0	0	0	0	0	0	0	0	0	0	0	0	0	0	0	0	0	0
Нижегородская область	Частные; Очная	    прибыло по другим причинам / 5.0	0	0	0	0	0	0	0	0	0	0	0	0	0	0	0	0	0	0	2	2
Нижегородская область	Частные; Очная	Выбыло студентов - всего (сумма стр. 07-11, 13-15) / 6.0	0	0	0	0	0	0	0	0	0	0	0	0	0	255	255	0	0	0	52	52
Нижегородская область	Частные; Очная	Прибыло студентов - всего (сумма стр. 02-05) / 1.0	0	0	0	0	0	0	0	0	0	0	0	0	0	62	62	0	0	0	12	12
Нижегородская область	Частные; Очная	"Численность студентов на начало прошлого учебного года
(на 1 октября) / 17.0"	0	0	0	0	0	0	0	0	0	0	0	0	0	1808	1808	0	0	0	244	244
Новгородская область	Государственные, муниципальные (без учета организаций в ведении ФСИН); Заочная	            из стр. 11 - не прошли итоговую аттестацию / 12.0	0	0	0	0	0	0	0	0	0	0	0	0	0	0	0	0	0	0	0	0
Новгородская область	Государственные, муниципальные (без учета организаций в ведении ФСИН); Заочная	"            из стр. 11 – лица с ограниченными возможностями здоровья,
            инвалиды, дети-инвалиды / 13.0"	0	0	0	0	0	0	0	0	0	0	0	0	0	0	0	0	0	0	0	0
Новгородская область	Государственные, муниципальные (без учета организаций в ведении ФСИН); Заочная	         отчислено в виде меры дисциплинарного взыскания / 14.0	0	0	0	0	0	0	0	0	0	0	0	0	0	0	0	0	0	0	0	0
Новгородская область	Государственные, муниципальные (без учета организаций в ведении ФСИН); Заочная	         отчислено из-за просрочки оплаты обучения / 15.0	0	0	0	0	0	0	0	0	0	0	0	0	0	0	0	0	0	0	2	2
Новгородская область	Государственные, муниципальные (без учета организаций в ведении ФСИН); Заочная	"    в том числе:
    переведено на другие формы обучения данной
    организации на программы того же уровня / 7.0"	0	0	0	0	0	0	0	0	0	0	0	0	0	0	0	0	0	0	0	0
Новгородская область	Государственные, муниципальные (без учета организаций в ведении ФСИН); Заочная	"    в том числе:
    переведено с других форм обучения данной
    образовательной организации с программ того же уровня / 2.0"	0	0	0	0	0	0	0	0	0	0	0	0	0	0	0	4	0	0	9	13
Новгородская область	Государственные, муниципальные (без учета организаций в ведении ФСИН); Заочная	    восстановлены из числа ранее отчисленных / 4.0	0	0	0	0	0	0	0	0	0	0	0	0	0	0	0	1	0	0	5	6
Новгородская область	Государственные, муниципальные (без учета организаций в ведении ФСИН); Заочная	    выбыло по другим причинам / 16.0	0	0	0	0	0	0	0	0	0	0	0	0	0	0	0	63	0	0	16	79
Новгородская область	Государственные, муниципальные (без учета организаций в ведении ФСИН); Заочная	"    добровольно прекратили образовательные отношения
    (бросили учебу) / 10.0"	0	0	0	0	0	0	0	0	0	0	0	0	0	0	0	21	6	0	12	39
Новгородская область	Государственные, муниципальные (без учета организаций в ведении ФСИН); Заочная	"    отчислено:
         по неуспеваемости / 11.0"	0	0	0	0	0	0	0	0	0	0	0	0	0	0	0	13	0	0	11	24
Новгородская область	Государственные, муниципальные (без учета организаций в ведении ФСИН); Заочная	"    переведено в другие образовательные организации
    на программы того же уровня / 8.0"	0	0	0	0	0	0	0	0	0	0	0	0	0	0	0	3	0	0	0	3
Новгородская область	Государственные, муниципальные (без учета организаций в ведении ФСИН); Заочная	"    переведено из других образовательных организаций 
    с программ того же уровня / 3.0"	0	0	0	0	0	0	0	0	0	0	0	0	0	0	0	1	0	0	0	1
Новгородская область	Государственные, муниципальные (без учета организаций в ведении ФСИН); Заочная	    по болезни / 9.0	0	0	0	0	0	0	0	0	0	0	0	0	0	0	0	2	0	0	0	2
Новгородская область	Государственные, муниципальные (без учета организаций в ведении ФСИН); Заочная	    прибыло по другим причинам / 5.0	0	0	0	0	0	0	0	0	0	0	0	0	0	0	0	6	0	0	7	13
Новгородская область	Государственные, муниципальные (без учета организаций в ведении ФСИН); Заочная	Выбыло студентов - всего (сумма стр. 07-11, 13-15) / 6.0	0	0	0	0	0	0	0	0	0	0	0	0	0	0	0	102	6	0	41	149
Новгородская область	Государственные, муниципальные (без учета организаций в ведении ФСИН); Заочная	Прибыло студентов - всего (сумма стр. 02-05) / 1.0	0	0	0	0	0	0	0	0	0	0	0	0	0	0	0	12	0	0	21	33
Новгородская область	Государственные, муниципальные (без учета организаций в ведении ФСИН); Заочная	"Численность студентов на начало прошлого учебного года
(на 1 октября) / 17.0"	0	0	0	0	0	0	0	0	0	0	0	0	0	43	43	709	93	15	318	1135
Новгородская область	Государственные, муниципальные (без учета организаций в ведении ФСИН); Очная	            из стр. 11 - не прошли итоговую аттестацию / 12.0	22	0	0	1	23	0	0	0	0	0	18	0	0	2	20	0	0	0	0	0
Новгородская область	Государственные, муниципальные (без учета организаций в ведении ФСИН); Очная	"            из стр. 11 – лица с ограниченными возможностями здоровья,
            инвалиды, дети-инвалиды / 13.0"	0	0	0	0	0	0	0	0	0	0	2	0	0	0	2	0	0	0	0	0
Новгородская область	Государственные, муниципальные (без учета организаций в ведении ФСИН); Очная	         отчислено в виде меры дисциплинарного взыскания / 14.0	4	0	0	0	4	5	0	0	0	5	12	0	0	5	17	1	0	0	0	1
Новгородская область	Государственные, муниципальные (без учета организаций в ведении ФСИН); Очная	         отчислено из-за просрочки оплаты обучения / 15.0	0	0	0	8	8	0	0	0	0	0	0	0	0	4	4	0	0	0	1	1
Новгородская область	Государственные, муниципальные (без учета организаций в ведении ФСИН); Очная	"    в том числе:
    переведено на другие формы обучения данной
    организации на программы того же уровня / 7.0"	8	0	0	2	10	0	0	0	0	0	2	0	0	22	24	4	0	0	3	7
Новгородская область	Государственные, муниципальные (без учета организаций в ведении ФСИН); Очная	"    в том числе:
    переведено с других форм обучения данной
    образовательной организации с программ того же уровня / 2.0"	1	0	3	0	4	0	0	0	0	0	27	0	2	11	40	2	0	0	1	3
Новгородская область	Государственные, муниципальные (без учета организаций в ведении ФСИН); Очная	    восстановлены из числа ранее отчисленных / 4.0	0	0	0	0	0	0	0	0	0	0	8	0	5	31	44	5	0	2	10	17
Новгородская область	Государственные, муниципальные (без учета организаций в ведении ФСИН); Очная	    выбыло по другим причинам / 16.0	58	0	1	5	64	1	0	0	0	1	92	0	0	35	127	17	0	0	0	17
Новгородская область	Государственные, муниципальные (без учета организаций в ведении ФСИН); Очная	"    добровольно прекратили образовательные отношения
    (бросили учебу) / 10.0"	99	0	4	31	134	4	0	0	5	9	237	0	72	209	518	18	0	24	52	94
Новгородская область	Государственные, муниципальные (без учета организаций в ведении ФСИН); Очная	"    отчислено:
         по неуспеваемости / 11.0"	60	0	0	3	63	0	0	0	0	0	77	0	2	16	95	11	0	2	6	19
Новгородская область	Государственные, муниципальные (без учета организаций в ведении ФСИН); Очная	"    переведено в другие образовательные организации
    на программы того же уровня / 8.0"	16	0	3	5	24	0	0	0	0	0	98	0	9	38	145	4	0	2	10	16
Новгородская область	Государственные, муниципальные (без учета организаций в ведении ФСИН); Очная	"    переведено из других образовательных организаций 
    с программ того же уровня / 3.0"	7	0	0	7	14	0	0	0	0	0	107	0	8	17	132	10	0	0	3	13
Новгородская область	Государственные, муниципальные (без учета организаций в ведении ФСИН); Очная	    по болезни / 9.0	12	0	1	0	13	0	0	0	0	0	2	0	0	0	2	0	0	0	0	0
Новгородская область	Государственные, муниципальные (без учета организаций в ведении ФСИН); Очная	    прибыло по другим причинам / 5.0	6	0	0	7	13	0	0	0	0	0	12	0	1	24	37	2	0	3	6	11
Новгородская область	Государственные, муниципальные (без учета организаций в ведении ФСИН); Очная	Выбыло студентов - всего (сумма стр. 07-11, 13-15) / 6.0	257	0	9	54	320	10	0	0	5	15	520	0	83	329	932	55	0	28	72	155
Новгородская область	Государственные, муниципальные (без учета организаций в ведении ФСИН); Очная	Прибыло студентов - всего (сумма стр. 02-05) / 1.0	14	0	3	14	31	0	0	0	0	0	154	0	16	83	253	19	0	5	20	44
Новгородская область	Государственные, муниципальные (без учета организаций в ведении ФСИН); Очная	"Численность студентов на начало прошлого учебного года
(на 1 октября) / 17.0"	2653	0	99	367	3119	65	0	0	61	126	6646	0	1116	1644	9406	501	0	200	501	1202
Новгородская область	Очно-заочная; Государственные, муниципальные (без учета организаций в ведении ФСИН)	            из стр. 11 - не прошли итоговую аттестацию / 12.0	0	0	0	0	0	0	0	0	0	0	0	0	0	0	0	0	0	0	0	0
Новгородская область	Очно-заочная; Государственные, муниципальные (без учета организаций в ведении ФСИН)	"            из стр. 11 – лица с ограниченными возможностями здоровья,
            инвалиды, дети-инвалиды / 13.0"	0	0	0	0	0	0	0	0	0	0	0	0	0	0	0	0	0	0	0	0
Новгородская область	Очно-заочная; Государственные, муниципальные (без учета организаций в ведении ФСИН)	         отчислено в виде меры дисциплинарного взыскания / 14.0	0	0	0	0	0	0	0	0	0	0	0	0	0	0	0	0	0	0	0	0
Новгородская область	Очно-заочная; Государственные, муниципальные (без учета организаций в ведении ФСИН)	         отчислено из-за просрочки оплаты обучения / 15.0	0	0	0	0	0	0	0	0	0	0	0	0	0	0	0	0	0	0	0	0
Новгородская область	Очно-заочная; Государственные, муниципальные (без учета организаций в ведении ФСИН)	"    в том числе:
    переведено на другие формы обучения данной
    организации на программы того же уровня / 7.0"	0	0	0	0	0	0	0	0	0	0	0	0	0	0	0	0	0	0	0	0
Новгородская область	Очно-заочная; Государственные, муниципальные (без учета организаций в ведении ФСИН)	"    в том числе:
    переведено с других форм обучения данной
    образовательной организации с программ того же уровня / 2.0"	0	0	0	0	0	0	0	0	0	0	0	0	0	0	0	0	0	0	1	1
Новгородская область	Очно-заочная; Государственные, муниципальные (без учета организаций в ведении ФСИН)	    восстановлены из числа ранее отчисленных / 4.0	0	0	0	0	0	0	0	0	0	0	0	0	0	0	0	0	0	0	6	6
Новгородская область	Очно-заочная; Государственные, муниципальные (без учета организаций в ведении ФСИН)	    выбыло по другим причинам / 16.0	0	0	0	0	0	0	0	0	0	0	0	0	0	0	0	0	0	0	0	0
Новгородская область	Очно-заочная; Государственные, муниципальные (без учета организаций в ведении ФСИН)	"    добровольно прекратили образовательные отношения
    (бросили учебу) / 10.0"	0	0	0	0	0	0	0	0	0	0	0	0	0	0	0	0	0	0	16	16
Новгородская область	Очно-заочная; Государственные, муниципальные (без учета организаций в ведении ФСИН)	"    отчислено:
         по неуспеваемости / 11.0"	0	0	0	0	0	0	0	0	0	0	0	0	0	0	0	0	0	0	3	3
Новгородская область	Очно-заочная; Государственные, муниципальные (без учета организаций в ведении ФСИН)	"    переведено в другие образовательные организации
    на программы того же уровня / 8.0"	0	0	0	0	0	0	0	0	0	0	0	0	0	0	0	0	0	0	0	0
Новгородская область	Очно-заочная; Государственные, муниципальные (без учета организаций в ведении ФСИН)	"    переведено из других образовательных организаций 
    с программ того же уровня / 3.0"	0	0	0	0	0	0	0	0	0	0	0	0	0	0	0	0	0	0	0	0
Новгородская область	Очно-заочная; Государственные, муниципальные (без учета организаций в ведении ФСИН)	    по болезни / 9.0	0	0	0	0	0	0	0	0	0	0	0	0	0	0	0	0	0	0	0	0
Новгородская область	Очно-заочная; Государственные, муниципальные (без учета организаций в ведении ФСИН)	    прибыло по другим причинам / 5.0	0	0	0	0	0	0	0	0	0	0	0	0	0	0	0	0	0	0	11	11
Новгородская область	Очно-заочная; Государственные, муниципальные (без учета организаций в ведении ФСИН)	Выбыло студентов - всего (сумма стр. 07-11, 13-15) / 6.0	0	0	0	0	0	0	0	0	0	0	0	0	0	0	0	0	0	0	19	19
Новгородская область	Очно-заочная; Государственные, муниципальные (без учета организаций в ведении ФСИН)	Прибыло студентов - всего (сумма стр. 02-05) / 1.0	0	0	0	0	0	0	0	0	0	0	0	0	0	0	0	0	0	0	18	18
Новгородская область	Очно-заочная; Государственные, муниципальные (без учета организаций в ведении ФСИН)	"Численность студентов на начало прошлого учебного года
(на 1 октября) / 17.0"	0	0	0	0	0	0	0	0	0	0	0	0	0	0	0	0	0	0	179	179
Новгородская область	Частные; Заочная	            из стр. 11 - не прошли итоговую аттестацию / 12.0	0	0	0	0	0	0	0	0	0	0	0	0	0	0	0	0	0	0	0	0
Новгородская область	Частные; Заочная	"            из стр. 11 – лица с ограниченными возможностями здоровья,
            инвалиды, дети-инвалиды / 13.0"	0	0	0	0	0	0	0	0	0	0	0	0	0	0	0	0	0	0	0	0
Новгородская область	Частные; Заочная	         отчислено в виде меры дисциплинарного взыскания / 14.0	0	0	0	0	0	0	0	0	0	0	0	0	0	0	0	0	0	0	0	0
Новгородская область	Частные; Заочная	         отчислено из-за просрочки оплаты обучения / 15.0	0	0	0	0	0	0	0	0	0	0	0	0	0	0	0	0	0	0	0	0
Новгородская область	Частные; Заочная	"    в том числе:
    переведено на другие формы обучения данной
    организации на программы того же уровня / 7.0"	0	0	0	0	0	0	0	0	0	0	0	0	0	1	1	0	0	0	0	0
Новгородская область	Частные; Заочная	"    в том числе:
    переведено с других форм обучения данной
    образовательной организации с программ того же уровня / 2.0"	0	0	0	0	0	0	0	0	0	0	0	0	0	0	0	0	0	0	0	0
Новгородская область	Частные; Заочная	    восстановлены из числа ранее отчисленных / 4.0	0	0	0	0	0	0	0	0	0	0	0	0	0	4	4	0	0	0	0	0
Новгородская область	Частные; Заочная	    выбыло по другим причинам / 16.0	0	0	0	0	0	0	0	0	0	0	0	0	0	0	0	0	0	0	0	0
Новгородская область	Частные; Заочная	"    добровольно прекратили образовательные отношения
    (бросили учебу) / 10.0"	0	0	0	0	0	0	0	0	0	0	0	0	0	0	0	0	0	0	0	0
Новгородская область	Частные; Заочная	"    отчислено:
         по неуспеваемости / 11.0"	0	0	0	0	0	0	0	0	0	0	0	0	0	8	8	0	0	0	6	6
Новгородская область	Частные; Заочная	"    переведено в другие образовательные организации
    на программы того же уровня / 8.0"	0	0	0	0	0	0	0	0	0	0	0	0	0	0	0	0	0	0	0	0
Новгородская область	Частные; Заочная	"    переведено из других образовательных организаций 
    с программ того же уровня / 3.0"	0	0	0	0	0	0	0	0	0	0	0	0	0	5	5	0	0	0	0	0
Новгородская область	Частные; Заочная	    по болезни / 9.0	0	0	0	0	0	0	0	0	0	0	0	0	0	0	0	0	0	0	0	0
Новгородская область	Частные; Заочная	    прибыло по другим причинам / 5.0	0	0	0	0	0	0	0	0	0	0	0	0	0	0	0	0	0	0	0	0
Новгородская область	Частные; Заочная	Выбыло студентов - всего (сумма стр. 07-11, 13-15) / 6.0	0	0	0	0	0	0	0	0	0	0	0	0	0	9	9	0	0	0	6	6
Новгородская область	Частные; Заочная	Прибыло студентов - всего (сумма стр. 02-05) / 1.0	0	0	0	0	0	0	0	0	0	0	0	0	0	9	9	0	0	0	0	0
Новгородская область	Частные; Заочная	"Численность студентов на начало прошлого учебного года
(на 1 октября) / 17.0"	0	0	0	0	0	0	0	0	0	0	0	0	0	58	58	0	0	0	24	24
Новгородская область	Частные; Очная	            из стр. 11 - не прошли итоговую аттестацию / 12.0	0	0	0	0	0	0	0	0	0	0	0	0	0	0	0	0	0	0	0	0
Новгородская область	Частные; Очная	"            из стр. 11 – лица с ограниченными возможностями здоровья,
            инвалиды, дети-инвалиды / 13.0"	0	0	0	0	0	0	0	0	0	0	0	0	0	0	0	0	0	0	0	0
Новгородская область	Частные; Очная	         отчислено в виде меры дисциплинарного взыскания / 14.0	0	0	0	0	0	0	0	0	0	0	0	0	0	0	0	0	0	0	0	0
Новгородская область	Частные; Очная	         отчислено из-за просрочки оплаты обучения / 15.0	0	0	0	0	0	0	0	0	0	0	0	0	0	0	0	0	0	0	0	0
Новгородская область	Частные; Очная	"    в том числе:
    переведено на другие формы обучения данной
    организации на программы того же уровня / 7.0"	0	0	0	0	0	0	0	0	0	0	0	0	0	0	0	0	0	0	0	0
Новгородская область	Частные; Очная	"    в том числе:
    переведено с других форм обучения данной
    образовательной организации с программ того же уровня / 2.0"	0	0	0	0	0	0	0	0	0	0	0	0	0	0	0	0	0	0	0	0
Новгородская область	Частные; Очная	    восстановлены из числа ранее отчисленных / 4.0	0	0	0	0	0	0	0	0	0	0	0	0	0	0	0	0	0	0	0	0
Новгородская область	Частные; Очная	    выбыло по другим причинам / 16.0	0	0	0	0	0	0	0	0	0	0	0	0	0	0	0	0	0	0	0	0
Новгородская область	Частные; Очная	"    добровольно прекратили образовательные отношения
    (бросили учебу) / 10.0"	0	0	0	0	0	0	0	0	0	0	0	0	0	0	0	0	0	0	0	0
Новгородская область	Частные; Очная	"    отчислено:
         по неуспеваемости / 11.0"	0	0	0	0	0	0	0	0	0	0	0	0	0	3	3	0	0	0	0	0
Новгородская область	Частные; Очная	"    переведено в другие образовательные организации
    на программы того же уровня / 8.0"	0	0	0	0	0	0	0	0	0	0	0	0	0	0	0	0	0	0	0	0
Новгородская область	Частные; Очная	"    переведено из других образовательных организаций 
    с программ того же уровня / 3.0"	0	0	0	0	0	0	0	0	0	0	0	0	0	2	2	0	0	0	0	0
Новгородская область	Частные; Очная	    по болезни / 9.0	0	0	0	0	0	0	0	0	0	0	0	0	0	0	0	0	0	0	0	0
Новгородская область	Частные; Очная	    прибыло по другим причинам / 5.0	0	0	0	0	0	0	0	0	0	0	0	0	0	0	0	0	0	0	0	0
Новгородская область	Частные; Очная	Выбыло студентов - всего (сумма стр. 07-11, 13-15) / 6.0	0	0	0	0	0	0	0	0	0	0	0	0	0	3	3	0	0	0	0	0
Новгородская область	Частные; Очная	Прибыло студентов - всего (сумма стр. 02-05) / 1.0	0	0	0	0	0	0	0	0	0	0	0	0	0	2	2	0	0	0	0	0
Новгородская область	Частные; Очная	"Численность студентов на начало прошлого учебного года
(на 1 октября) / 17.0"	0	0	0	0	0	0	0	0	0	0	0	0	0	36	36	0	0	0	6	6
Новосибирская область	Государственные, муниципальные (без учета организаций в ведении ФСИН); Заочная	            из стр. 11 - не прошли итоговую аттестацию / 12.0	0	0	0	0	0	0	0	0	0	0	0	0	0	0	0	2	0	0	1	3
Новосибирская область	Государственные, муниципальные (без учета организаций в ведении ФСИН); Заочная	"            из стр. 11 – лица с ограниченными возможностями здоровья,
            инвалиды, дети-инвалиды / 13.0"	0	0	0	0	0	0	0	0	0	0	0	0	0	0	0	0	0	0	0	0
Новосибирская область	Государственные, муниципальные (без учета организаций в ведении ФСИН); Заочная	         отчислено в виде меры дисциплинарного взыскания / 14.0	0	0	0	0	0	0	0	0	0	0	0	0	0	0	0	0	0	0	0	0
Новосибирская область	Государственные, муниципальные (без учета организаций в ведении ФСИН); Заочная	         отчислено из-за просрочки оплаты обучения / 15.0	0	0	0	0	0	0	0	0	0	0	0	0	0	198	198	0	0	0	215	215
Новосибирская область	Государственные, муниципальные (без учета организаций в ведении ФСИН); Заочная	"    в том числе:
    переведено на другие формы обучения данной
    организации на программы того же уровня / 7.0"	0	0	0	0	0	0	0	0	0	0	1	0	0	8	9	2	0	0	13	15
Новосибирская область	Государственные, муниципальные (без учета организаций в ведении ФСИН); Заочная	"    в том числе:
    переведено с других форм обучения данной
    образовательной организации с программ того же уровня / 2.0"	0	0	0	0	0	0	0	0	0	0	6	0	2	88	96	6	0	2	72	80
Новосибирская область	Государственные, муниципальные (без учета организаций в ведении ФСИН); Заочная	    восстановлены из числа ранее отчисленных / 4.0	0	0	0	0	0	0	0	0	0	0	7	0	0	93	100	10	0	1	72	83
Новосибирская область	Государственные, муниципальные (без учета организаций в ведении ФСИН); Заочная	    выбыло по другим причинам / 16.0	0	0	0	0	0	0	0	0	0	0	0	0	0	41	41	19	0	11	88	118
Новосибирская область	Государственные, муниципальные (без учета организаций в ведении ФСИН); Заочная	"    добровольно прекратили образовательные отношения
    (бросили учебу) / 10.0"	0	0	0	0	0	0	0	0	0	0	15	0	0	81	96	50	0	13	206	269
Новосибирская область	Государственные, муниципальные (без учета организаций в ведении ФСИН); Заочная	"    отчислено:
         по неуспеваемости / 11.0"	0	0	0	0	0	0	0	0	0	0	35	0	2	77	114	31	0	31	91	153
Новосибирская область	Государственные, муниципальные (без учета организаций в ведении ФСИН); Заочная	"    переведено в другие образовательные организации
    на программы того же уровня / 8.0"	0	0	0	0	0	0	0	0	0	0	1	0	0	15	16	5	0	0	13	18
Новосибирская область	Государственные, муниципальные (без учета организаций в ведении ФСИН); Заочная	"    переведено из других образовательных организаций 
    с программ того же уровня / 3.0"	0	0	0	0	0	0	0	0	0	0	4	0	0	33	37	3	0	0	15	18
Новосибирская область	Государственные, муниципальные (без учета организаций в ведении ФСИН); Заочная	    по болезни / 9.0	0	0	0	0	0	0	0	0	0	0	0	0	0	5	5	0	0	0	10	10
Новосибирская область	Государственные, муниципальные (без учета организаций в ведении ФСИН); Заочная	    прибыло по другим причинам / 5.0	0	0	0	0	0	0	0	0	0	0	4	0	0	31	35	17	0	1	84	102
Новосибирская область	Государственные, муниципальные (без учета организаций в ведении ФСИН); Заочная	Выбыло студентов - всего (сумма стр. 07-11, 13-15) / 6.0	0	0	0	0	0	0	0	0	0	0	52	0	2	425	479	107	0	55	636	798
Новосибирская область	Государственные, муниципальные (без учета организаций в ведении ФСИН); Заочная	Прибыло студентов - всего (сумма стр. 02-05) / 1.0	0	0	0	0	0	0	0	0	0	0	21	0	2	245	268	36	0	4	243	283
Новосибирская область	Государственные, муниципальные (без учета организаций в ведении ФСИН); Заочная	"Численность студентов на начало прошлого учебного года
(на 1 октября) / 17.0"	0	0	0	0	0	0	0	0	0	0	252	0	12	1416	1680	916	0	377	3029	4322
Новосибирская область	Государственные, муниципальные (без учета организаций в ведении ФСИН); Очная	            из стр. 11 - не прошли итоговую аттестацию / 12.0	9	0	0	0	9	0	0	0	0	0	7	0	0	17	24	8	0	0	0	8
Новосибирская область	Государственные, муниципальные (без учета организаций в ведении ФСИН); Очная	"            из стр. 11 – лица с ограниченными возможностями здоровья,
            инвалиды, дети-инвалиды / 13.0"	0	0	0	0	0	0	0	0	0	0	1	0	0	0	1	1	0	0	0	1
Новосибирская область	Государственные, муниципальные (без учета организаций в ведении ФСИН); Очная	         отчислено в виде меры дисциплинарного взыскания / 14.0	1	0	0	0	1	0	0	0	0	0	7	0	1	2	10	2	0	1	0	3
Новосибирская область	Государственные, муниципальные (без учета организаций в ведении ФСИН); Очная	         отчислено из-за просрочки оплаты обучения / 15.0	0	0	0	0	0	0	0	0	0	0	0	0	0	146	146	0	0	0	105	105
Новосибирская область	Государственные, муниципальные (без учета организаций в ведении ФСИН); Очная	"    в том числе:
    переведено на другие формы обучения данной
    организации на программы того же уровня / 7.0"	8	0	0	5	13	0	0	0	0	0	61	0	20	149	230	39	0	1	33	73
Новосибирская область	Государственные, муниципальные (без учета организаций в ведении ФСИН); Очная	"    в том числе:
    переведено с других форм обучения данной
    образовательной организации с программ того же уровня / 2.0"	40	0	0	0	40	1	0	0	0	1	67	0	0	23	90	21	0	0	7	28
Новосибирская область	Государственные, муниципальные (без учета организаций в ведении ФСИН); Очная	    восстановлены из числа ранее отчисленных / 4.0	18	0	0	0	18	1	0	0	0	1	63	0	12	144	219	26	0	1	54	81
Новосибирская область	Государственные, муниципальные (без учета организаций в ведении ФСИН); Очная	    выбыло по другим причинам / 16.0	126	0	0	18	144	7	0	0	0	7	174	0	12	185	371	143	0	1	112	256
Новосибирская область	Государственные, муниципальные (без учета организаций в ведении ФСИН); Очная	"    добровольно прекратили образовательные отношения
    (бросили учебу) / 10.0"	351	0	3	17	371	10	0	0	0	10	693	0	195	673	1561	451	0	78	338	867
Новосибирская область	Государственные, муниципальные (без учета организаций в ведении ФСИН); Очная	"    отчислено:
         по неуспеваемости / 11.0"	129	0	0	6	135	3	0	0	0	3	205	0	27	368	600	117	0	9	118	244
Новосибирская область	Государственные, муниципальные (без учета организаций в ведении ФСИН); Очная	"    переведено в другие образовательные организации
    на программы того же уровня / 8.0"	54	0	1	4	59	0	0	0	0	0	196	0	38	181	415	56	0	1	30	87
Новосибирская область	Государственные, муниципальные (без учета организаций в ведении ФСИН); Очная	"    переведено из других образовательных организаций 
    с программ того же уровня / 3.0"	49	0	2	0	51	0	0	0	0	0	159	0	17	127	303	29	0	0	17	46
Новосибирская область	Государственные, муниципальные (без учета организаций в ведении ФСИН); Очная	    по болезни / 9.0	3	0	0	0	3	0	0	0	0	0	12	0	0	2	14	6	0	0	1	7
Новосибирская область	Государственные, муниципальные (без учета организаций в ведении ФСИН); Очная	    прибыло по другим причинам / 5.0	62	0	0	0	62	0	0	0	0	0	91	0	12	55	158	32	0	9	11	52
Новосибирская область	Государственные, муниципальные (без учета организаций в ведении ФСИН); Очная	Выбыло студентов - всего (сумма стр. 07-11, 13-15) / 6.0	672	0	4	50	726	20	0	0	0	20	1348	0	293	1706	3347	814	0	91	737	1642
Новосибирская область	Государственные, муниципальные (без учета организаций в ведении ФСИН); Очная	Прибыло студентов - всего (сумма стр. 02-05) / 1.0	169	0	2	0	171	2	0	0	0	2	380	0	41	349	770	108	0	10	89	207
Новосибирская область	Государственные, муниципальные (без учета организаций в ведении ФСИН); Очная	"Численность студентов на начало прошлого учебного года
(на 1 октября) / 17.0"	8794	0	336	293	9423	310	0	0	0	310	18697	0	3352	11307	33356	7280	0	775	4315	12370
Новосибирская область	Очно-заочная; Государственные, муниципальные (без учета организаций в ведении ФСИН)	            из стр. 11 - не прошли итоговую аттестацию / 12.0	0	0	0	0	0	0	0	0	0	0	0	0	0	0	0	0	0	0	0	0
Новосибирская область	Очно-заочная; Государственные, муниципальные (без учета организаций в ведении ФСИН)	"            из стр. 11 – лица с ограниченными возможностями здоровья,
            инвалиды, дети-инвалиды / 13.0"	0	0	0	0	0	0	0	0	0	0	0	0	0	0	0	0	0	0	0	0
Новосибирская область	Очно-заочная; Государственные, муниципальные (без учета организаций в ведении ФСИН)	         отчислено в виде меры дисциплинарного взыскания / 14.0	0	0	0	0	0	0	0	0	0	0	0	0	0	0	0	0	0	0	0	0
Новосибирская область	Очно-заочная; Государственные, муниципальные (без учета организаций в ведении ФСИН)	         отчислено из-за просрочки оплаты обучения / 15.0	0	0	0	0	0	0	0	0	0	0	0	0	0	0	0	0	0	0	0	0
Новосибирская область	Очно-заочная; Государственные, муниципальные (без учета организаций в ведении ФСИН)	"    в том числе:
    переведено на другие формы обучения данной
    организации на программы того же уровня / 7.0"	0	0	0	0	0	0	0	0	0	0	0	0	0	2	2	0	0	0	0	0
Новосибирская область	Очно-заочная; Государственные, муниципальные (без учета организаций в ведении ФСИН)	"    в том числе:
    переведено с других форм обучения данной
    образовательной организации с программ того же уровня / 2.0"	0	0	0	0	0	0	0	0	0	0	0	0	0	0	0	0	0	0	0	0
Новосибирская область	Очно-заочная; Государственные, муниципальные (без учета организаций в ведении ФСИН)	    восстановлены из числа ранее отчисленных / 4.0	0	0	0	0	0	0	0	0	0	0	0	0	0	0	0	0	0	0	2	2
Новосибирская область	Очно-заочная; Государственные, муниципальные (без учета организаций в ведении ФСИН)	    выбыло по другим причинам / 16.0	0	0	0	0	0	0	0	0	0	0	0	0	0	0	0	0	0	0	0	0
Новосибирская область	Очно-заочная; Государственные, муниципальные (без учета организаций в ведении ФСИН)	"    добровольно прекратили образовательные отношения
    (бросили учебу) / 10.0"	0	0	0	0	0	0	0	0	0	0	0	0	0	0	0	0	0	0	5	5
Новосибирская область	Очно-заочная; Государственные, муниципальные (без учета организаций в ведении ФСИН)	"    отчислено:
         по неуспеваемости / 11.0"	0	0	0	0	0	0	0	0	0	0	0	0	0	0	0	0	0	0	0	0
Новосибирская область	Очно-заочная; Государственные, муниципальные (без учета организаций в ведении ФСИН)	"    переведено в другие образовательные организации
    на программы того же уровня / 8.0"	0	0	0	0	0	0	0	0	0	0	0	0	0	0	0	0	0	0	0	0
Новосибирская область	Очно-заочная; Государственные, муниципальные (без учета организаций в ведении ФСИН)	"    переведено из других образовательных организаций 
    с программ того же уровня / 3.0"	0	0	0	0	0	0	0	0	0	0	0	0	0	0	0	0	0	0	0	0
Новосибирская область	Очно-заочная; Государственные, муниципальные (без учета организаций в ведении ФСИН)	    по болезни / 9.0	0	0	0	0	0	0	0	0	0	0	0	0	0	0	0	0	0	0	0	0
Новосибирская область	Очно-заочная; Государственные, муниципальные (без учета организаций в ведении ФСИН)	    прибыло по другим причинам / 5.0	0	0	0	0	0	0	0	0	0	0	0	0	0	0	0	0	0	0	0	0
Новосибирская область	Очно-заочная; Государственные, муниципальные (без учета организаций в ведении ФСИН)	Выбыло студентов - всего (сумма стр. 07-11, 13-15) / 6.0	0	0	0	0	0	0	0	0	0	0	0	0	0	2	2	0	0	0	5	5
Новосибирская область	Очно-заочная; Государственные, муниципальные (без учета организаций в ведении ФСИН)	Прибыло студентов - всего (сумма стр. 02-05) / 1.0	0	0	0	0	0	0	0	0	0	0	0	0	0	0	0	0	0	0	2	2
Новосибирская область	Очно-заочная; Государственные, муниципальные (без учета организаций в ведении ФСИН)	"Численность студентов на начало прошлого учебного года
(на 1 октября) / 17.0"	0	0	0	0	0	0	0	0	0	0	0	0	0	7	7	0	0	0	49	49
Новосибирская область	Частные; Заочная	            из стр. 11 - не прошли итоговую аттестацию / 12.0	0	0	0	0	0	0	0	0	0	0	0	0	0	0	0	0	0	0	0	0
Новосибирская область	Частные; Заочная	"            из стр. 11 – лица с ограниченными возможностями здоровья,
            инвалиды, дети-инвалиды / 13.0"	0	0	0	0	0	0	0	0	0	0	0	0	0	0	0	0	0	0	0	0
Новосибирская область	Частные; Заочная	         отчислено в виде меры дисциплинарного взыскания / 14.0	0	0	0	0	0	0	0	0	0	0	0	0	0	0	0	0	0	0	0	0
Новосибирская область	Частные; Заочная	         отчислено из-за просрочки оплаты обучения / 15.0	0	0	0	0	0	0	0	0	0	0	0	0	0	81	81	0	0	0	49	49
Новосибирская область	Частные; Заочная	"    в том числе:
    переведено на другие формы обучения данной
    организации на программы того же уровня / 7.0"	0	0	0	0	0	0	0	0	0	0	0	0	0	42	42	0	0	0	6	6
Новосибирская область	Частные; Заочная	"    в том числе:
    переведено с других форм обучения данной
    образовательной организации с программ того же уровня / 2.0"	0	0	0	0	0	0	0	0	0	0	0	0	0	124	124	0	0	0	36	36
Новосибирская область	Частные; Заочная	    восстановлены из числа ранее отчисленных / 4.0	0	0	0	0	0	0	0	0	0	0	0	0	0	46	46	0	0	0	8	8
Новосибирская область	Частные; Заочная	    выбыло по другим причинам / 16.0	0	0	0	0	0	0	0	0	0	0	0	0	0	19	19	0	0	0	0	0
Новосибирская область	Частные; Заочная	"    добровольно прекратили образовательные отношения
    (бросили учебу) / 10.0"	0	0	0	0	0	0	0	0	0	0	0	0	0	43	43	0	0	0	35	35
Новосибирская область	Частные; Заочная	"    отчислено:
         по неуспеваемости / 11.0"	0	0	0	0	0	0	0	0	0	0	0	0	0	57	57	0	0	0	12	12
Новосибирская область	Частные; Заочная	"    переведено в другие образовательные организации
    на программы того же уровня / 8.0"	0	0	0	0	0	0	0	0	0	0	0	0	0	9	9	0	0	0	5	5
Новосибирская область	Частные; Заочная	"    переведено из других образовательных организаций 
    с программ того же уровня / 3.0"	0	0	0	0	0	0	0	0	0	0	0	0	0	21	21	0	0	0	5	5
Новосибирская область	Частные; Заочная	    по болезни / 9.0	0	0	0	0	0	0	0	0	0	0	0	0	0	0	0	0	0	0	0	0
Новосибирская область	Частные; Заочная	    прибыло по другим причинам / 5.0	0	0	0	0	0	0	0	0	0	0	0	0	0	18	18	0	0	0	1	1
Новосибирская область	Частные; Заочная	Выбыло студентов - всего (сумма стр. 07-11, 13-15) / 6.0	0	0	0	0	0	0	0	0	0	0	0	0	0	251	251	0	0	0	107	107
Новосибирская область	Частные; Заочная	Прибыло студентов - всего (сумма стр. 02-05) / 1.0	0	0	0	0	0	0	0	0	0	0	0	0	0	209	209	0	0	0	50	50
Новосибирская область	Частные; Заочная	"Численность студентов на начало прошлого учебного года
(на 1 октября) / 17.0"	0	0	0	0	0	0	0	0	0	0	0	0	0	1157	1157	0	0	0	666	666
Новосибирская область	Частные; Очная	            из стр. 11 - не прошли итоговую аттестацию / 12.0	0	0	0	0	0	0	0	0	0	0	0	0	0	0	0	0	0	0	0	0
Новосибирская область	Частные; Очная	"            из стр. 11 – лица с ограниченными возможностями здоровья,
            инвалиды, дети-инвалиды / 13.0"	0	0	0	0	0	0	0	0	0	0	0	0	0	0	0	0	0	0	0	0
Новосибирская область	Частные; Очная	         отчислено в виде меры дисциплинарного взыскания / 14.0	0	0	0	0	0	0	0	0	0	0	0	0	0	0	0	0	0	0	0	0
Новосибирская область	Частные; Очная	         отчислено из-за просрочки оплаты обучения / 15.0	0	0	0	0	0	0	0	0	0	0	0	0	0	52	52	0	0	0	17	17
Новосибирская область	Частные; Очная	"    в том числе:
    переведено на другие формы обучения данной
    организации на программы того же уровня / 7.0"	0	0	0	0	0	0	0	0	0	0	0	0	0	87	87	0	0	0	41	41
Новосибирская область	Частные; Очная	"    в том числе:
    переведено с других форм обучения данной
    образовательной организации с программ того же уровня / 2.0"	0	0	0	0	0	0	0	0	0	0	0	0	0	20	20	0	0	0	5	5
Новосибирская область	Частные; Очная	    восстановлены из числа ранее отчисленных / 4.0	0	0	0	0	0	0	0	0	0	0	0	0	0	38	38	0	0	0	16	16
Новосибирская область	Частные; Очная	    выбыло по другим причинам / 16.0	0	0	0	0	0	0	0	0	0	0	0	0	0	16	16	0	0	0	11	11
Новосибирская область	Частные; Очная	"    добровольно прекратили образовательные отношения
    (бросили учебу) / 10.0"	0	0	0	0	0	0	0	0	0	0	0	0	0	127	127	0	0	0	63	63
Новосибирская область	Частные; Очная	"    отчислено:
         по неуспеваемости / 11.0"	0	0	0	0	0	0	0	0	0	0	0	0	0	68	68	0	0	0	60	60
Новосибирская область	Частные; Очная	"    переведено в другие образовательные организации
    на программы того же уровня / 8.0"	0	0	0	0	0	0	0	0	0	0	0	0	0	38	38	0	0	0	23	23
Новосибирская область	Частные; Очная	"    переведено из других образовательных организаций 
    с программ того же уровня / 3.0"	0	0	0	0	0	0	0	0	0	0	0	0	0	54	54	0	0	0	24	24
Новосибирская область	Частные; Очная	    по болезни / 9.0	0	0	0	0	0	0	0	0	0	0	0	0	0	1	1	0	0	0	0	0
Новосибирская область	Частные; Очная	    прибыло по другим причинам / 5.0	0	0	0	0	0	0	0	0	0	0	0	0	0	3	3	0	0	0	2	2
Новосибирская область	Частные; Очная	Выбыло студентов - всего (сумма стр. 07-11, 13-15) / 6.0	0	0	0	0	0	0	0	0	0	0	0	0	0	389	389	0	0	0	215	215
Новосибирская область	Частные; Очная	Прибыло студентов - всего (сумма стр. 02-05) / 1.0	0	0	0	0	0	0	0	0	0	0	0	0	0	115	115	0	0	0	47	47
Новосибирская область	Частные; Очная	"Численность студентов на начало прошлого учебного года
(на 1 октября) / 17.0"	0	0	0	0	0	0	0	0	0	0	0	0	10	4721	4731	0	0	10	1723	1733
Омская область	Государственные, муниципальные (без учета организаций в ведении ФСИН); Заочная	            из стр. 11 - не прошли итоговую аттестацию / 12.0	0	0	0	0	0	0	0	0	0	0	0	0	2	0	2	14	0	0	3	17
Омская область	Государственные, муниципальные (без учета организаций в ведении ФСИН); Заочная	"            из стр. 11 – лица с ограниченными возможностями здоровья,
            инвалиды, дети-инвалиды / 13.0"	0	0	0	0	0	0	0	0	0	0	0	0	0	0	0	0	0	0	0	0
Омская область	Государственные, муниципальные (без учета организаций в ведении ФСИН); Заочная	         отчислено в виде меры дисциплинарного взыскания / 14.0	0	0	0	0	0	0	0	0	0	0	0	0	0	0	0	0	0	0	0	0
Омская область	Государственные, муниципальные (без учета организаций в ведении ФСИН); Заочная	         отчислено из-за просрочки оплаты обучения / 15.0	0	0	0	0	0	0	0	0	0	0	0	0	0	58	58	0	0	0	68	68
Омская область	Государственные, муниципальные (без учета организаций в ведении ФСИН); Заочная	"    в том числе:
    переведено на другие формы обучения данной
    организации на программы того же уровня / 7.0"	0	0	0	0	0	0	0	0	0	0	0	0	0	5	5	13	0	1	3	17
Омская область	Государственные, муниципальные (без учета организаций в ведении ФСИН); Заочная	"    в том числе:
    переведено с других форм обучения данной
    образовательной организации с программ того же уровня / 2.0"	0	0	0	0	0	0	0	0	0	0	4	0	0	21	25	14	0	1	52	67
Омская область	Государственные, муниципальные (без учета организаций в ведении ФСИН); Заочная	    восстановлены из числа ранее отчисленных / 4.0	0	0	0	0	0	0	0	0	0	0	1	0	0	35	36	12	0	1	38	51
Омская область	Государственные, муниципальные (без учета организаций в ведении ФСИН); Заочная	    выбыло по другим причинам / 16.0	0	0	0	0	0	0	0	0	0	0	3	0	0	12	15	42	0	0	63	105
Омская область	Государственные, муниципальные (без учета организаций в ведении ФСИН); Заочная	"    добровольно прекратили образовательные отношения
    (бросили учебу) / 10.0"	0	0	0	0	0	0	0	0	0	0	0	0	0	58	58	77	3	22	88	190
Омская область	Государственные, муниципальные (без учета организаций в ведении ФСИН); Заочная	"    отчислено:
         по неуспеваемости / 11.0"	0	0	0	0	0	0	0	0	0	0	6	0	2	58	66	104	0	21	118	243
Омская область	Государственные, муниципальные (без учета организаций в ведении ФСИН); Заочная	"    переведено в другие образовательные организации
    на программы того же уровня / 8.0"	0	0	0	0	0	0	0	0	0	0	0	0	0	2	2	3	0	1	0	4
Омская область	Государственные, муниципальные (без учета организаций в ведении ФСИН); Заочная	"    переведено из других образовательных организаций 
    с программ того же уровня / 3.0"	0	0	0	0	0	0	0	0	0	0	0	0	14	15	29	0	0	0	5	5
Омская область	Государственные, муниципальные (без учета организаций в ведении ФСИН); Заочная	    по болезни / 9.0	0	0	0	0	0	0	0	0	0	0	0	0	0	0	0	0	0	0	0	0
Омская область	Государственные, муниципальные (без учета организаций в ведении ФСИН); Заочная	    прибыло по другим причинам / 5.0	0	0	0	0	0	0	0	0	0	0	0	0	0	62	62	5	0	0	30	35
Омская область	Государственные, муниципальные (без учета организаций в ведении ФСИН); Заочная	Выбыло студентов - всего (сумма стр. 07-11, 13-15) / 6.0	0	0	0	0	0	0	0	0	0	0	9	0	2	193	204	239	3	45	340	627
Омская область	Государственные, муниципальные (без учета организаций в ведении ФСИН); Заочная	Прибыло студентов - всего (сумма стр. 02-05) / 1.0	0	0	0	0	0	0	0	0	0	0	5	0	14	133	152	31	0	2	125	158
Омская область	Государственные, муниципальные (без учета организаций в ведении ФСИН); Заочная	"Численность студентов на начало прошлого учебного года
(на 1 октября) / 17.0"	0	0	0	0	0	0	0	0	0	0	180	0	0	937	1117	2260	0	385	1524	4169
Омская область	Государственные, муниципальные (без учета организаций в ведении ФСИН); Очная	            из стр. 11 - не прошли итоговую аттестацию / 12.0	9	0	0	2	11	0	0	0	0	0	13	0	0	1	14	0	0	0	1	1
Омская область	Государственные, муниципальные (без учета организаций в ведении ФСИН); Очная	"            из стр. 11 – лица с ограниченными возможностями здоровья,
            инвалиды, дети-инвалиды / 13.0"	1	0	0	0	1	0	0	0	0	0	2	0	0	2	4	0	0	0	0	0
Омская область	Государственные, муниципальные (без учета организаций в ведении ФСИН); Очная	         отчислено в виде меры дисциплинарного взыскания / 14.0	17	0	0	0	17	0	0	0	0	0	17	0	2	2	21	0	0	2	2	4
Омская область	Государственные, муниципальные (без учета организаций в ведении ФСИН); Очная	         отчислено из-за просрочки оплаты обучения / 15.0	0	0	0	2	2	0	0	0	0	0	0	0	0	35	35	0	0	0	11	11
Омская область	Государственные, муниципальные (без учета организаций в ведении ФСИН); Очная	"    в том числе:
    переведено на другие формы обучения данной
    организации на программы того же уровня / 7.0"	28	0	0	18	46	0	0	0	1	1	149	1	6	120	276	20	2	5	25	52
Омская область	Государственные, муниципальные (без учета организаций в ведении ФСИН); Очная	"    в том числе:
    переведено с других форм обучения данной
    образовательной организации с программ того же уровня / 2.0"	93	0	0	8	101	0	0	0	5	5	111	0	6	26	143	2	0	16	0	18
Омская область	Государственные, муниципальные (без учета организаций в ведении ФСИН); Очная	    восстановлены из числа ранее отчисленных / 4.0	33	1	1	3	38	0	0	0	0	0	48	8	40	44	140	6	4	1	3	14
Омская область	Государственные, муниципальные (без учета организаций в ведении ФСИН); Очная	    выбыло по другим причинам / 16.0	87	0	0	16	103	1	0	0	4	5	207	0	41	114	362	19	0	25	51	95
Омская область	Государственные, муниципальные (без учета организаций в ведении ФСИН); Очная	"    добровольно прекратили образовательные отношения
    (бросили учебу) / 10.0"	464	7	1	59	531	3	4	0	13	20	907	46	152	365	1470	177	18	73	68	336
Омская область	Государственные, муниципальные (без учета организаций в ведении ФСИН); Очная	"    отчислено:
         по неуспеваемости / 11.0"	214	6	0	35	255	7	5	0	4	16	298	13	79	99	489	51	10	14	27	102
Омская область	Государственные, муниципальные (без учета организаций в ведении ФСИН); Очная	"    переведено в другие образовательные организации
    на программы того же уровня / 8.0"	90	2	0	24	116	9	0	0	2	11	260	13	52	147	472	14	1	5	11	31
Омская область	Государственные, муниципальные (без учета организаций в ведении ФСИН); Очная	"    переведено из других образовательных организаций 
    с программ того же уровня / 3.0"	103	1	0	3	107	0	0	0	0	0	201	3	38	87	329	10	1	1	12	24
Омская область	Государственные, муниципальные (без учета организаций в ведении ФСИН); Очная	    по болезни / 9.0	0	0	0	0	0	0	0	0	0	0	2	0	58	6	66	5	0	12	0	17
Омская область	Государственные, муниципальные (без учета организаций в ведении ФСИН); Очная	    прибыло по другим причинам / 5.0	49	7	0	26	82	4	0	0	0	4	109	18	26	55	208	15	1	56	9	81
Омская область	Государственные, муниципальные (без учета организаций в ведении ФСИН); Очная	Выбыло студентов - всего (сумма стр. 07-11, 13-15) / 6.0	900	15	1	154	1070	20	9	0	24	53	1840	73	390	888	3191	286	31	136	195	648
Омская область	Государственные, муниципальные (без учета организаций в ведении ФСИН); Очная	Прибыло студентов - всего (сумма стр. 02-05) / 1.0	278	9	1	40	328	4	0	0	5	9	469	29	110	212	820	33	6	74	24	137
Омская область	Государственные, муниципальные (без учета организаций в ведении ФСИН); Очная	"Численность студентов на начало прошлого учебного года
(на 1 октября) / 17.0"	8352	0	15	637	9004	175	0	15	114	304	18242	0	4403	6533	29178	2862	0	1933	1421	6216
Омская область	Очно-заочная; Государственные, муниципальные (без учета организаций в ведении ФСИН)	            из стр. 11 - не прошли итоговую аттестацию / 12.0	0	0	0	0	0	0	0	0	0	0	0	0	0	0	0	0	0	0	1	1
Омская область	Очно-заочная; Государственные, муниципальные (без учета организаций в ведении ФСИН)	"            из стр. 11 – лица с ограниченными возможностями здоровья,
            инвалиды, дети-инвалиды / 13.0"	0	0	0	0	0	0	0	0	0	0	0	0	0	0	0	0	0	0	0	0
Омская область	Очно-заочная; Государственные, муниципальные (без учета организаций в ведении ФСИН)	         отчислено в виде меры дисциплинарного взыскания / 14.0	0	0	0	0	0	0	0	0	0	0	0	0	0	0	0	0	0	0	0	0
Омская область	Очно-заочная; Государственные, муниципальные (без учета организаций в ведении ФСИН)	         отчислено из-за просрочки оплаты обучения / 15.0	0	0	0	0	0	0	0	0	0	0	0	0	0	17	17	0	0	0	2	2
Омская область	Очно-заочная; Государственные, муниципальные (без учета организаций в ведении ФСИН)	"    в том числе:
    переведено на другие формы обучения данной
    организации на программы того же уровня / 7.0"	0	0	0	0	0	0	0	0	5	5	0	0	0	6	6	2	0	0	3	5
Омская область	Очно-заочная; Государственные, муниципальные (без учета организаций в ведении ФСИН)	"    в том числе:
    переведено с других форм обучения данной
    образовательной организации с программ того же уровня / 2.0"	0	0	0	0	0	0	0	0	0	0	1	0	0	2	3	2	0	0	2	4
Омская область	Очно-заочная; Государственные, муниципальные (без учета организаций в ведении ФСИН)	    восстановлены из числа ранее отчисленных / 4.0	0	0	0	0	0	0	0	0	21	21	0	0	0	0	0	2	0	0	0	2
Омская область	Очно-заочная; Государственные, муниципальные (без учета организаций в ведении ФСИН)	    выбыло по другим причинам / 16.0	0	0	0	0	0	0	0	0	6	6	0	0	0	0	0	3	0	0	1	4
Омская область	Очно-заочная; Государственные, муниципальные (без учета организаций в ведении ФСИН)	"    добровольно прекратили образовательные отношения
    (бросили учебу) / 10.0"	0	0	0	0	0	0	0	0	0	0	0	0	0	9	9	32	0	0	47	79
Омская область	Очно-заочная; Государственные, муниципальные (без учета организаций в ведении ФСИН)	"    отчислено:
         по неуспеваемости / 11.0"	0	0	0	0	0	0	0	0	51	51	0	0	0	3	3	9	0	0	2	11
Омская область	Очно-заочная; Государственные, муниципальные (без учета организаций в ведении ФСИН)	"    переведено в другие образовательные организации
    на программы того же уровня / 8.0"	0	0	0	0	0	0	0	0	0	0	0	0	0	2	2	0	0	0	0	0
Омская область	Очно-заочная; Государственные, муниципальные (без учета организаций в ведении ФСИН)	"    переведено из других образовательных организаций 
    с программ того же уровня / 3.0"	0	0	0	0	0	0	0	0	1	1	0	0	0	0	0	0	0	0	1	1
Омская область	Очно-заочная; Государственные, муниципальные (без учета организаций в ведении ФСИН)	    по болезни / 9.0	0	0	0	0	0	0	0	0	0	0	0	0	0	0	0	0	0	0	0	0
Омская область	Очно-заочная; Государственные, муниципальные (без учета организаций в ведении ФСИН)	    прибыло по другим причинам / 5.0	0	0	0	0	0	0	0	0	41	41	0	0	0	0	0	0	0	0	0	0
Омская область	Очно-заочная; Государственные, муниципальные (без учета организаций в ведении ФСИН)	Выбыло студентов - всего (сумма стр. 07-11, 13-15) / 6.0	0	0	0	0	0	0	0	0	62	62	0	0	0	37	37	46	0	0	55	101
Омская область	Очно-заочная; Государственные, муниципальные (без учета организаций в ведении ФСИН)	Прибыло студентов - всего (сумма стр. 02-05) / 1.0	0	0	0	0	0	0	0	0	63	63	1	0	0	2	3	4	0	0	3	7
Омская область	Очно-заочная; Государственные, муниципальные (без учета организаций в ведении ФСИН)	"Численность студентов на начало прошлого учебного года
(на 1 октября) / 17.0"	0	0	0	0	0	20	0	0	203	223	13	0	0	150	163	352	0	0	544	896
Омская область	Частные; Заочная	            из стр. 11 - не прошли итоговую аттестацию / 12.0	0	0	0	0	0	0	0	0	0	0	0	0	0	1	1	0	0	0	4	4
Омская область	Частные; Заочная	"            из стр. 11 – лица с ограниченными возможностями здоровья,
            инвалиды, дети-инвалиды / 13.0"	0	0	0	0	0	0	0	0	0	0	0	0	0	1	1	0	0	0	0	0
Омская область	Частные; Заочная	         отчислено в виде меры дисциплинарного взыскания / 14.0	0	0	0	0	0	0	0	0	0	0	0	0	0	0	0	0	0	0	0	0
Омская область	Частные; Заочная	         отчислено из-за просрочки оплаты обучения / 15.0	0	0	0	0	0	0	0	0	0	0	0	0	0	121	121	0	0	0	101	101
Омская область	Частные; Заочная	"    в том числе:
    переведено на другие формы обучения данной
    организации на программы того же уровня / 7.0"	0	0	0	0	0	0	0	0	0	0	0	0	0	6	6	0	0	0	1	1
Омская область	Частные; Заочная	"    в том числе:
    переведено с других форм обучения данной
    образовательной организации с программ того же уровня / 2.0"	0	0	0	0	0	0	0	0	0	0	0	0	0	56	56	0	0	0	15	15
Омская область	Частные; Заочная	    восстановлены из числа ранее отчисленных / 4.0	0	0	0	0	0	0	0	0	0	0	0	0	0	31	31	0	0	0	37	37
Омская область	Частные; Заочная	    выбыло по другим причинам / 16.0	0	0	0	0	0	0	0	0	0	0	0	0	0	1	1	0	0	0	2	2
Омская область	Частные; Заочная	"    добровольно прекратили образовательные отношения
    (бросили учебу) / 10.0"	0	0	0	0	0	0	0	0	0	0	0	0	0	82	82	0	0	0	76	76
Омская область	Частные; Заочная	"    отчислено:
         по неуспеваемости / 11.0"	0	0	0	0	0	0	0	0	0	0	0	0	0	153	153	0	0	0	195	195
Омская область	Частные; Заочная	"    переведено в другие образовательные организации
    на программы того же уровня / 8.0"	0	0	0	0	0	0	0	0	0	0	0	0	0	8	8	0	0	0	1	1
Омская область	Частные; Заочная	"    переведено из других образовательных организаций 
    с программ того же уровня / 3.0"	0	0	0	0	0	0	0	0	0	0	0	0	0	37	37	0	0	0	1	1
Омская область	Частные; Заочная	    по болезни / 9.0	0	0	0	0	0	0	0	0	0	0	0	0	0	0	0	0	0	0	0	0
Омская область	Частные; Заочная	    прибыло по другим причинам / 5.0	0	0	0	0	0	0	0	0	0	0	0	0	0	4	4	0	0	0	4	4
Омская область	Частные; Заочная	Выбыло студентов - всего (сумма стр. 07-11, 13-15) / 6.0	0	0	0	0	0	0	0	0	0	0	0	0	0	371	371	0	0	0	376	376
Омская область	Частные; Заочная	Прибыло студентов - всего (сумма стр. 02-05) / 1.0	0	0	0	0	0	0	0	0	0	0	0	0	0	128	128	0	0	0	57	57
Омская область	Частные; Заочная	"Численность студентов на начало прошлого учебного года
(на 1 октября) / 17.0"	0	0	0	0	0	0	0	0	0	0	0	0	0	1733	1733	0	0	0	1564	1564
Омская область	Частные; Очная	            из стр. 11 - не прошли итоговую аттестацию / 12.0	0	0	0	0	0	0	0	0	0	0	0	0	0	9	9	0	0	0	5	5
Омская область	Частные; Очная	"            из стр. 11 – лица с ограниченными возможностями здоровья,
            инвалиды, дети-инвалиды / 13.0"	0	0	0	0	0	0	0	0	0	0	0	0	0	0	0	0	0	0	0	0
Омская область	Частные; Очная	         отчислено в виде меры дисциплинарного взыскания / 14.0	0	0	0	0	0	0	0	0	0	0	0	0	0	0	0	0	0	0	0	0
Омская область	Частные; Очная	         отчислено из-за просрочки оплаты обучения / 15.0	0	0	0	0	0	0	0	0	0	0	0	0	0	51	51	0	0	0	24	24
Омская область	Частные; Очная	"    в том числе:
    переведено на другие формы обучения данной
    организации на программы того же уровня / 7.0"	0	0	0	0	0	0	0	0	0	0	1	0	0	60	61	0	0	0	15	15
Омская область	Частные; Очная	"    в том числе:
    переведено с других форм обучения данной
    образовательной организации с программ того же уровня / 2.0"	0	0	0	0	0	0	0	0	0	0	0	0	0	13	13	0	0	0	4	4
Омская область	Частные; Очная	    восстановлены из числа ранее отчисленных / 4.0	0	0	0	0	0	0	0	0	0	0	0	0	0	36	36	0	0	0	14	14
Омская область	Частные; Очная	    выбыло по другим причинам / 16.0	0	0	0	1	1	0	0	0	0	0	3	0	0	16	19	0	0	0	1	1
Омская область	Частные; Очная	"    добровольно прекратили образовательные отношения
    (бросили учебу) / 10.0"	0	0	0	0	0	0	0	0	0	0	16	0	0	193	209	0	0	0	64	64
Омская область	Частные; Очная	"    отчислено:
         по неуспеваемости / 11.0"	0	0	0	0	0	0	0	0	0	0	4	0	0	143	147	0	0	0	49	49
Омская область	Частные; Очная	"    переведено в другие образовательные организации
    на программы того же уровня / 8.0"	0	0	0	0	0	0	0	0	0	0	1	0	0	112	113	0	0	0	4	4
Омская область	Частные; Очная	"    переведено из других образовательных организаций 
    с программ того же уровня / 3.0"	0	0	0	0	0	0	0	0	0	0	5	0	0	67	72	0	0	0	4	4
Омская область	Частные; Очная	    по болезни / 9.0	0	0	0	0	0	0	0	0	0	0	0	0	0	2	2	0	0	0	0	0
Омская область	Частные; Очная	    прибыло по другим причинам / 5.0	0	0	0	0	0	0	0	0	0	0	15	0	0	4	19	0	0	0	0	0
Омская область	Частные; Очная	Выбыло студентов - всего (сумма стр. 07-11, 13-15) / 6.0	0	0	0	1	1	0	0	0	0	0	25	0	0	577	602	0	0	0	157	157
Омская область	Частные; Очная	Прибыло студентов - всего (сумма стр. 02-05) / 1.0	0	0	0	0	0	0	0	0	0	0	20	0	0	120	140	0	0	0	22	22
Омская область	Частные; Очная	"Численность студентов на начало прошлого учебного года
(на 1 октября) / 17.0"	0	0	0	0	0	0	0	0	0	0	235	0	0	3017	3252	0	0	0	855	855
Омская область	Частные; Очно-заочная	            из стр. 11 - не прошли итоговую аттестацию / 12.0	0	0	0	0	0	0	0	0	0	0	0	0	0	0	0	0	0	0	0	0
Омская область	Частные; Очно-заочная	"            из стр. 11 – лица с ограниченными возможностями здоровья,
            инвалиды, дети-инвалиды / 13.0"	0	0	0	0	0	0	0	0	0	0	0	0	0	0	0	0	0	0	0	0
Омская область	Частные; Очно-заочная	         отчислено в виде меры дисциплинарного взыскания / 14.0	0	0	0	0	0	0	0	0	0	0	0	0	0	0	0	0	0	0	0	0
Омская область	Частные; Очно-заочная	         отчислено из-за просрочки оплаты обучения / 15.0	0	0	0	0	0	0	0	0	0	0	0	0	0	0	0	0	0	0	1	1
Омская область	Частные; Очно-заочная	"    в том числе:
    переведено на другие формы обучения данной
    организации на программы того же уровня / 7.0"	0	0	0	0	0	0	0	0	0	0	0	0	0	1	1	0	0	0	0	0
Омская область	Частные; Очно-заочная	"    в том числе:
    переведено с других форм обучения данной
    образовательной организации с программ того же уровня / 2.0"	0	0	0	0	0	0	0	0	0	0	0	0	0	1	1	0	0	0	0	0
Омская область	Частные; Очно-заочная	    восстановлены из числа ранее отчисленных / 4.0	0	0	0	0	0	0	0	0	0	0	0	0	0	0	0	0	0	0	0	0
Омская область	Частные; Очно-заочная	    выбыло по другим причинам / 16.0	0	0	0	0	0	0	0	0	1	1	0	0	0	0	0	0	0	0	0	0
Омская область	Частные; Очно-заочная	"    добровольно прекратили образовательные отношения
    (бросили учебу) / 10.0"	0	0	0	0	0	0	0	0	3	3	0	0	0	8	8	0	0	0	5	5
Омская область	Частные; Очно-заочная	"    отчислено:
         по неуспеваемости / 11.0"	0	0	0	2	2	0	0	0	5	5	0	0	0	2	2	0	0	0	3	3
Омская область	Частные; Очно-заочная	"    переведено в другие образовательные организации
    на программы того же уровня / 8.0"	0	0	0	0	0	0	0	0	0	0	0	0	0	2	2	0	0	0	0	0
Омская область	Частные; Очно-заочная	"    переведено из других образовательных организаций 
    с программ того же уровня / 3.0"	0	0	0	0	0	0	0	0	0	0	0	0	0	2	2	0	0	0	0	0
Омская область	Частные; Очно-заочная	    по болезни / 9.0	0	0	0	0	0	0	0	0	0	0	0	0	0	0	0	0	0	0	0	0
Омская область	Частные; Очно-заочная	    прибыло по другим причинам / 5.0	0	0	0	0	0	0	0	0	0	0	0	0	0	0	0	0	0	0	0	0
Омская область	Частные; Очно-заочная	Выбыло студентов - всего (сумма стр. 07-11, 13-15) / 6.0	0	0	0	2	2	0	0	0	9	9	0	0	0	13	13	0	0	0	9	9
Омская область	Частные; Очно-заочная	Прибыло студентов - всего (сумма стр. 02-05) / 1.0	0	0	0	0	0	0	0	0	0	0	0	0	0	3	3	0	0	0	0	0
Омская область	Частные; Очно-заочная	"Численность студентов на начало прошлого учебного года
(на 1 октября) / 17.0"	0	0	0	13	13	0	0	0	14	14	0	0	0	91	91	0	0	0	42	42
Оренбургская область	Государственные, муниципальные (без учета организаций в ведении ФСИН); Заочная	            из стр. 11 - не прошли итоговую аттестацию / 12.0	0	0	0	0	0	0	0	0	0	0	0	0	0	9	9	0	0	0	0	0
Оренбургская область	Государственные, муниципальные (без учета организаций в ведении ФСИН); Заочная	"            из стр. 11 – лица с ограниченными возможностями здоровья,
            инвалиды, дети-инвалиды / 13.0"	0	0	0	0	0	0	0	0	0	0	0	0	0	0	0	0	0	0	0	0
Оренбургская область	Государственные, муниципальные (без учета организаций в ведении ФСИН); Заочная	         отчислено в виде меры дисциплинарного взыскания / 14.0	0	0	0	0	0	0	0	0	0	0	0	0	0	0	0	0	0	0	0	0
Оренбургская область	Государственные, муниципальные (без учета организаций в ведении ФСИН); Заочная	         отчислено из-за просрочки оплаты обучения / 15.0	0	0	0	0	0	0	0	0	0	0	0	0	0	22	22	0	0	0	46	46
Оренбургская область	Государственные, муниципальные (без учета организаций в ведении ФСИН); Заочная	"    в том числе:
    переведено на другие формы обучения данной
    организации на программы того же уровня / 7.0"	0	0	0	0	0	0	0	0	0	0	0	0	0	7	7	0	0	0	3	3
Оренбургская область	Государственные, муниципальные (без учета организаций в ведении ФСИН); Заочная	"    в том числе:
    переведено с других форм обучения данной
    образовательной организации с программ того же уровня / 2.0"	0	0	0	0	0	0	0	0	0	0	0	0	1	84	85	0	0	0	141	141
Оренбургская область	Государственные, муниципальные (без учета организаций в ведении ФСИН); Заочная	    восстановлены из числа ранее отчисленных / 4.0	0	0	0	0	0	0	0	0	0	0	0	0	0	24	24	0	0	1	46	47
Оренбургская область	Государственные, муниципальные (без учета организаций в ведении ФСИН); Заочная	    выбыло по другим причинам / 16.0	0	0	0	0	0	0	0	0	0	0	0	0	3	40	43	1	0	8	23	32
Оренбургская область	Государственные, муниципальные (без учета организаций в ведении ФСИН); Заочная	"    добровольно прекратили образовательные отношения
    (бросили учебу) / 10.0"	0	0	0	0	0	0	0	0	0	0	0	0	2	49	51	8	1	10	95	114
Оренбургская область	Государственные, муниципальные (без учета организаций в ведении ФСИН); Заочная	"    отчислено:
         по неуспеваемости / 11.0"	0	0	0	0	0	0	0	0	0	0	0	0	0	42	42	25	0	1	63	89
Оренбургская область	Государственные, муниципальные (без учета организаций в ведении ФСИН); Заочная	"    переведено в другие образовательные организации
    на программы того же уровня / 8.0"	0	0	0	0	0	0	0	0	0	0	0	0	0	3	3	0	0	0	3	3
Оренбургская область	Государственные, муниципальные (без учета организаций в ведении ФСИН); Заочная	"    переведено из других образовательных организаций 
    с программ того же уровня / 3.0"	0	0	0	0	0	0	0	0	0	0	0	0	0	22	22	0	0	1	11	12
Оренбургская область	Государственные, муниципальные (без учета организаций в ведении ФСИН); Заочная	    по болезни / 9.0	0	0	0	0	0	0	0	0	0	0	0	0	0	0	0	0	0	0	0	0
Оренбургская область	Государственные, муниципальные (без учета организаций в ведении ФСИН); Заочная	    прибыло по другим причинам / 5.0	0	0	0	0	0	0	0	0	0	0	0	0	0	75	75	1	0	0	71	72
Оренбургская область	Государственные, муниципальные (без учета организаций в ведении ФСИН); Заочная	Выбыло студентов - всего (сумма стр. 07-11, 13-15) / 6.0	0	0	0	0	0	0	0	0	0	0	0	0	5	163	168	34	1	19	233	287
Оренбургская область	Государственные, муниципальные (без учета организаций в ведении ФСИН); Заочная	Прибыло студентов - всего (сумма стр. 02-05) / 1.0	0	0	0	0	0	0	0	0	0	0	0	0	1	205	206	1	0	2	269	272
Оренбургская область	Государственные, муниципальные (без учета организаций в ведении ФСИН); Заочная	"Численность студентов на начало прошлого учебного года
(на 1 октября) / 17.0"	0	0	0	0	0	0	0	0	16	16	0	0	50	1195	1245	202	23	201	2442	2868
Оренбургская область	Государственные, муниципальные (без учета организаций в ведении ФСИН); Очная	            из стр. 11 - не прошли итоговую аттестацию / 12.0	17	0	0	0	17	0	0	0	0	0	14	0	0	0	14	0	0	0	0	0
Оренбургская область	Государственные, муниципальные (без учета организаций в ведении ФСИН); Очная	"            из стр. 11 – лица с ограниченными возможностями здоровья,
            инвалиды, дети-инвалиды / 13.0"	2	0	0	0	2	0	0	0	0	0	0	0	0	0	0	0	0	0	0	0
Оренбургская область	Государственные, муниципальные (без учета организаций в ведении ФСИН); Очная	         отчислено в виде меры дисциплинарного взыскания / 14.0	3	0	0	0	3	0	0	0	0	0	8	0	3	11	22	1	0	0	0	1
Оренбургская область	Государственные, муниципальные (без учета организаций в ведении ФСИН); Очная	         отчислено из-за просрочки оплаты обучения / 15.0	0	0	0	20	20	0	0	0	0	0	0	0	0	39	39	0	0	0	0	0
Оренбургская область	Государственные, муниципальные (без учета организаций в ведении ФСИН); Очная	"    в том числе:
    переведено на другие формы обучения данной
    организации на программы того же уровня / 7.0"	13	0	0	0	13	0	0	0	0	0	95	0	14	116	225	67	0	0	20	87
Оренбургская область	Государственные, муниципальные (без учета организаций в ведении ФСИН); Очная	"    в том числе:
    переведено с других форм обучения данной
    образовательной организации с программ того же уровня / 2.0"	12	0	0	1	13	0	0	0	0	0	25	0	0	18	43	9	0	0	1	10
Оренбургская область	Государственные, муниципальные (без учета организаций в ведении ФСИН); Очная	    восстановлены из числа ранее отчисленных / 4.0	24	0	0	5	29	0	0	0	0	0	67	0	20	96	183	0	0	2	3	5
Оренбургская область	Государственные, муниципальные (без учета организаций в ведении ФСИН); Очная	    выбыло по другим причинам / 16.0	75	0	0	9	84	0	0	0	0	0	87	2	42	149	280	2	0	5	10	17
Оренбургская область	Государственные, муниципальные (без учета организаций в ведении ФСИН); Очная	"    добровольно прекратили образовательные отношения
    (бросили учебу) / 10.0"	438	0	0	28	466	0	0	0	0	0	992	18	174	499	1683	43	0	21	41	105
Оренбургская область	Государственные, муниципальные (без учета организаций в ведении ФСИН); Очная	"    отчислено:
         по неуспеваемости / 11.0"	121	0	0	4	125	0	0	0	0	0	145	3	31	88	267	6	0	1	9	16
Оренбургская область	Государственные, муниципальные (без учета организаций в ведении ФСИН); Очная	"    переведено в другие образовательные организации
    на программы того же уровня / 8.0"	50	0	0	3	53	0	0	0	0	0	212	0	49	185	446	6	0	0	3	9
Оренбургская область	Государственные, муниципальные (без учета организаций в ведении ФСИН); Очная	"    переведено из других образовательных организаций 
    с программ того же уровня / 3.0"	44	0	0	1	45	0	0	0	0	0	177	0	17	198	392	54	0	0	22	76
Оренбургская область	Государственные, муниципальные (без учета организаций в ведении ФСИН); Очная	    по болезни / 9.0	2	0	0	0	2	0	0	0	0	0	3	0	0	1	4	0	0	0	0	0
Оренбургская область	Государственные, муниципальные (без учета организаций в ведении ФСИН); Очная	    прибыло по другим причинам / 5.0	84	0	0	3	87	0	0	0	0	0	148	0	45	178	371	0	0	0	1	1
Оренбургская область	Государственные, муниципальные (без учета организаций в ведении ФСИН); Очная	Выбыло студентов - всего (сумма стр. 07-11, 13-15) / 6.0	702	0	0	64	766	0	0	0	0	0	1542	23	313	1088	2966	125	0	27	83	235
Оренбургская область	Государственные, муниципальные (без учета организаций в ведении ФСИН); Очная	Прибыло студентов - всего (сумма стр. 02-05) / 1.0	164	0	0	10	174	0	0	0	0	0	417	0	82	490	989	63	0	2	27	92
Оренбургская область	Государственные, муниципальные (без учета организаций в ведении ФСИН); Очная	"Численность студентов на начало прошлого учебного года
(на 1 октября) / 17.0"	6906	0	0	527	7433	0	0	0	0	0	21791	0	5347	10759	37897	801	0	574	755	2130
Оренбургская область	Очно-заочная; Государственные, муниципальные (без учета организаций в ведении ФСИН)	            из стр. 11 - не прошли итоговую аттестацию / 12.0	0	0	0	0	0	0	0	0	0	0	0	0	0	0	0	0	0	0	0	0
Оренбургская область	Очно-заочная; Государственные, муниципальные (без учета организаций в ведении ФСИН)	"            из стр. 11 – лица с ограниченными возможностями здоровья,
            инвалиды, дети-инвалиды / 13.0"	0	0	0	0	0	0	0	0	0	0	0	0	0	0	0	0	0	0	0	0
Оренбургская область	Очно-заочная; Государственные, муниципальные (без учета организаций в ведении ФСИН)	         отчислено в виде меры дисциплинарного взыскания / 14.0	0	0	0	0	0	0	0	0	0	0	0	0	0	0	0	0	0	0	0	0
Оренбургская область	Очно-заочная; Государственные, муниципальные (без учета организаций в ведении ФСИН)	         отчислено из-за просрочки оплаты обучения / 15.0	0	0	0	0	0	0	0	0	0	0	0	0	0	0	0	0	0	0	0	0
Оренбургская область	Очно-заочная; Государственные, муниципальные (без учета организаций в ведении ФСИН)	"    в том числе:
    переведено на другие формы обучения данной
    организации на программы того же уровня / 7.0"	0	0	0	1	1	0	0	0	0	0	0	0	0	0	0	0	0	0	0	0
Оренбургская область	Очно-заочная; Государственные, муниципальные (без учета организаций в ведении ФСИН)	"    в том числе:
    переведено с других форм обучения данной
    образовательной организации с программ того же уровня / 2.0"	0	0	0	0	0	0	0	0	0	0	0	0	0	0	0	1	0	0	0	1
Оренбургская область	Очно-заочная; Государственные, муниципальные (без учета организаций в ведении ФСИН)	    восстановлены из числа ранее отчисленных / 4.0	0	0	0	0	0	0	0	0	0	0	0	0	0	0	0	3	0	0	4	7
Оренбургская область	Очно-заочная; Государственные, муниципальные (без учета организаций в ведении ФСИН)	    выбыло по другим причинам / 16.0	0	0	0	0	0	0	0	0	0	0	0	0	0	0	0	1	0	0	0	1
Оренбургская область	Очно-заочная; Государственные, муниципальные (без учета организаций в ведении ФСИН)	"    добровольно прекратили образовательные отношения
    (бросили учебу) / 10.0"	0	0	0	0	0	0	0	0	0	0	0	0	0	0	0	16	0	0	35	51
Оренбургская область	Очно-заочная; Государственные, муниципальные (без учета организаций в ведении ФСИН)	"    отчислено:
         по неуспеваемости / 11.0"	0	0	0	0	0	0	0	0	0	0	0	0	0	0	0	0	0	0	0	0
Оренбургская область	Очно-заочная; Государственные, муниципальные (без учета организаций в ведении ФСИН)	"    переведено в другие образовательные организации
    на программы того же уровня / 8.0"	0	0	0	0	0	0	0	0	0	0	0	0	0	0	0	1	0	0	1	2
Оренбургская область	Очно-заочная; Государственные, муниципальные (без учета организаций в ведении ФСИН)	"    переведено из других образовательных организаций 
    с программ того же уровня / 3.0"	0	0	0	0	0	0	0	0	0	0	0	0	0	0	0	0	0	0	1	1
Оренбургская область	Очно-заочная; Государственные, муниципальные (без учета организаций в ведении ФСИН)	    по болезни / 9.0	0	0	0	0	0	0	0	0	0	0	0	0	0	0	0	0	0	0	0	0
Оренбургская область	Очно-заочная; Государственные, муниципальные (без учета организаций в ведении ФСИН)	    прибыло по другим причинам / 5.0	0	0	0	0	0	0	0	0	0	0	0	0	0	0	0	0	0	0	0	0
Оренбургская область	Очно-заочная; Государственные, муниципальные (без учета организаций в ведении ФСИН)	Выбыло студентов - всего (сумма стр. 07-11, 13-15) / 6.0	0	0	0	1	1	0	0	0	0	0	0	0	0	0	0	18	0	0	36	54
Оренбургская область	Очно-заочная; Государственные, муниципальные (без учета организаций в ведении ФСИН)	Прибыло студентов - всего (сумма стр. 02-05) / 1.0	0	0	0	0	0	0	0	0	0	0	0	0	0	0	0	4	0	0	5	9
Оренбургская область	Очно-заочная; Государственные, муниципальные (без учета организаций в ведении ФСИН)	"Численность студентов на начало прошлого учебного года
(на 1 октября) / 17.0"	0	0	0	21	21	0	0	0	0	0	0	0	0	0	0	326	0	0	251	577
Оренбургская область	Частные; Заочная	            из стр. 11 - не прошли итоговую аттестацию / 12.0	0	0	0	0	0	0	0	0	0	0	0	0	0	0	0	0	0	0	0	0
Оренбургская область	Частные; Заочная	"            из стр. 11 – лица с ограниченными возможностями здоровья,
            инвалиды, дети-инвалиды / 13.0"	0	0	0	0	0	0	0	0	0	0	0	0	0	0	0	0	0	0	0	0
Оренбургская область	Частные; Заочная	         отчислено в виде меры дисциплинарного взыскания / 14.0	0	0	0	0	0	0	0	0	0	0	0	0	0	0	0	0	0	0	0	0
Оренбургская область	Частные; Заочная	         отчислено из-за просрочки оплаты обучения / 15.0	0	0	0	0	0	0	0	0	0	0	0	0	0	12	12	0	0	0	6	6
Оренбургская область	Частные; Заочная	"    в том числе:
    переведено на другие формы обучения данной
    организации на программы того же уровня / 7.0"	0	0	0	0	0	0	0	0	0	0	0	0	0	1	1	0	0	0	0	0
Оренбургская область	Частные; Заочная	"    в том числе:
    переведено с других форм обучения данной
    образовательной организации с программ того же уровня / 2.0"	0	0	0	0	0	0	0	0	0	0	0	0	0	1	1	0	0	0	2	2
Оренбургская область	Частные; Заочная	    восстановлены из числа ранее отчисленных / 4.0	0	0	0	0	0	0	0	0	0	0	0	0	0	0	0	0	0	0	6	6
Оренбургская область	Частные; Заочная	    выбыло по другим причинам / 16.0	0	0	0	0	0	0	0	0	0	0	0	0	0	0	0	0	0	0	20	20
Оренбургская область	Частные; Заочная	"    добровольно прекратили образовательные отношения
    (бросили учебу) / 10.0"	0	0	0	0	0	0	0	0	0	0	0	0	0	1	1	0	0	0	2	2
Оренбургская область	Частные; Заочная	"    отчислено:
         по неуспеваемости / 11.0"	0	0	0	0	0	0	0	0	0	0	0	0	0	0	0	0	0	0	0	0
Оренбургская область	Частные; Заочная	"    переведено в другие образовательные организации
    на программы того же уровня / 8.0"	0	0	0	0	0	0	0	0	0	0	0	0	0	0	0	0	0	0	0	0
Оренбургская область	Частные; Заочная	"    переведено из других образовательных организаций 
    с программ того же уровня / 3.0"	0	0	0	0	0	0	0	0	0	0	0	0	0	0	0	0	0	0	0	0
Оренбургская область	Частные; Заочная	    по болезни / 9.0	0	0	0	0	0	0	0	0	0	0	0	0	0	0	0	0	0	0	0	0
Оренбургская область	Частные; Заочная	    прибыло по другим причинам / 5.0	0	0	0	0	0	0	0	0	0	0	0	0	0	0	0	0	0	0	0	0
Оренбургская область	Частные; Заочная	Выбыло студентов - всего (сумма стр. 07-11, 13-15) / 6.0	0	0	0	0	0	0	0	0	0	0	0	0	0	14	14	0	0	0	28	28
Оренбургская область	Частные; Заочная	Прибыло студентов - всего (сумма стр. 02-05) / 1.0	0	0	0	0	0	0	0	0	0	0	0	0	0	1	1	0	0	0	8	8
Оренбургская область	Частные; Заочная	"Численность студентов на начало прошлого учебного года
(на 1 октября) / 17.0"	0	0	0	0	0	0	0	0	0	0	0	0	0	34	34	0	0	0	47	47
Оренбургская область	Частные; Очная	            из стр. 11 - не прошли итоговую аттестацию / 12.0	0	0	0	0	0	0	0	0	0	0	0	0	0	0	0	0	0	0	0	0
Оренбургская область	Частные; Очная	"            из стр. 11 – лица с ограниченными возможностями здоровья,
            инвалиды, дети-инвалиды / 13.0"	0	0	0	0	0	0	0	0	0	0	0	0	0	0	0	0	0	0	0	0
Оренбургская область	Частные; Очная	         отчислено в виде меры дисциплинарного взыскания / 14.0	0	0	0	0	0	0	0	0	0	0	0	0	0	0	0	0	0	0	0	0
Оренбургская область	Частные; Очная	         отчислено из-за просрочки оплаты обучения / 15.0	0	0	0	0	0	0	0	0	0	0	0	0	0	24	24	0	0	0	5	5
Оренбургская область	Частные; Очная	"    в том числе:
    переведено на другие формы обучения данной
    организации на программы того же уровня / 7.0"	0	0	0	0	0	0	0	0	0	0	0	0	0	1	1	0	0	0	0	0
Оренбургская область	Частные; Очная	"    в том числе:
    переведено с других форм обучения данной
    образовательной организации с программ того же уровня / 2.0"	0	0	0	0	0	0	0	0	0	0	0	0	0	1	1	0	0	0	1	1
Оренбургская область	Частные; Очная	    восстановлены из числа ранее отчисленных / 4.0	0	0	0	0	0	0	0	0	0	0	0	0	0	6	6	0	0	0	0	0
Оренбургская область	Частные; Очная	    выбыло по другим причинам / 16.0	0	0	0	0	0	0	0	0	0	0	0	0	0	75	75	0	0	0	9	9
Оренбургская область	Частные; Очная	"    добровольно прекратили образовательные отношения
    (бросили учебу) / 10.0"	0	0	0	0	0	0	0	0	0	0	0	0	0	26	26	0	0	0	1	1
Оренбургская область	Частные; Очная	"    отчислено:
         по неуспеваемости / 11.0"	0	0	0	0	0	0	0	0	0	0	0	0	0	32	32	0	0	0	1	1
Оренбургская область	Частные; Очная	"    переведено в другие образовательные организации
    на программы того же уровня / 8.0"	0	0	0	0	0	0	0	0	0	0	0	0	0	9	9	0	0	0	0	0
Оренбургская область	Частные; Очная	"    переведено из других образовательных организаций 
    с программ того же уровня / 3.0"	0	0	0	0	0	0	0	0	0	0	0	0	0	6	6	0	0	0	5	5
Оренбургская область	Частные; Очная	    по болезни / 9.0	0	0	0	0	0	0	0	0	0	0	0	0	0	0	0	0	0	0	0	0
Оренбургская область	Частные; Очная	    прибыло по другим причинам / 5.0	0	0	0	0	0	0	0	0	0	0	0	0	0	4	4	0	0	0	0	0
Оренбургская область	Частные; Очная	Выбыло студентов - всего (сумма стр. 07-11, 13-15) / 6.0	0	0	0	0	0	0	0	0	0	0	0	0	0	167	167	0	0	0	16	16
Оренбургская область	Частные; Очная	Прибыло студентов - всего (сумма стр. 02-05) / 1.0	0	0	0	0	0	0	0	0	0	0	0	0	0	17	17	0	0	0	6	6
Оренбургская область	Частные; Очная	"Численность студентов на начало прошлого учебного года
(на 1 октября) / 17.0"	0	0	0	0	0	0	0	0	0	0	0	0	0	1000	1000	0	0	0	74	74
Орловская область	Государственные, муниципальные (без учета организаций в ведении ФСИН); Заочная	            из стр. 11 - не прошли итоговую аттестацию / 12.0	0	0	0	0	0	0	0	0	0	0	0	0	0	0	0	0	0	0	0	0
Орловская область	Государственные, муниципальные (без учета организаций в ведении ФСИН); Заочная	"            из стр. 11 – лица с ограниченными возможностями здоровья,
            инвалиды, дети-инвалиды / 13.0"	0	0	0	0	0	0	0	0	0	0	0	0	0	0	0	0	0	0	0	0
Орловская область	Государственные, муниципальные (без учета организаций в ведении ФСИН); Заочная	         отчислено в виде меры дисциплинарного взыскания / 14.0	0	0	0	0	0	0	0	0	0	0	0	0	0	0	0	0	0	0	0	0
Орловская область	Государственные, муниципальные (без учета организаций в ведении ФСИН); Заочная	         отчислено из-за просрочки оплаты обучения / 15.0	0	0	0	0	0	0	0	0	0	0	0	0	0	0	0	0	0	0	0	0
Орловская область	Государственные, муниципальные (без учета организаций в ведении ФСИН); Заочная	"    в том числе:
    переведено на другие формы обучения данной
    организации на программы того же уровня / 7.0"	0	0	0	0	0	0	0	0	0	0	0	0	0	0	0	1	0	0	1	2
Орловская область	Государственные, муниципальные (без учета организаций в ведении ФСИН); Заочная	"    в том числе:
    переведено с других форм обучения данной
    образовательной организации с программ того же уровня / 2.0"	0	0	0	0	0	0	0	0	0	0	0	0	0	4	4	4	0	0	1	5
Орловская область	Государственные, муниципальные (без учета организаций в ведении ФСИН); Заочная	    восстановлены из числа ранее отчисленных / 4.0	0	0	0	0	0	0	0	0	0	0	0	0	0	3	3	1	0	0	2	3
Орловская область	Государственные, муниципальные (без учета организаций в ведении ФСИН); Заочная	    выбыло по другим причинам / 16.0	0	0	0	0	0	0	0	0	0	0	0	0	0	1	1	3	0	3	0	6
Орловская область	Государственные, муниципальные (без учета организаций в ведении ФСИН); Заочная	"    добровольно прекратили образовательные отношения
    (бросили учебу) / 10.0"	0	0	0	0	0	0	0	0	0	0	4	0	0	8	12	17	0	5	9	31
Орловская область	Государственные, муниципальные (без учета организаций в ведении ФСИН); Заочная	"    отчислено:
         по неуспеваемости / 11.0"	0	0	0	0	0	0	0	0	0	0	0	0	0	9	9	11	0	11	16	38
Орловская область	Государственные, муниципальные (без учета организаций в ведении ФСИН); Заочная	"    переведено в другие образовательные организации
    на программы того же уровня / 8.0"	0	0	0	0	0	0	0	0	0	0	0	0	0	1	1	0	0	1	0	1
Орловская область	Государственные, муниципальные (без учета организаций в ведении ФСИН); Заочная	"    переведено из других образовательных организаций 
    с программ того же уровня / 3.0"	0	0	0	0	0	0	0	0	0	0	0	0	0	0	0	1	0	0	1	2
Орловская область	Государственные, муниципальные (без учета организаций в ведении ФСИН); Заочная	    по болезни / 9.0	0	0	0	0	0	0	0	0	0	0	0	0	0	0	0	0	0	0	0	0
Орловская область	Государственные, муниципальные (без учета организаций в ведении ФСИН); Заочная	    прибыло по другим причинам / 5.0	0	0	0	0	0	0	0	0	0	0	0	0	0	0	0	0	0	0	5	5
Орловская область	Государственные, муниципальные (без учета организаций в ведении ФСИН); Заочная	Выбыло студентов - всего (сумма стр. 07-11, 13-15) / 6.0	0	0	0	0	0	0	0	0	0	0	4	0	0	19	23	32	0	20	26	78
Орловская область	Государственные, муниципальные (без учета организаций в ведении ФСИН); Заочная	Прибыло студентов - всего (сумма стр. 02-05) / 1.0	0	0	0	0	0	0	0	0	0	0	0	0	0	7	7	6	0	0	9	15
Орловская область	Государственные, муниципальные (без учета организаций в ведении ФСИН); Заочная	"Численность студентов на начало прошлого учебного года
(на 1 октября) / 17.0"	0	0	0	0	0	0	0	0	0	0	49	0	0	71	120	477	0	104	169	750
Орловская область	Государственные, муниципальные (без учета организаций в ведении ФСИН); Очная	            из стр. 11 - не прошли итоговую аттестацию / 12.0	0	0	0	0	0	0	0	0	0	0	2	0	0	0	2	0	0	0	0	0
Орловская область	Государственные, муниципальные (без учета организаций в ведении ФСИН); Очная	"            из стр. 11 – лица с ограниченными возможностями здоровья,
            инвалиды, дети-инвалиды / 13.0"	0	0	0	0	0	0	0	0	0	0	1	0	1	0	2	1	0	0	0	1
Орловская область	Государственные, муниципальные (без учета организаций в ведении ФСИН); Очная	         отчислено в виде меры дисциплинарного взыскания / 14.0	1	0	0	0	1	0	0	0	0	0	6	0	0	0	6	0	0	0	0	0
Орловская область	Государственные, муниципальные (без учета организаций в ведении ФСИН); Очная	         отчислено из-за просрочки оплаты обучения / 15.0	0	0	0	0	0	0	0	0	0	0	0	0	0	13	13	0	0	0	0	0
Орловская область	Государственные, муниципальные (без учета организаций в ведении ФСИН); Очная	"    в том числе:
    переведено на другие формы обучения данной
    организации на программы того же уровня / 7.0"	2	0	0	4	6	0	0	0	0	0	4	0	5	7	16	0	0	0	1	1
Орловская область	Государственные, муниципальные (без учета организаций в ведении ФСИН); Очная	"    в том числе:
    переведено с других форм обучения данной
    образовательной организации с программ того же уровня / 2.0"	0	0	0	0	0	0	0	0	0	0	3	0	3	5	11	1	0	0	1	2
Орловская область	Государственные, муниципальные (без учета организаций в ведении ФСИН); Очная	    восстановлены из числа ранее отчисленных / 4.0	5	0	0	0	5	0	0	0	0	0	15	0	6	10	31	0	0	0	0	0
Орловская область	Государственные, муниципальные (без учета организаций в ведении ФСИН); Очная	    выбыло по другим причинам / 16.0	60	0	0	1	61	0	0	0	0	0	82	0	37	11	130	1	0	0	0	1
Орловская область	Государственные, муниципальные (без учета организаций в ведении ФСИН); Очная	"    добровольно прекратили образовательные отношения
    (бросили учебу) / 10.0"	137	0	0	0	137	0	0	0	0	0	250	29	116	88	483	21	0	0	14	35
Орловская область	Государственные, муниципальные (без учета организаций в ведении ФСИН); Очная	"    отчислено:
         по неуспеваемости / 11.0"	19	0	0	0	19	0	0	0	0	0	55	0	18	23	96	5	0	0	2	7
Орловская область	Государственные, муниципальные (без учета организаций в ведении ФСИН); Очная	"    переведено в другие образовательные организации
    на программы того же уровня / 8.0"	9	0	0	0	9	0	0	0	0	0	91	0	31	29	151	0	0	0	0	0
Орловская область	Государственные, муниципальные (без учета организаций в ведении ФСИН); Очная	"    переведено из других образовательных организаций 
    с программ того же уровня / 3.0"	13	0	0	0	13	0	0	0	0	0	72	0	23	26	121	0	0	0	0	0
Орловская область	Государственные, муниципальные (без учета организаций в ведении ФСИН); Очная	    по болезни / 9.0	0	0	0	0	0	0	0	0	0	0	1	0	0	0	1	0	0	0	0	0
Орловская область	Государственные, муниципальные (без учета организаций в ведении ФСИН); Очная	    прибыло по другим причинам / 5.0	33	0	0	0	33	0	0	0	0	0	35	0	39	44	118	0	0	0	0	0
Орловская область	Государственные, муниципальные (без учета организаций в ведении ФСИН); Очная	Выбыло студентов - всего (сумма стр. 07-11, 13-15) / 6.0	228	0	0	5	233	0	0	0	0	0	489	29	207	171	896	27	0	0	17	44
Орловская область	Государственные, муниципальные (без учета организаций в ведении ФСИН); Очная	Прибыло студентов - всего (сумма стр. 02-05) / 1.0	51	0	0	0	51	0	0	0	0	0	125	0	71	85	281	1	0	0	1	2
Орловская область	Государственные, муниципальные (без учета организаций в ведении ФСИН); Очная	"Численность студентов на начало прошлого учебного года
(на 1 октября) / 17.0"	2253	73	0	133	2459	34	21	0	0	55	6657	312	3023	2628	12620	284	56	1	191	532
Орловская область	Очно-заочная; Государственные, муниципальные (без учета организаций в ведении ФСИН)	            из стр. 11 - не прошли итоговую аттестацию / 12.0	0	0	0	0	0	0	0	0	0	0	0	0	0	0	0	0	0	0	0	0
Орловская область	Очно-заочная; Государственные, муниципальные (без учета организаций в ведении ФСИН)	"            из стр. 11 – лица с ограниченными возможностями здоровья,
            инвалиды, дети-инвалиды / 13.0"	0	0	0	0	0	0	0	0	0	0	0	0	0	0	0	0	0	0	0	0
Орловская область	Очно-заочная; Государственные, муниципальные (без учета организаций в ведении ФСИН)	         отчислено в виде меры дисциплинарного взыскания / 14.0	0	0	0	0	0	0	0	0	0	0	0	0	0	0	0	0	0	0	0	0
Орловская область	Очно-заочная; Государственные, муниципальные (без учета организаций в ведении ФСИН)	         отчислено из-за просрочки оплаты обучения / 15.0	0	0	0	0	0	0	0	0	0	0	0	0	0	1	1	0	0	0	0	0
Орловская область	Очно-заочная; Государственные, муниципальные (без учета организаций в ведении ФСИН)	"    в том числе:
    переведено на другие формы обучения данной
    организации на программы того же уровня / 7.0"	0	0	0	0	0	0	0	0	0	0	0	0	0	2	2	0	0	0	0	0
Орловская область	Очно-заочная; Государственные, муниципальные (без учета организаций в ведении ФСИН)	"    в том числе:
    переведено с других форм обучения данной
    образовательной организации с программ того же уровня / 2.0"	0	0	0	0	0	0	0	0	0	0	0	0	0	1	1	0	0	0	0	0
Орловская область	Очно-заочная; Государственные, муниципальные (без учета организаций в ведении ФСИН)	    восстановлены из числа ранее отчисленных / 4.0	0	0	0	0	0	0	0	0	0	0	0	0	0	0	0	0	0	0	0	0
Орловская область	Очно-заочная; Государственные, муниципальные (без учета организаций в ведении ФСИН)	    выбыло по другим причинам / 16.0	0	0	0	0	0	0	0	0	0	0	0	0	0	0	0	0	0	0	0	0
Орловская область	Очно-заочная; Государственные, муниципальные (без учета организаций в ведении ФСИН)	"    добровольно прекратили образовательные отношения
    (бросили учебу) / 10.0"	0	0	0	0	0	0	0	0	0	0	0	0	0	13	13	0	0	0	10	10
Орловская область	Очно-заочная; Государственные, муниципальные (без учета организаций в ведении ФСИН)	"    отчислено:
         по неуспеваемости / 11.0"	0	0	0	0	0	0	0	0	0	0	0	0	0	2	2	0	0	0	1	1
Орловская область	Очно-заочная; Государственные, муниципальные (без учета организаций в ведении ФСИН)	"    переведено в другие образовательные организации
    на программы того же уровня / 8.0"	0	0	0	0	0	0	0	0	0	0	0	0	0	2	2	0	0	0	0	0
Орловская область	Очно-заочная; Государственные, муниципальные (без учета организаций в ведении ФСИН)	"    переведено из других образовательных организаций 
    с программ того же уровня / 3.0"	0	0	0	0	0	0	0	0	0	0	0	0	0	2	2	0	0	0	0	0
Орловская область	Очно-заочная; Государственные, муниципальные (без учета организаций в ведении ФСИН)	    по болезни / 9.0	0	0	0	0	0	0	0	0	0	0	0	0	0	0	0	0	0	0	0	0
Орловская область	Очно-заочная; Государственные, муниципальные (без учета организаций в ведении ФСИН)	    прибыло по другим причинам / 5.0	0	0	0	0	0	0	0	0	0	0	0	0	0	0	0	0	0	0	0	0
Орловская область	Очно-заочная; Государственные, муниципальные (без учета организаций в ведении ФСИН)	Выбыло студентов - всего (сумма стр. 07-11, 13-15) / 6.0	0	0	0	0	0	0	0	0	0	0	0	0	0	20	20	0	0	0	11	11
Орловская область	Очно-заочная; Государственные, муниципальные (без учета организаций в ведении ФСИН)	Прибыло студентов - всего (сумма стр. 02-05) / 1.0	0	0	0	0	0	0	0	0	0	0	0	0	0	3	3	0	0	0	0	0
Орловская область	Очно-заочная; Государственные, муниципальные (без учета организаций в ведении ФСИН)	"Численность студентов на начало прошлого учебного года
(на 1 октября) / 17.0"	0	0	0	0	0	0	0	0	0	0	0	0	0	82	82	23	0	0	137	160
Орловская область	Частные; Заочная	            из стр. 11 - не прошли итоговую аттестацию / 12.0	0	0	0	0	0	0	0	0	0	0	0	0	0	0	0	0	0	0	0	0
Орловская область	Частные; Заочная	"            из стр. 11 – лица с ограниченными возможностями здоровья,
            инвалиды, дети-инвалиды / 13.0"	0	0	0	0	0	0	0	0	0	0	0	0	0	0	0	0	0	0	0	0
Орловская область	Частные; Заочная	         отчислено в виде меры дисциплинарного взыскания / 14.0	0	0	0	0	0	0	0	0	0	0	0	0	0	0	0	0	0	0	0	0
Орловская область	Частные; Заочная	         отчислено из-за просрочки оплаты обучения / 15.0	0	0	0	0	0	0	0	0	0	0	0	0	0	0	0	0	0	0	0	0
Орловская область	Частные; Заочная	"    в том числе:
    переведено на другие формы обучения данной
    организации на программы того же уровня / 7.0"	0	0	0	0	0	0	0	0	0	0	0	0	0	0	0	0	0	0	0	0
Орловская область	Частные; Заочная	"    в том числе:
    переведено с других форм обучения данной
    образовательной организации с программ того же уровня / 2.0"	0	0	0	0	0	0	0	0	0	0	0	0	0	0	0	0	0	0	0	0
Орловская область	Частные; Заочная	    восстановлены из числа ранее отчисленных / 4.0	0	0	0	0	0	0	0	0	0	0	0	0	0	0	0	0	0	0	0	0
Орловская область	Частные; Заочная	    выбыло по другим причинам / 16.0	0	0	0	0	0	0	0	0	0	0	0	0	0	0	0	0	0	0	0	0
Орловская область	Частные; Заочная	"    добровольно прекратили образовательные отношения
    (бросили учебу) / 10.0"	0	0	0	0	0	0	0	0	0	0	0	0	0	0	0	0	0	0	0	0
Орловская область	Частные; Заочная	"    отчислено:
         по неуспеваемости / 11.0"	0	0	0	0	0	0	0	0	0	0	0	0	0	0	0	0	0	0	0	0
Орловская область	Частные; Заочная	"    переведено в другие образовательные организации
    на программы того же уровня / 8.0"	0	0	0	0	0	0	0	0	0	0	0	0	0	0	0	0	0	0	0	0
Орловская область	Частные; Заочная	"    переведено из других образовательных организаций 
    с программ того же уровня / 3.0"	0	0	0	0	0	0	0	0	0	0	0	0	0	0	0	0	0	0	0	0
Орловская область	Частные; Заочная	    по болезни / 9.0	0	0	0	0	0	0	0	0	0	0	0	0	0	0	0	0	0	0	0	0
Орловская область	Частные; Заочная	    прибыло по другим причинам / 5.0	0	0	0	0	0	0	0	0	0	0	0	0	0	0	0	0	0	0	0	0
Орловская область	Частные; Заочная	Выбыло студентов - всего (сумма стр. 07-11, 13-15) / 6.0	0	0	0	0	0	0	0	0	0	0	0	0	0	0	0	0	0	0	0	0
Орловская область	Частные; Заочная	Прибыло студентов - всего (сумма стр. 02-05) / 1.0	0	0	0	0	0	0	0	0	0	0	0	0	0	0	0	0	0	0	0	0
Орловская область	Частные; Заочная	"Численность студентов на начало прошлого учебного года
(на 1 октября) / 17.0"	0	0	0	0	0	0	0	0	0	0	0	0	0	0	0	0	0	0	3	3
Орловская область	Частные; Очная	            из стр. 11 - не прошли итоговую аттестацию / 12.0	0	0	0	0	0	0	0	0	0	0	0	0	0	0	0	0	0	0	0	0
Орловская область	Частные; Очная	"            из стр. 11 – лица с ограниченными возможностями здоровья,
            инвалиды, дети-инвалиды / 13.0"	0	0	0	0	0	0	0	0	0	0	0	0	0	0	0	0	0	0	0	0
Орловская область	Частные; Очная	         отчислено в виде меры дисциплинарного взыскания / 14.0	0	0	0	0	0	0	0	0	0	0	0	0	0	0	0	0	0	0	0	0
Орловская область	Частные; Очная	         отчислено из-за просрочки оплаты обучения / 15.0	0	0	0	0	0	0	0	0	0	0	0	0	0	0	0	0	0	0	0	0
Орловская область	Частные; Очная	"    в том числе:
    переведено на другие формы обучения данной
    организации на программы того же уровня / 7.0"	0	0	0	0	0	0	0	0	0	0	0	0	0	0	0	0	0	0	0	0
Орловская область	Частные; Очная	"    в том числе:
    переведено с других форм обучения данной
    образовательной организации с программ того же уровня / 2.0"	0	0	0	0	0	0	0	0	0	0	0	0	0	0	0	0	0	0	0	0
Орловская область	Частные; Очная	    восстановлены из числа ранее отчисленных / 4.0	0	0	0	0	0	0	0	0	0	0	0	0	0	0	0	0	0	0	0	0
Орловская область	Частные; Очная	    выбыло по другим причинам / 16.0	0	0	0	0	0	0	0	0	0	0	0	0	0	1	1	0	0	0	16	16
Орловская область	Частные; Очная	"    добровольно прекратили образовательные отношения
    (бросили учебу) / 10.0"	0	0	0	0	0	0	0	0	0	0	0	0	0	2	2	0	0	0	1	1
Орловская область	Частные; Очная	"    отчислено:
         по неуспеваемости / 11.0"	0	0	0	0	0	0	0	0	0	0	0	0	0	0	0	0	0	0	0	0
Орловская область	Частные; Очная	"    переведено в другие образовательные организации
    на программы того же уровня / 8.0"	0	0	0	0	0	0	0	0	0	0	0	0	0	0	0	0	0	0	0	0
Орловская область	Частные; Очная	"    переведено из других образовательных организаций 
    с программ того же уровня / 3.0"	0	0	0	0	0	0	0	0	0	0	0	0	0	1	1	0	0	0	1	1
Орловская область	Частные; Очная	    по болезни / 9.0	0	0	0	0	0	0	0	0	0	0	0	0	0	0	0	0	0	0	0	0
Орловская область	Частные; Очная	    прибыло по другим причинам / 5.0	0	0	0	0	0	0	0	0	0	0	0	0	0	0	0	0	0	0	0	0
Орловская область	Частные; Очная	Выбыло студентов - всего (сумма стр. 07-11, 13-15) / 6.0	0	0	0	0	0	0	0	0	0	0	0	0	0	3	3	0	0	0	17	17
Орловская область	Частные; Очная	Прибыло студентов - всего (сумма стр. 02-05) / 1.0	0	0	0	0	0	0	0	0	0	0	0	0	0	1	1	0	0	0	1	1
Орловская область	Частные; Очная	"Численность студентов на начало прошлого учебного года
(на 1 октября) / 17.0"	0	0	0	0	0	0	0	0	0	0	0	0	0	24	24	0	0	0	27	27
Пензенская область	Государственные, муниципальные (без учета организаций в ведении ФСИН); Заочная	            из стр. 11 - не прошли итоговую аттестацию / 12.0	0	0	0	0	0	0	0	0	0	0	0	0	0	0	0	2	0	0	2	4
Пензенская область	Государственные, муниципальные (без учета организаций в ведении ФСИН); Заочная	"            из стр. 11 – лица с ограниченными возможностями здоровья,
            инвалиды, дети-инвалиды / 13.0"	0	0	0	0	0	0	0	0	0	0	0	0	0	0	0	0	0	0	0	0
Пензенская область	Государственные, муниципальные (без учета организаций в ведении ФСИН); Заочная	         отчислено в виде меры дисциплинарного взыскания / 14.0	0	0	0	0	0	0	0	0	0	0	0	0	0	0	0	0	0	0	0	0
Пензенская область	Государственные, муниципальные (без учета организаций в ведении ФСИН); Заочная	         отчислено из-за просрочки оплаты обучения / 15.0	0	0	0	0	0	0	0	0	0	0	0	0	0	9	9	0	0	0	9	9
Пензенская область	Государственные, муниципальные (без учета организаций в ведении ФСИН); Заочная	"    в том числе:
    переведено на другие формы обучения данной
    организации на программы того же уровня / 7.0"	0	0	0	0	0	0	0	0	0	0	0	0	0	1	1	4	0	0	0	4
Пензенская область	Государственные, муниципальные (без учета организаций в ведении ФСИН); Заочная	"    в том числе:
    переведено с других форм обучения данной
    образовательной организации с программ того же уровня / 2.0"	0	0	0	0	0	0	0	0	0	0	0	0	0	2	2	16	0	0	12	28
Пензенская область	Государственные, муниципальные (без учета организаций в ведении ФСИН); Заочная	    восстановлены из числа ранее отчисленных / 4.0	0	0	0	0	0	0	0	0	0	0	0	0	0	3	3	6	0	0	5	11
Пензенская область	Государственные, муниципальные (без учета организаций в ведении ФСИН); Заочная	    выбыло по другим причинам / 16.0	0	0	0	0	0	0	0	0	0	0	0	0	0	0	0	12	0	0	8	20
Пензенская область	Государственные, муниципальные (без учета организаций в ведении ФСИН); Заочная	"    добровольно прекратили образовательные отношения
    (бросили учебу) / 10.0"	0	0	0	0	0	0	0	0	0	0	19	0	0	4	23	44	0	0	45	89
Пензенская область	Государственные, муниципальные (без учета организаций в ведении ФСИН); Заочная	"    отчислено:
         по неуспеваемости / 11.0"	0	0	0	0	0	0	0	0	0	0	3	0	0	0	3	37	0	0	30	67
Пензенская область	Государственные, муниципальные (без учета организаций в ведении ФСИН); Заочная	"    переведено в другие образовательные организации
    на программы того же уровня / 8.0"	0	0	0	0	0	0	0	0	0	0	0	0	0	0	0	0	0	0	15	15
Пензенская область	Государственные, муниципальные (без учета организаций в ведении ФСИН); Заочная	"    переведено из других образовательных организаций 
    с программ того же уровня / 3.0"	0	0	0	0	0	0	0	0	0	0	0	0	0	1	1	2	0	0	3	5
Пензенская область	Государственные, муниципальные (без учета организаций в ведении ФСИН); Заочная	    по болезни / 9.0	0	0	0	0	0	0	0	0	0	0	0	0	0	0	0	0	0	0	0	0
Пензенская область	Государственные, муниципальные (без учета организаций в ведении ФСИН); Заочная	    прибыло по другим причинам / 5.0	0	0	0	0	0	0	0	0	0	0	0	0	0	0	0	0	0	0	0	0
Пензенская область	Государственные, муниципальные (без учета организаций в ведении ФСИН); Заочная	Выбыло студентов - всего (сумма стр. 07-11, 13-15) / 6.0	0	0	0	0	0	0	0	0	0	0	22	0	0	14	36	97	0	0	107	204
Пензенская область	Государственные, муниципальные (без учета организаций в ведении ФСИН); Заочная	Прибыло студентов - всего (сумма стр. 02-05) / 1.0	0	0	0	0	0	0	0	0	0	0	0	0	0	6	6	24	0	0	20	44
Пензенская область	Государственные, муниципальные (без учета организаций в ведении ФСИН); Заочная	"Численность студентов на начало прошлого учебного года
(на 1 октября) / 17.0"	0	0	0	0	0	0	0	0	0	0	66	0	0	49	115	984	0	205	201	1390
Пензенская область	Государственные, муниципальные (без учета организаций в ведении ФСИН); Очная	            из стр. 11 - не прошли итоговую аттестацию / 12.0	9	0	0	0	9	0	0	0	0	0	15	0	2	0	17	7	0	0	0	7
Пензенская область	Государственные, муниципальные (без учета организаций в ведении ФСИН); Очная	"            из стр. 11 – лица с ограниченными возможностями здоровья,
            инвалиды, дети-инвалиды / 13.0"	0	0	0	0	0	0	0	0	0	0	0	0	0	0	0	2	0	0	0	2
Пензенская область	Государственные, муниципальные (без учета организаций в ведении ФСИН); Очная	         отчислено в виде меры дисциплинарного взыскания / 14.0	0	0	0	0	0	0	0	0	0	0	7	0	3	0	10	6	0	0	0	6
Пензенская область	Государственные, муниципальные (без учета организаций в ведении ФСИН); Очная	         отчислено из-за просрочки оплаты обучения / 15.0	0	0	0	0	0	0	0	0	0	0	0	0	0	23	23	0	0	0	17	17
Пензенская область	Государственные, муниципальные (без учета организаций в ведении ФСИН); Очная	"    в том числе:
    переведено на другие формы обучения данной
    организации на программы того же уровня / 7.0"	0	0	0	0	0	0	0	0	0	0	32	0	12	12	56	1	0	0	2	3
Пензенская область	Государственные, муниципальные (без учета организаций в ведении ФСИН); Очная	"    в том числе:
    переведено с других форм обучения данной
    образовательной организации с программ того же уровня / 2.0"	5	0	0	0	5	0	0	0	0	0	34	0	4	7	45	0	0	2	5	7
Пензенская область	Государственные, муниципальные (без учета организаций в ведении ФСИН); Очная	    восстановлены из числа ранее отчисленных / 4.0	16	0	0	0	16	0	0	0	0	0	55	0	7	57	119	7	0	0	4	11
Пензенская область	Государственные, муниципальные (без учета организаций в ведении ФСИН); Очная	    выбыло по другим причинам / 16.0	34	0	0	0	34	0	0	0	7	7	89	0	10	40	139	6	0	1	17	24
Пензенская область	Государственные, муниципальные (без учета организаций в ведении ФСИН); Очная	"    добровольно прекратили образовательные отношения
    (бросили учебу) / 10.0"	206	0	0	4	210	0	0	0	10	10	336	0	131	198	665	61	0	2	85	148
Пензенская область	Государственные, муниципальные (без учета организаций в ведении ФСИН); Очная	"    отчислено:
         по неуспеваемости / 11.0"	129	0	0	0	129	0	0	0	0	0	114	0	12	43	169	10	0	0	10	20
Пензенская область	Государственные, муниципальные (без учета организаций в ведении ФСИН); Очная	"    переведено в другие образовательные организации
    на программы того же уровня / 8.0"	31	0	0	3	34	0	0	0	0	0	178	0	17	114	309	6	0	0	3	9
Пензенская область	Государственные, муниципальные (без учета организаций в ведении ФСИН); Очная	"    переведено из других образовательных организаций 
    с программ того же уровня / 3.0"	36	0	0	0	36	0	0	0	0	0	86	0	22	33	141	1	0	0	3	4
Пензенская область	Государственные, муниципальные (без учета организаций в ведении ФСИН); Очная	    по болезни / 9.0	0	0	0	0	0	0	0	0	0	0	8	0	0	2	10	3	0	0	0	3
Пензенская область	Государственные, муниципальные (без учета организаций в ведении ФСИН); Очная	    прибыло по другим причинам / 5.0	19	0	0	8	27	0	0	0	0	0	10	0	8	31	49	22	0	0	10	32
Пензенская область	Государственные, муниципальные (без учета организаций в ведении ФСИН); Очная	Выбыло студентов - всего (сумма стр. 07-11, 13-15) / 6.0	400	0	0	7	407	0	0	0	17	17	764	0	185	432	1381	93	0	3	134	230
Пензенская область	Государственные, муниципальные (без учета организаций в ведении ФСИН); Очная	Прибыло студентов - всего (сумма стр. 02-05) / 1.0	76	0	0	8	84	0	0	0	0	0	185	0	41	128	354	30	0	2	22	54
Пензенская область	Государственные, муниципальные (без учета организаций в ведении ФСИН); Очная	"Численность студентов на начало прошлого учебного года
(на 1 октября) / 17.0"	5198	0	0	129	5327	50	0	0	30	80	12664	0	3510	4171	20345	950	0	141	857	1948
Пензенская область	Очно-заочная; Государственные, муниципальные (без учета организаций в ведении ФСИН)	            из стр. 11 - не прошли итоговую аттестацию / 12.0	0	0	0	0	0	0	0	0	0	0	0	0	0	0	0	0	0	0	0	0
Пензенская область	Очно-заочная; Государственные, муниципальные (без учета организаций в ведении ФСИН)	"            из стр. 11 – лица с ограниченными возможностями здоровья,
            инвалиды, дети-инвалиды / 13.0"	0	0	0	0	0	0	0	0	0	0	0	0	0	0	0	0	0	0	0	0
Пензенская область	Очно-заочная; Государственные, муниципальные (без учета организаций в ведении ФСИН)	         отчислено в виде меры дисциплинарного взыскания / 14.0	0	0	0	0	0	0	0	0	0	0	0	0	0	0	0	0	0	0	0	0
Пензенская область	Очно-заочная; Государственные, муниципальные (без учета организаций в ведении ФСИН)	         отчислено из-за просрочки оплаты обучения / 15.0	0	0	0	0	0	0	0	0	0	0	0	0	0	0	0	0	0	0	0	0
Пензенская область	Очно-заочная; Государственные, муниципальные (без учета организаций в ведении ФСИН)	"    в том числе:
    переведено на другие формы обучения данной
    организации на программы того же уровня / 7.0"	0	0	0	0	0	0	0	0	0	0	0	0	0	0	0	0	0	0	0	0
Пензенская область	Очно-заочная; Государственные, муниципальные (без учета организаций в ведении ФСИН)	"    в том числе:
    переведено с других форм обучения данной
    образовательной организации с программ того же уровня / 2.0"	0	0	0	0	0	0	0	0	0	0	0	0	0	0	0	2	0	0	0	2
Пензенская область	Очно-заочная; Государственные, муниципальные (без учета организаций в ведении ФСИН)	    восстановлены из числа ранее отчисленных / 4.0	0	0	0	0	0	0	0	0	0	0	0	0	0	0	0	0	0	0	0	0
Пензенская область	Очно-заочная; Государственные, муниципальные (без учета организаций в ведении ФСИН)	    выбыло по другим причинам / 16.0	0	0	0	0	0	0	0	0	0	0	0	0	0	0	0	0	0	0	0	0
Пензенская область	Очно-заочная; Государственные, муниципальные (без учета организаций в ведении ФСИН)	"    добровольно прекратили образовательные отношения
    (бросили учебу) / 10.0"	0	0	0	0	0	0	0	0	0	0	0	0	0	1	1	0	0	0	0	0
Пензенская область	Очно-заочная; Государственные, муниципальные (без учета организаций в ведении ФСИН)	"    отчислено:
         по неуспеваемости / 11.0"	0	0	0	0	0	0	0	0	0	0	0	0	0	0	0	1	0	0	1	2
Пензенская область	Очно-заочная; Государственные, муниципальные (без учета организаций в ведении ФСИН)	"    переведено в другие образовательные организации
    на программы того же уровня / 8.0"	0	0	0	0	0	0	0	0	0	0	0	0	0	0	0	0	0	0	0	0
Пензенская область	Очно-заочная; Государственные, муниципальные (без учета организаций в ведении ФСИН)	"    переведено из других образовательных организаций 
    с программ того же уровня / 3.0"	0	0	0	0	0	0	0	0	0	0	0	0	0	0	0	0	0	0	0	0
Пензенская область	Очно-заочная; Государственные, муниципальные (без учета организаций в ведении ФСИН)	    по болезни / 9.0	0	0	0	0	0	0	0	0	0	0	0	0	0	0	0	0	0	0	0	0
Пензенская область	Очно-заочная; Государственные, муниципальные (без учета организаций в ведении ФСИН)	    прибыло по другим причинам / 5.0	0	0	0	0	0	0	0	0	0	0	0	0	0	0	0	0	0	0	0	0
Пензенская область	Очно-заочная; Государственные, муниципальные (без учета организаций в ведении ФСИН)	Выбыло студентов - всего (сумма стр. 07-11, 13-15) / 6.0	0	0	0	0	0	0	0	0	0	0	0	0	0	1	1	1	0	0	1	2
Пензенская область	Очно-заочная; Государственные, муниципальные (без учета организаций в ведении ФСИН)	Прибыло студентов - всего (сумма стр. 02-05) / 1.0	0	0	0	0	0	0	0	0	0	0	0	0	0	0	0	2	0	0	0	2
Пензенская область	Очно-заочная; Государственные, муниципальные (без учета организаций в ведении ФСИН)	"Численность студентов на начало прошлого учебного года
(на 1 октября) / 17.0"	0	0	0	0	0	0	0	0	0	0	0	0	0	1	1	22	0	0	1	23
Пензенская область	Частные; Заочная	            из стр. 11 - не прошли итоговую аттестацию / 12.0	0	0	0	0	0	0	0	0	0	0	0	0	0	0	0	0	0	0	4	4
Пензенская область	Частные; Заочная	"            из стр. 11 – лица с ограниченными возможностями здоровья,
            инвалиды, дети-инвалиды / 13.0"	0	0	0	0	0	0	0	0	0	0	0	0	0	0	0	0	0	0	0	0
Пензенская область	Частные; Заочная	         отчислено в виде меры дисциплинарного взыскания / 14.0	0	0	0	0	0	0	0	0	0	0	0	0	0	0	0	0	0	0	1	1
Пензенская область	Частные; Заочная	         отчислено из-за просрочки оплаты обучения / 15.0	0	0	0	0	0	0	0	0	0	0	0	0	0	0	0	0	0	0	20	20
Пензенская область	Частные; Заочная	"    в том числе:
    переведено на другие формы обучения данной
    организации на программы того же уровня / 7.0"	0	0	0	0	0	0	0	0	0	0	0	0	0	0	0	0	0	0	0	0
Пензенская область	Частные; Заочная	"    в том числе:
    переведено с других форм обучения данной
    образовательной организации с программ того же уровня / 2.0"	0	0	0	0	0	0	0	0	0	0	0	0	0	0	0	0	0	0	0	0
Пензенская область	Частные; Заочная	    восстановлены из числа ранее отчисленных / 4.0	0	0	0	0	0	0	0	0	0	0	0	0	0	0	0	0	0	0	10	10
Пензенская область	Частные; Заочная	    выбыло по другим причинам / 16.0	0	0	0	0	0	0	0	0	0	0	0	0	0	0	0	0	0	0	5	5
Пензенская область	Частные; Заочная	"    добровольно прекратили образовательные отношения
    (бросили учебу) / 10.0"	0	0	0	0	0	0	0	0	0	0	0	0	0	0	0	0	0	0	8	8
Пензенская область	Частные; Заочная	"    отчислено:
         по неуспеваемости / 11.0"	0	0	0	0	0	0	0	0	0	0	0	0	0	0	0	0	0	0	31	31
Пензенская область	Частные; Заочная	"    переведено в другие образовательные организации
    на программы того же уровня / 8.0"	0	0	0	0	0	0	0	0	0	0	0	0	0	0	0	0	0	0	25	25
Пензенская область	Частные; Заочная	"    переведено из других образовательных организаций 
    с программ того же уровня / 3.0"	0	0	0	0	0	0	0	0	0	0	0	0	0	0	0	0	0	0	2	2
Пензенская область	Частные; Заочная	    по болезни / 9.0	0	0	0	0	0	0	0	0	0	0	0	0	0	0	0	0	0	0	0	0
Пензенская область	Частные; Заочная	    прибыло по другим причинам / 5.0	0	0	0	0	0	0	0	0	0	0	0	0	0	0	0	0	0	0	0	0
Пензенская область	Частные; Заочная	Выбыло студентов - всего (сумма стр. 07-11, 13-15) / 6.0	0	0	0	0	0	0	0	0	0	0	0	0	0	0	0	0	0	0	90	90
Пензенская область	Частные; Заочная	Прибыло студентов - всего (сумма стр. 02-05) / 1.0	0	0	0	0	0	0	0	0	0	0	0	0	0	0	0	0	0	0	12	12
Пензенская область	Частные; Заочная	"Численность студентов на начало прошлого учебного года
(на 1 октября) / 17.0"	0	0	0	0	0	0	0	0	0	0	0	0	0	0	0	0	0	0	831	831
Пензенская область	Частные; Очная	            из стр. 11 - не прошли итоговую аттестацию / 12.0	0	0	0	0	0	0	0	0	0	0	0	0	0	0	0	0	0	0	0	0
Пензенская область	Частные; Очная	"            из стр. 11 – лица с ограниченными возможностями здоровья,
            инвалиды, дети-инвалиды / 13.0"	0	0	0	0	0	0	0	0	0	0	0	0	0	0	0	0	0	0	0	0
Пензенская область	Частные; Очная	         отчислено в виде меры дисциплинарного взыскания / 14.0	0	0	0	0	0	0	0	0	0	0	0	0	0	5	5	0	0	0	1	1
Пензенская область	Частные; Очная	         отчислено из-за просрочки оплаты обучения / 15.0	0	0	0	0	0	0	0	0	0	0	0	0	0	0	0	0	0	0	0	0
Пензенская область	Частные; Очная	"    в том числе:
    переведено на другие формы обучения данной
    организации на программы того же уровня / 7.0"	0	0	0	0	0	0	0	0	0	0	0	0	0	0	0	0	0	0	0	0
Пензенская область	Частные; Очная	"    в том числе:
    переведено с других форм обучения данной
    образовательной организации с программ того же уровня / 2.0"	0	0	0	0	0	0	0	0	0	0	0	0	0	0	0	0	0	0	0	0
Пензенская область	Частные; Очная	    восстановлены из числа ранее отчисленных / 4.0	0	0	0	0	0	0	0	0	0	0	0	0	0	2	2	0	0	0	0	0
Пензенская область	Частные; Очная	    выбыло по другим причинам / 16.0	0	0	0	0	0	0	0	0	0	0	0	0	0	0	0	0	0	0	0	0
Пензенская область	Частные; Очная	"    добровольно прекратили образовательные отношения
    (бросили учебу) / 10.0"	0	0	0	0	0	0	0	0	0	0	0	0	0	37	37	0	0	0	26	26
Пензенская область	Частные; Очная	"    отчислено:
         по неуспеваемости / 11.0"	0	0	0	0	0	0	0	0	0	0	0	0	0	0	0	0	0	0	0	0
Пензенская область	Частные; Очная	"    переведено в другие образовательные организации
    на программы того же уровня / 8.0"	0	0	0	0	0	0	0	0	0	0	0	0	0	1	1	0	0	0	0	0
Пензенская область	Частные; Очная	"    переведено из других образовательных организаций 
    с программ того же уровня / 3.0"	0	0	0	0	0	0	0	0	0	0	0	0	0	24	24	0	0	0	1	1
Пензенская область	Частные; Очная	    по болезни / 9.0	0	0	0	0	0	0	0	0	0	0	0	0	0	0	0	0	0	0	0	0
Пензенская область	Частные; Очная	    прибыло по другим причинам / 5.0	0	0	0	0	0	0	0	0	0	0	0	0	0	0	0	0	0	0	0	0
Пензенская область	Частные; Очная	Выбыло студентов - всего (сумма стр. 07-11, 13-15) / 6.0	0	0	0	0	0	0	0	0	0	0	0	0	0	43	43	0	0	0	27	27
Пензенская область	Частные; Очная	Прибыло студентов - всего (сумма стр. 02-05) / 1.0	0	0	0	0	0	0	0	0	0	0	0	0	0	26	26	0	0	0	1	1
Пензенская область	Частные; Очная	"Численность студентов на начало прошлого учебного года
(на 1 октября) / 17.0"	0	0	0	0	0	0	0	0	0	0	0	0	0	175	175	0	0	0	27	27
Пермский край	Государственные, муниципальные (без учета организаций в ведении ФСИН); Заочная	            из стр. 11 - не прошли итоговую аттестацию / 12.0	0	0	0	0	0	0	0	0	0	0	0	0	0	5	5	0	0	0	8	8
Пермский край	Государственные, муниципальные (без учета организаций в ведении ФСИН); Заочная	"            из стр. 11 – лица с ограниченными возможностями здоровья,
            инвалиды, дети-инвалиды / 13.0"	0	0	0	0	0	0	0	0	0	0	0	0	0	0	0	0	0	0	0	0
Пермский край	Государственные, муниципальные (без учета организаций в ведении ФСИН); Заочная	         отчислено в виде меры дисциплинарного взыскания / 14.0	0	0	0	0	0	0	0	0	0	0	0	0	0	0	0	0	0	0	0	0
Пермский край	Государственные, муниципальные (без учета организаций в ведении ФСИН); Заочная	         отчислено из-за просрочки оплаты обучения / 15.0	0	0	0	0	0	0	0	0	0	0	0	0	0	24	24	0	0	0	80	80
Пермский край	Государственные, муниципальные (без учета организаций в ведении ФСИН); Заочная	"    в том числе:
    переведено на другие формы обучения данной
    организации на программы того же уровня / 7.0"	0	0	0	0	0	0	0	0	0	0	0	0	0	0	0	0	0	0	1	1
Пермский край	Государственные, муниципальные (без учета организаций в ведении ФСИН); Заочная	"    в том числе:
    переведено с других форм обучения данной
    образовательной организации с программ того же уровня / 2.0"	0	0	0	0	0	0	0	0	0	0	0	0	0	30	30	7	0	15	19	41
Пермский край	Государственные, муниципальные (без учета организаций в ведении ФСИН); Заочная	    восстановлены из числа ранее отчисленных / 4.0	0	0	0	0	0	0	0	0	0	0	0	0	0	39	39	22	0	1	61	84
Пермский край	Государственные, муниципальные (без учета организаций в ведении ФСИН); Заочная	    выбыло по другим причинам / 16.0	0	0	0	0	0	0	0	0	0	0	1	0	0	8	9	55	0	49	71	175
Пермский край	Государственные, муниципальные (без учета организаций в ведении ФСИН); Заочная	"    добровольно прекратили образовательные отношения
    (бросили учебу) / 10.0"	0	0	0	0	0	0	0	0	0	0	0	0	0	30	30	89	0	38	123	250
Пермский край	Государственные, муниципальные (без учета организаций в ведении ФСИН); Заочная	"    отчислено:
         по неуспеваемости / 11.0"	0	0	0	0	0	0	0	0	0	0	0	0	0	25	25	58	0	3	70	131
Пермский край	Государственные, муниципальные (без учета организаций в ведении ФСИН); Заочная	"    переведено в другие образовательные организации
    на программы того же уровня / 8.0"	0	0	0	0	0	0	0	0	0	0	0	0	0	1	1	1	0	0	7	8
Пермский край	Государственные, муниципальные (без учета организаций в ведении ФСИН); Заочная	"    переведено из других образовательных организаций 
    с программ того же уровня / 3.0"	0	0	0	0	0	0	0	0	0	0	0	0	0	7	7	1	0	0	9	10
Пермский край	Государственные, муниципальные (без учета организаций в ведении ФСИН); Заочная	    по болезни / 9.0	0	0	0	0	0	0	0	0	0	0	0	0	0	0	0	3	0	0	0	3
Пермский край	Государственные, муниципальные (без учета организаций в ведении ФСИН); Заочная	    прибыло по другим причинам / 5.0	0	0	0	0	0	0	0	0	0	0	0	0	0	28	28	52	0	49	69	170
Пермский край	Государственные, муниципальные (без учета организаций в ведении ФСИН); Заочная	Выбыло студентов - всего (сумма стр. 07-11, 13-15) / 6.0	0	0	0	0	0	0	0	0	0	0	1	0	0	88	89	206	0	90	352	648
Пермский край	Государственные, муниципальные (без учета организаций в ведении ФСИН); Заочная	Прибыло студентов - всего (сумма стр. 02-05) / 1.0	0	0	0	0	0	0	0	0	0	0	0	0	0	104	104	82	0	65	158	305
Пермский край	Государственные, муниципальные (без учета организаций в ведении ФСИН); Заочная	"Численность студентов на начало прошлого учебного года
(на 1 октября) / 17.0"	0	0	0	0	0	0	0	0	0	0	46	0	0	337	383	1857	0	365	1861	4083
Пермский край	Государственные, муниципальные (без учета организаций в ведении ФСИН); Очная	            из стр. 11 - не прошли итоговую аттестацию / 12.0	19	7	0	0	26	2	0	0	0	2	51	0	1	18	70	4	0	0	2	6
Пермский край	Государственные, муниципальные (без учета организаций в ведении ФСИН); Очная	"            из стр. 11 – лица с ограниченными возможностями здоровья,
            инвалиды, дети-инвалиды / 13.0"	0	0	0	0	0	0	0	0	0	0	2	0	0	0	2	1	0	0	0	1
Пермский край	Государственные, муниципальные (без учета организаций в ведении ФСИН); Очная	         отчислено в виде меры дисциплинарного взыскания / 14.0	14	0	0	0	14	0	0	0	0	0	10	0	4	12	26	0	0	0	1	1
Пермский край	Государственные, муниципальные (без учета организаций в ведении ФСИН); Очная	         отчислено из-за просрочки оплаты обучения / 15.0	0	0	0	7	7	0	0	0	0	0	0	0	0	42	42	0	0	0	8	8
Пермский край	Государственные, муниципальные (без учета организаций в ведении ФСИН); Очная	"    в том числе:
    переведено на другие формы обучения данной
    организации на программы того же уровня / 7.0"	60	0	0	1	61	0	0	0	0	0	166	0	17	79	262	7	0	0	8	15
Пермский край	Государственные, муниципальные (без учета организаций в ведении ФСИН); Очная	"    в том числе:
    переведено с других форм обучения данной
    образовательной организации с программ того же уровня / 2.0"	127	0	0	24	151	0	0	0	0	0	105	0	12	26	143	23	0	4	6	33
Пермский край	Государственные, муниципальные (без учета организаций в ведении ФСИН); Очная	    восстановлены из числа ранее отчисленных / 4.0	118	0	0	15	133	0	0	0	0	0	150	0	5	135	290	35	0	0	23	58
Пермский край	Государственные, муниципальные (без учета организаций в ведении ФСИН); Очная	    выбыло по другим причинам / 16.0	206	0	0	97	303	1	0	0	0	1	663	0	178	438	1279	107	0	11	73	191
Пермский край	Государственные, муниципальные (без учета организаций в ведении ФСИН); Очная	"    добровольно прекратили образовательные отношения
    (бросили учебу) / 10.0"	705	7	16	59	787	6	0	0	0	6	1023	0	114	624	1761	219	0	39	110	368
Пермский край	Государственные, муниципальные (без учета организаций в ведении ФСИН); Очная	"    отчислено:
         по неуспеваемости / 11.0"	361	29	11	13	414	2	0	0	0	2	505	0	16	155	676	108	2	2	36	148
Пермский край	Государственные, муниципальные (без учета организаций в ведении ФСИН); Очная	"    переведено в другие образовательные организации
    на программы того же уровня / 8.0"	112	13	0	5	130	0	0	0	0	0	333	0	45	165	543	15	0	1	11	27
Пермский край	Государственные, муниципальные (без учета организаций в ведении ФСИН); Очная	"    переведено из других образовательных организаций 
    с программ того же уровня / 3.0"	123	0	1	27	151	0	0	0	0	0	242	0	12	122	376	11	0	1	6	18
Пермский край	Государственные, муниципальные (без учета организаций в ведении ФСИН); Очная	    по болезни / 9.0	34	0	0	0	34	0	0	0	0	0	26	0	3	6	35	0	0	0	0	0
Пермский край	Государственные, муниципальные (без учета организаций в ведении ФСИН); Очная	    прибыло по другим причинам / 5.0	128	0	3	41	172	0	0	0	1	1	473	0	208	365	1046	48	0	1	62	111
Пермский край	Государственные, муниципальные (без учета организаций в ведении ФСИН); Очная	Выбыло студентов - всего (сумма стр. 07-11, 13-15) / 6.0	1492	49	27	182	1750	9	0	0	0	9	2726	0	377	1521	4624	456	2	53	247	758
Пермский край	Государственные, муниципальные (без учета организаций в ведении ФСИН); Очная	Прибыло студентов - всего (сумма стр. 02-05) / 1.0	496	0	4	107	607	0	0	0	1	1	970	0	237	648	1855	117	0	6	97	220
Пермский край	Государственные, муниципальные (без учета организаций в ведении ФСИН); Очная	"Численность студентов на начало прошлого учебного года
(на 1 октября) / 17.0"	12024	0	205	901	13130	44	0	0	1	45	32099	0	3202	9585	44886	4083	0	564	1262	5909
Пермский край	Очно-заочная; Государственные, муниципальные (без учета организаций в ведении ФСИН)	            из стр. 11 - не прошли итоговую аттестацию / 12.0	0	0	0	0	0	0	0	0	0	0	0	0	0	0	0	1	0	0	0	1
Пермский край	Очно-заочная; Государственные, муниципальные (без учета организаций в ведении ФСИН)	"            из стр. 11 – лица с ограниченными возможностями здоровья,
            инвалиды, дети-инвалиды / 13.0"	0	0	0	0	0	0	0	0	0	0	0	0	0	0	0	0	0	0	1	1
Пермский край	Очно-заочная; Государственные, муниципальные (без учета организаций в ведении ФСИН)	         отчислено в виде меры дисциплинарного взыскания / 14.0	0	0	0	0	0	0	0	0	0	0	0	0	0	0	0	0	0	0	0	0
Пермский край	Очно-заочная; Государственные, муниципальные (без учета организаций в ведении ФСИН)	         отчислено из-за просрочки оплаты обучения / 15.0	0	0	0	0	0	0	0	0	0	0	0	0	0	0	0	0	0	0	1	1
Пермский край	Очно-заочная; Государственные, муниципальные (без учета организаций в ведении ФСИН)	"    в том числе:
    переведено на другие формы обучения данной
    организации на программы того же уровня / 7.0"	0	0	0	0	0	0	0	0	0	0	0	0	0	0	0	0	0	0	0	0
Пермский край	Очно-заочная; Государственные, муниципальные (без учета организаций в ведении ФСИН)	"    в том числе:
    переведено с других форм обучения данной
    образовательной организации с программ того же уровня / 2.0"	0	0	0	0	0	0	0	0	0	0	0	0	0	0	0	0	0	0	3	3
Пермский край	Очно-заочная; Государственные, муниципальные (без учета организаций в ведении ФСИН)	    восстановлены из числа ранее отчисленных / 4.0	0	0	0	0	0	0	0	0	0	0	0	0	0	0	0	1	0	0	2	3
Пермский край	Очно-заочная; Государственные, муниципальные (без учета организаций в ведении ФСИН)	    выбыло по другим причинам / 16.0	0	0	0	0	0	0	0	0	0	0	0	0	0	0	0	7	0	0	0	7
Пермский край	Очно-заочная; Государственные, муниципальные (без учета организаций в ведении ФСИН)	"    добровольно прекратили образовательные отношения
    (бросили учебу) / 10.0"	0	0	0	0	0	0	0	0	0	0	0	0	0	0	0	6	0	0	11	17
Пермский край	Очно-заочная; Государственные, муниципальные (без учета организаций в ведении ФСИН)	"    отчислено:
         по неуспеваемости / 11.0"	0	0	0	0	0	0	0	0	0	0	0	0	0	0	0	18	0	0	3	21
Пермский край	Очно-заочная; Государственные, муниципальные (без учета организаций в ведении ФСИН)	"    переведено в другие образовательные организации
    на программы того же уровня / 8.0"	0	0	0	0	0	0	0	0	0	0	0	0	0	0	0	0	0	0	0	0
Пермский край	Очно-заочная; Государственные, муниципальные (без учета организаций в ведении ФСИН)	"    переведено из других образовательных организаций 
    с программ того же уровня / 3.0"	0	0	0	0	0	0	0	0	0	0	0	0	0	0	0	0	0	0	1	1
Пермский край	Очно-заочная; Государственные, муниципальные (без учета организаций в ведении ФСИН)	    по болезни / 9.0	0	0	0	0	0	0	0	0	0	0	0	0	0	0	0	0	0	0	0	0
Пермский край	Очно-заочная; Государственные, муниципальные (без учета организаций в ведении ФСИН)	    прибыло по другим причинам / 5.0	0	0	0	0	0	0	0	0	0	0	0	0	0	0	0	2	0	0	2	4
Пермский край	Очно-заочная; Государственные, муниципальные (без учета организаций в ведении ФСИН)	Выбыло студентов - всего (сумма стр. 07-11, 13-15) / 6.0	0	0	0	0	0	0	0	0	0	0	0	0	0	0	0	31	0	0	15	46
Пермский край	Очно-заочная; Государственные, муниципальные (без учета организаций в ведении ФСИН)	Прибыло студентов - всего (сумма стр. 02-05) / 1.0	0	0	0	0	0	0	0	0	0	0	0	0	0	0	0	3	0	0	8	11
Пермский край	Очно-заочная; Государственные, муниципальные (без учета организаций в ведении ФСИН)	"Численность студентов на начало прошлого учебного года
(на 1 октября) / 17.0"	0	0	0	0	0	0	0	0	0	0	0	0	0	0	0	143	0	0	225	368
Пермский край	Частные; Заочная	            из стр. 11 - не прошли итоговую аттестацию / 12.0	0	0	0	0	0	0	0	0	0	0	0	0	0	20	20	0	0	0	15	15
Пермский край	Частные; Заочная	"            из стр. 11 – лица с ограниченными возможностями здоровья,
            инвалиды, дети-инвалиды / 13.0"	0	0	0	0	0	0	0	0	0	0	0	0	0	0	0	0	0	0	0	0
Пермский край	Частные; Заочная	         отчислено в виде меры дисциплинарного взыскания / 14.0	0	0	0	0	0	0	0	0	0	0	0	0	0	0	0	0	0	0	0	0
Пермский край	Частные; Заочная	         отчислено из-за просрочки оплаты обучения / 15.0	0	0	0	0	0	0	0	0	0	0	0	0	0	878	878	0	0	0	535	535
Пермский край	Частные; Заочная	"    в том числе:
    переведено на другие формы обучения данной
    организации на программы того же уровня / 7.0"	0	0	0	0	0	0	0	0	0	0	0	0	0	3	3	0	0	0	8	8
Пермский край	Частные; Заочная	"    в том числе:
    переведено с других форм обучения данной
    образовательной организации с программ того же уровня / 2.0"	0	0	0	0	0	0	0	0	0	0	0	0	0	58	58	0	0	0	17	17
Пермский край	Частные; Заочная	    восстановлены из числа ранее отчисленных / 4.0	0	0	0	0	0	0	0	0	0	0	0	0	0	223	223	0	0	0	162	162
Пермский край	Частные; Заочная	    выбыло по другим причинам / 16.0	0	0	0	0	0	0	0	0	0	0	0	0	0	280	280	0	0	0	473	473
Пермский край	Частные; Заочная	"    добровольно прекратили образовательные отношения
    (бросили учебу) / 10.0"	0	0	0	0	0	0	0	0	0	0	0	0	0	326	326	0	0	0	443	443
Пермский край	Частные; Заочная	"    отчислено:
         по неуспеваемости / 11.0"	0	0	0	0	0	0	0	0	0	0	0	0	0	481	481	0	0	0	566	566
Пермский край	Частные; Заочная	"    переведено в другие образовательные организации
    на программы того же уровня / 8.0"	0	0	0	0	0	0	0	0	0	0	0	0	0	36	36	0	0	0	8	8
Пермский край	Частные; Заочная	"    переведено из других образовательных организаций 
    с программ того же уровня / 3.0"	0	0	0	0	0	0	0	0	0	0	0	0	0	298	298	0	0	0	53	53
Пермский край	Частные; Заочная	    по болезни / 9.0	0	0	0	0	0	0	0	0	0	0	0	0	0	4	4	0	0	0	2	2
Пермский край	Частные; Заочная	    прибыло по другим причинам / 5.0	0	0	0	0	0	0	0	0	0	0	0	0	0	38	38	0	0	0	76	76
Пермский край	Частные; Заочная	Выбыло студентов - всего (сумма стр. 07-11, 13-15) / 6.0	0	0	0	0	0	0	0	0	0	0	0	0	0	2008	2008	0	0	0	2035	2035
Пермский край	Частные; Заочная	Прибыло студентов - всего (сумма стр. 02-05) / 1.0	0	0	0	0	0	0	0	0	0	0	0	0	0	617	617	0	0	0	308	308
Пермский край	Частные; Заочная	"Численность студентов на начало прошлого учебного года
(на 1 октября) / 17.0"	0	0	0	0	0	0	0	0	0	0	0	0	0	10345	10345	0	0	0	8630	8630
Пермский край	Частные; Очная	            из стр. 11 - не прошли итоговую аттестацию / 12.0	0	0	0	0	0	0	0	0	0	0	0	1	0	8	9	0	0	0	2	2
Пермский край	Частные; Очная	"            из стр. 11 – лица с ограниченными возможностями здоровья,
            инвалиды, дети-инвалиды / 13.0"	0	0	0	0	0	0	0	0	0	0	0	0	0	0	0	0	0	0	0	0
Пермский край	Частные; Очная	         отчислено в виде меры дисциплинарного взыскания / 14.0	0	0	0	0	0	0	0	0	0	0	0	0	0	0	0	0	0	0	0	0
Пермский край	Частные; Очная	         отчислено из-за просрочки оплаты обучения / 15.0	0	0	0	0	0	0	0	0	0	0	0	0	0	22	22	0	0	0	7	7
Пермский край	Частные; Очная	"    в том числе:
    переведено на другие формы обучения данной
    организации на программы того же уровня / 7.0"	0	0	0	0	0	0	0	0	0	0	0	0	0	59	59	0	0	0	26	26
Пермский край	Частные; Очная	"    в том числе:
    переведено с других форм обучения данной
    образовательной организации с программ того же уровня / 2.0"	0	0	0	0	0	0	0	0	0	0	0	0	0	3	3	0	0	0	8	8
Пермский край	Частные; Очная	    восстановлены из числа ранее отчисленных / 4.0	0	0	0	0	0	0	0	0	0	0	0	0	0	27	27	0	0	0	6	6
Пермский край	Частные; Очная	    выбыло по другим причинам / 16.0	0	0	0	0	0	0	0	0	0	0	0	0	0	45	45	0	0	0	16	16
Пермский край	Частные; Очная	"    добровольно прекратили образовательные отношения
    (бросили учебу) / 10.0"	0	0	0	0	0	0	0	0	0	0	0	9	0	129	138	0	0	0	50	50
Пермский край	Частные; Очная	"    отчислено:
         по неуспеваемости / 11.0"	0	0	0	0	0	0	0	0	0	0	0	1	0	84	85	0	0	0	23	23
Пермский край	Частные; Очная	"    переведено в другие образовательные организации
    на программы того же уровня / 8.0"	0	0	0	0	0	0	0	0	0	0	0	0	0	19	19	0	0	0	1	1
Пермский край	Частные; Очная	"    переведено из других образовательных организаций 
    с программ того же уровня / 3.0"	0	0	0	0	0	0	0	0	0	0	0	0	0	40	40	0	0	0	8	8
Пермский край	Частные; Очная	    по болезни / 9.0	0	0	0	0	0	0	0	0	0	0	0	0	0	3	3	0	0	0	2	2
Пермский край	Частные; Очная	    прибыло по другим причинам / 5.0	0	0	0	0	0	0	0	0	0	0	0	0	0	48	48	0	0	0	16	16
Пермский край	Частные; Очная	Выбыло студентов - всего (сумма стр. 07-11, 13-15) / 6.0	0	0	0	0	0	0	0	0	0	0	0	10	0	361	371	0	0	0	125	125
Пермский край	Частные; Очная	Прибыло студентов - всего (сумма стр. 02-05) / 1.0	0	0	0	0	0	0	0	0	0	0	0	0	0	118	118	0	0	0	38	38
Пермский край	Частные; Очная	"Численность студентов на начало прошлого учебного года
(на 1 октября) / 17.0"	0	50	0	28	78	0	0	0	0	0	0	59	0	1853	1912	0	0	0	404	404
Пермский край	Частные; Очно-заочная	            из стр. 11 - не прошли итоговую аттестацию / 12.0	0	0	0	0	0	0	0	0	0	0	0	0	0	0	0	0	0	0	0	0
Пермский край	Частные; Очно-заочная	"            из стр. 11 – лица с ограниченными возможностями здоровья,
            инвалиды, дети-инвалиды / 13.0"	0	0	0	0	0	0	0	0	0	0	0	0	0	0	0	0	0	0	0	0
Пермский край	Частные; Очно-заочная	         отчислено в виде меры дисциплинарного взыскания / 14.0	0	0	0	0	0	0	0	0	0	0	0	0	0	0	0	0	0	0	0	0
Пермский край	Частные; Очно-заочная	         отчислено из-за просрочки оплаты обучения / 15.0	0	0	0	0	0	0	0	0	0	0	0	0	0	0	0	0	0	0	0	0
Пермский край	Частные; Очно-заочная	"    в том числе:
    переведено на другие формы обучения данной
    организации на программы того же уровня / 7.0"	0	0	0	0	0	0	0	0	0	0	0	0	0	0	0	0	0	0	0	0
Пермский край	Частные; Очно-заочная	"    в том числе:
    переведено с других форм обучения данной
    образовательной организации с программ того же уровня / 2.0"	0	0	0	0	0	0	0	0	0	0	0	0	0	0	0	0	0	0	0	0
Пермский край	Частные; Очно-заочная	    восстановлены из числа ранее отчисленных / 4.0	0	0	0	0	0	0	0	0	0	0	0	0	0	0	0	0	0	0	0	0
Пермский край	Частные; Очно-заочная	    выбыло по другим причинам / 16.0	0	0	0	0	0	0	0	0	0	0	0	0	0	0	0	0	0	0	0	0
Пермский край	Частные; Очно-заочная	"    добровольно прекратили образовательные отношения
    (бросили учебу) / 10.0"	0	0	0	0	0	0	0	0	0	0	0	0	0	6	6	0	0	0	0	0
Пермский край	Частные; Очно-заочная	"    отчислено:
         по неуспеваемости / 11.0"	0	0	0	0	0	0	0	0	0	0	0	0	0	0	0	0	0	0	0	0
Пермский край	Частные; Очно-заочная	"    переведено в другие образовательные организации
    на программы того же уровня / 8.0"	0	0	0	0	0	0	0	0	0	0	0	0	0	0	0	0	0	0	0	0
Пермский край	Частные; Очно-заочная	"    переведено из других образовательных организаций 
    с программ того же уровня / 3.0"	0	0	0	0	0	0	0	0	0	0	0	0	0	0	0	0	0	0	0	0
Пермский край	Частные; Очно-заочная	    по болезни / 9.0	0	0	0	0	0	0	0	0	0	0	0	0	0	0	0	0	0	0	0	0
Пермский край	Частные; Очно-заочная	    прибыло по другим причинам / 5.0	0	0	0	0	0	0	0	0	0	0	0	0	0	0	0	0	0	0	0	0
Пермский край	Частные; Очно-заочная	Выбыло студентов - всего (сумма стр. 07-11, 13-15) / 6.0	0	0	0	0	0	0	0	0	0	0	0	0	0	6	6	0	0	0	0	0
Пермский край	Частные; Очно-заочная	Прибыло студентов - всего (сумма стр. 02-05) / 1.0	0	0	0	0	0	0	0	0	0	0	0	0	0	0	0	0	0	0	0	0
Пермский край	Частные; Очно-заочная	"Численность студентов на начало прошлого учебного года
(на 1 октября) / 17.0"	0	0	0	0	0	0	0	0	0	0	0	0	0	5	5	0	0	0	8	8
Приморский край	Государственные, муниципальные (без учета организаций в ведении ФСИН); Заочная	            из стр. 11 - не прошли итоговую аттестацию / 12.0	0	0	0	0	0	0	0	0	0	0	0	0	0	0	0	0	0	0	7	7
Приморский край	Государственные, муниципальные (без учета организаций в ведении ФСИН); Заочная	"            из стр. 11 – лица с ограниченными возможностями здоровья,
            инвалиды, дети-инвалиды / 13.0"	0	0	0	0	0	0	0	0	0	0	0	0	0	0	0	0	0	0	0	0
Приморский край	Государственные, муниципальные (без учета организаций в ведении ФСИН); Заочная	         отчислено в виде меры дисциплинарного взыскания / 14.0	0	0	0	0	0	0	0	0	0	0	0	0	0	0	0	0	0	0	0	0
Приморский край	Государственные, муниципальные (без учета организаций в ведении ФСИН); Заочная	         отчислено из-за просрочки оплаты обучения / 15.0	0	0	0	0	0	0	0	0	0	0	0	0	0	4	4	0	0	0	19	19
Приморский край	Государственные, муниципальные (без учета организаций в ведении ФСИН); Заочная	"    в том числе:
    переведено на другие формы обучения данной
    организации на программы того же уровня / 7.0"	0	0	0	0	0	0	0	0	0	0	0	0	0	2	2	3	0	0	5	8
Приморский край	Государственные, муниципальные (без учета организаций в ведении ФСИН); Заочная	"    в том числе:
    переведено с других форм обучения данной
    образовательной организации с программ того же уровня / 2.0"	0	0	0	0	0	0	0	0	0	0	10	0	3	134	147	16	0	1	99	116
Приморский край	Государственные, муниципальные (без учета организаций в ведении ФСИН); Заочная	    восстановлены из числа ранее отчисленных / 4.0	0	0	0	0	0	0	0	0	0	0	0	0	0	38	38	8	0	0	93	101
Приморский край	Государственные, муниципальные (без учета организаций в ведении ФСИН); Заочная	    выбыло по другим причинам / 16.0	0	0	0	0	0	0	0	0	0	0	3	0	0	23	26	76	0	6	73	155
Приморский край	Государственные, муниципальные (без учета организаций в ведении ФСИН); Заочная	"    добровольно прекратили образовательные отношения
    (бросили учебу) / 10.0"	0	0	0	0	0	0	0	0	0	0	13	0	0	151	164	113	0	12	361	486
Приморский край	Государственные, муниципальные (без учета организаций в ведении ФСИН); Заочная	"    отчислено:
         по неуспеваемости / 11.0"	0	0	0	0	0	0	0	0	0	0	12	0	1	57	70	75	0	17	140	232
Приморский край	Государственные, муниципальные (без учета организаций в ведении ФСИН); Заочная	"    переведено в другие образовательные организации
    на программы того же уровня / 8.0"	0	0	0	0	0	0	0	0	0	0	0	0	0	5	5	5	0	0	10	15
Приморский край	Государственные, муниципальные (без учета организаций в ведении ФСИН); Заочная	"    переведено из других образовательных организаций 
    с программ того же уровня / 3.0"	0	0	0	0	0	0	0	0	0	0	0	0	0	23	23	18	0	0	28	46
Приморский край	Государственные, муниципальные (без учета организаций в ведении ФСИН); Заочная	    по болезни / 9.0	0	0	0	0	0	0	0	0	0	0	0	0	0	1	1	8	0	0	10	18
Приморский край	Государственные, муниципальные (без учета организаций в ведении ФСИН); Заочная	    прибыло по другим причинам / 5.0	0	0	0	0	0	0	0	0	0	0	0	0	0	21	21	60	0	3	72	135
Приморский край	Государственные, муниципальные (без учета организаций в ведении ФСИН); Заочная	Выбыло студентов - всего (сумма стр. 07-11, 13-15) / 6.0	0	0	0	0	0	0	0	0	0	0	28	0	1	243	272	280	0	35	618	933
Приморский край	Государственные, муниципальные (без учета организаций в ведении ФСИН); Заочная	Прибыло студентов - всего (сумма стр. 02-05) / 1.0	0	0	0	0	0	0	0	0	0	0	10	0	3	216	229	102	0	4	292	398
Приморский край	Государственные, муниципальные (без учета организаций в ведении ФСИН); Заочная	"Численность студентов на начало прошлого учебного года
(на 1 октября) / 17.0"	0	0	0	0	0	0	0	0	0	0	243	0	42	1081	1366	1734	0	310	3417	5461
Приморский край	Государственные, муниципальные (без учета организаций в ведении ФСИН); Очная	            из стр. 11 - не прошли итоговую аттестацию / 12.0	2	5	0	0	7	0	0	0	8	8	12	0	4	2	18	1	0	1	0	2
Приморский край	Государственные, муниципальные (без учета организаций в ведении ФСИН); Очная	"            из стр. 11 – лица с ограниченными возможностями здоровья,
            инвалиды, дети-инвалиды / 13.0"	2	0	0	0	2	0	0	0	0	0	2	0	0	3	5	1	0	0	0	1
Приморский край	Государственные, муниципальные (без учета организаций в ведении ФСИН); Очная	         отчислено в виде меры дисциплинарного взыскания / 14.0	13	0	0	3	16	0	0	0	0	0	14	0	9	14	37	0	0	1	4	5
Приморский край	Государственные, муниципальные (без учета организаций в ведении ФСИН); Очная	         отчислено из-за просрочки оплаты обучения / 15.0	0	0	0	0	0	0	0	0	0	0	0	0	0	20	20	0	0	0	6	6
Приморский край	Государственные, муниципальные (без учета организаций в ведении ФСИН); Очная	"    в том числе:
    переведено на другие формы обучения данной
    организации на программы того же уровня / 7.0"	16	2	0	0	18	2	0	0	0	2	97	6	17	200	320	12	0	3	39	54
Приморский край	Государственные, муниципальные (без учета организаций в ведении ФСИН); Очная	"    в том числе:
    переведено с других форм обучения данной
    образовательной организации с программ того же уровня / 2.0"	13	6	0	1	20	0	0	0	6	6	27	4	20	57	108	6	0	2	14	22
Приморский край	Государственные, муниципальные (без учета организаций в ведении ФСИН); Очная	    восстановлены из числа ранее отчисленных / 4.0	32	1	0	3	36	2	0	0	0	2	44	0	6	62	112	6	0	0	17	23
Приморский край	Государственные, муниципальные (без учета организаций в ведении ФСИН); Очная	    выбыло по другим причинам / 16.0	81	1	0	2	84	2	0	0	0	2	192	4	61	130	387	25	0	4	24	53
Приморский край	Государственные, муниципальные (без учета организаций в ведении ФСИН); Очная	"    добровольно прекратили образовательные отношения
    (бросили учебу) / 10.0"	229	0	0	49	278	16	0	0	29	45	503	14	218	601	1336	118	0	40	204	362
Приморский край	Государственные, муниципальные (без учета организаций в ведении ФСИН); Очная	"    отчислено:
         по неуспеваемости / 11.0"	225	6	0	28	259	6	0	0	15	21	411	2	67	198	678	67	0	27	44	138
Приморский край	Государственные, муниципальные (без учета организаций в ведении ФСИН); Очная	"    переведено в другие образовательные организации
    на программы того же уровня / 8.0"	61	0	0	4	65	1	0	0	1	2	137	3	50	108	298	18	0	6	43	67
Приморский край	Государственные, муниципальные (без учета организаций в ведении ФСИН); Очная	"    переведено из других образовательных организаций 
    с программ того же уровня / 3.0"	50	1	0	4	55	0	0	0	0	0	100	2	17	54	173	18	0	2	27	47
Приморский край	Государственные, муниципальные (без учета организаций в ведении ФСИН); Очная	    по болезни / 9.0	15	0	0	3	18	0	0	0	0	0	9	0	0	8	17	3	0	0	5	8
Приморский край	Государственные, муниципальные (без учета организаций в ведении ФСИН); Очная	    прибыло по другим причинам / 5.0	23	0	0	8	31	10	0	0	0	10	112	0	22	111	245	12	0	2	16	30
Приморский край	Государственные, муниципальные (без учета организаций в ведении ФСИН); Очная	Выбыло студентов - всего (сумма стр. 07-11, 13-15) / 6.0	640	9	0	89	738	27	0	0	45	72	1363	29	422	1279	3093	243	0	81	369	693
Приморский край	Государственные, муниципальные (без учета организаций в ведении ФСИН); Очная	Прибыло студентов - всего (сумма стр. 02-05) / 1.0	118	8	0	16	142	12	0	0	6	18	283	6	65	284	638	42	0	6	74	122
Приморский край	Государственные, муниципальные (без учета организаций в ведении ФСИН); Очная	"Численность студентов на начало прошлого учебного года
(на 1 октября) / 17.0"	5959	201	0	280	6440	349	0	0	274	623	13758	317	4645	6866	25586	2108	0	944	2897	5949
Приморский край	Очно-заочная; Государственные, муниципальные (без учета организаций в ведении ФСИН)	            из стр. 11 - не прошли итоговую аттестацию / 12.0	0	0	0	0	0	0	0	0	0	0	0	0	0	0	0	0	0	0	0	0
Приморский край	Очно-заочная; Государственные, муниципальные (без учета организаций в ведении ФСИН)	"            из стр. 11 – лица с ограниченными возможностями здоровья,
            инвалиды, дети-инвалиды / 13.0"	0	0	0	0	0	0	0	0	0	0	0	0	0	0	0	0	0	0	0	0
Приморский край	Очно-заочная; Государственные, муниципальные (без учета организаций в ведении ФСИН)	         отчислено в виде меры дисциплинарного взыскания / 14.0	0	0	0	0	0	0	0	0	0	0	0	0	0	0	0	0	0	0	0	0
Приморский край	Очно-заочная; Государственные, муниципальные (без учета организаций в ведении ФСИН)	         отчислено из-за просрочки оплаты обучения / 15.0	0	0	0	0	0	0	0	0	0	0	0	0	0	0	0	0	0	0	1	1
Приморский край	Очно-заочная; Государственные, муниципальные (без учета организаций в ведении ФСИН)	"    в том числе:
    переведено на другие формы обучения данной
    организации на программы того же уровня / 7.0"	0	0	0	0	0	0	0	0	0	0	0	0	0	0	0	1	0	0	3	4
Приморский край	Очно-заочная; Государственные, муниципальные (без учета организаций в ведении ФСИН)	"    в том числе:
    переведено с других форм обучения данной
    образовательной организации с программ того же уровня / 2.0"	0	0	0	0	0	0	0	0	0	0	1	0	0	0	1	6	0	0	0	6
Приморский край	Очно-заочная; Государственные, муниципальные (без учета организаций в ведении ФСИН)	    восстановлены из числа ранее отчисленных / 4.0	0	0	0	0	0	0	0	0	0	0	0	0	0	0	0	5	0	0	4	9
Приморский край	Очно-заочная; Государственные, муниципальные (без учета организаций в ведении ФСИН)	    выбыло по другим причинам / 16.0	0	0	0	0	0	0	0	0	0	0	4	0	0	24	28	0	0	0	4	4
Приморский край	Очно-заочная; Государственные, муниципальные (без учета организаций в ведении ФСИН)	"    добровольно прекратили образовательные отношения
    (бросили учебу) / 10.0"	0	0	0	0	0	0	0	0	0	0	0	0	0	0	0	31	0	0	27	58
Приморский край	Очно-заочная; Государственные, муниципальные (без учета организаций в ведении ФСИН)	"    отчислено:
         по неуспеваемости / 11.0"	0	0	0	0	0	0	0	0	0	0	0	0	0	0	0	11	0	0	11	22
Приморский край	Очно-заочная; Государственные, муниципальные (без учета организаций в ведении ФСИН)	"    переведено в другие образовательные организации
    на программы того же уровня / 8.0"	0	0	0	0	0	0	0	0	0	0	0	0	0	0	0	6	0	0	12	18
Приморский край	Очно-заочная; Государственные, муниципальные (без учета организаций в ведении ФСИН)	"    переведено из других образовательных организаций 
    с программ того же уровня / 3.0"	0	0	0	0	0	0	0	0	0	0	0	0	0	0	0	4	0	0	1	5
Приморский край	Очно-заочная; Государственные, муниципальные (без учета организаций в ведении ФСИН)	    по болезни / 9.0	0	0	0	0	0	0	0	0	0	0	0	0	0	0	0	0	0	0	3	3
Приморский край	Очно-заочная; Государственные, муниципальные (без учета организаций в ведении ФСИН)	    прибыло по другим причинам / 5.0	0	0	0	0	0	0	0	0	0	0	1	0	0	0	1	3	0	0	6	9
Приморский край	Очно-заочная; Государственные, муниципальные (без учета организаций в ведении ФСИН)	Выбыло студентов - всего (сумма стр. 07-11, 13-15) / 6.0	0	0	0	0	0	0	0	0	0	0	4	0	0	24	28	49	0	0	61	110
Приморский край	Очно-заочная; Государственные, муниципальные (без учета организаций в ведении ФСИН)	Прибыло студентов - всего (сумма стр. 02-05) / 1.0	0	0	0	0	0	0	0	0	0	0	2	0	0	0	2	18	0	0	11	29
Приморский край	Очно-заочная; Государственные, муниципальные (без учета организаций в ведении ФСИН)	"Численность студентов на начало прошлого учебного года
(на 1 октября) / 17.0"	0	0	0	0	0	0	0	0	0	0	39	0	25	61	125	604	0	0	405	1009
Приморский край	Частные; Заочная	            из стр. 11 - не прошли итоговую аттестацию / 12.0	0	0	0	0	0	0	0	0	0	0	0	0	0	0	0	0	0	0	0	0
Приморский край	Частные; Заочная	"            из стр. 11 – лица с ограниченными возможностями здоровья,
            инвалиды, дети-инвалиды / 13.0"	0	0	0	0	0	0	0	0	0	0	0	0	0	0	0	0	0	0	0	0
Приморский край	Частные; Заочная	         отчислено в виде меры дисциплинарного взыскания / 14.0	0	0	0	0	0	0	0	0	0	0	0	0	0	0	0	0	0	0	0	0
Приморский край	Частные; Заочная	         отчислено из-за просрочки оплаты обучения / 15.0	0	0	0	0	0	0	0	0	0	0	0	0	0	7	7	0	0	0	4	4
Приморский край	Частные; Заочная	"    в том числе:
    переведено на другие формы обучения данной
    организации на программы того же уровня / 7.0"	0	0	0	0	0	0	0	0	0	0	0	0	0	0	0	0	0	0	0	0
Приморский край	Частные; Заочная	"    в том числе:
    переведено с других форм обучения данной
    образовательной организации с программ того же уровня / 2.0"	0	0	0	0	0	0	0	0	0	0	0	0	0	43	43	0	0	0	16	16
Приморский край	Частные; Заочная	    восстановлены из числа ранее отчисленных / 4.0	0	0	0	0	0	0	0	0	0	0	0	0	0	6	6	0	0	0	3	3
Приморский край	Частные; Заочная	    выбыло по другим причинам / 16.0	0	0	0	0	0	0	0	0	0	0	0	0	0	2	2	0	0	0	0	0
Приморский край	Частные; Заочная	"    добровольно прекратили образовательные отношения
    (бросили учебу) / 10.0"	0	0	0	0	0	0	0	0	0	0	0	0	0	24	24	0	0	0	86	86
Приморский край	Частные; Заочная	"    отчислено:
         по неуспеваемости / 11.0"	0	0	0	0	0	0	0	0	0	0	0	0	0	6	6	0	0	0	2	2
Приморский край	Частные; Заочная	"    переведено в другие образовательные организации
    на программы того же уровня / 8.0"	0	0	0	0	0	0	0	0	0	0	0	0	0	0	0	0	0	0	0	0
Приморский край	Частные; Заочная	"    переведено из других образовательных организаций 
    с программ того же уровня / 3.0"	0	0	0	0	0	0	0	0	0	0	0	0	0	27	27	0	0	0	52	52
Приморский край	Частные; Заочная	    по болезни / 9.0	0	0	0	0	0	0	0	0	0	0	0	0	0	0	0	0	0	0	0	0
Приморский край	Частные; Заочная	    прибыло по другим причинам / 5.0	0	0	0	0	0	0	0	0	0	0	0	0	0	0	0	0	0	0	1	1
Приморский край	Частные; Заочная	Выбыло студентов - всего (сумма стр. 07-11, 13-15) / 6.0	0	0	0	0	0	0	0	0	0	0	0	0	0	39	39	0	0	0	92	92
Приморский край	Частные; Заочная	Прибыло студентов - всего (сумма стр. 02-05) / 1.0	0	0	0	0	0	0	0	0	0	0	0	0	0	76	76	0	0	0	72	72
Приморский край	Частные; Заочная	"Численность студентов на начало прошлого учебного года
(на 1 октября) / 17.0"	0	0	0	0	0	0	0	0	0	0	0	0	0	289	289	0	0	0	739	739
Приморский край	Частные; Очная	            из стр. 11 - не прошли итоговую аттестацию / 12.0	0	0	0	0	0	0	0	0	0	0	0	0	0	1	1	0	0	0	1	1
Приморский край	Частные; Очная	"            из стр. 11 – лица с ограниченными возможностями здоровья,
            инвалиды, дети-инвалиды / 13.0"	0	0	0	0	0	0	0	0	0	0	0	0	0	0	0	0	0	0	0	0
Приморский край	Частные; Очная	         отчислено в виде меры дисциплинарного взыскания / 14.0	0	0	0	0	0	0	0	0	0	0	0	0	0	4	4	0	0	0	2	2
Приморский край	Частные; Очная	         отчислено из-за просрочки оплаты обучения / 15.0	0	0	0	0	0	0	0	0	0	0	0	0	0	3	3	0	0	0	1	1
Приморский край	Частные; Очная	"    в том числе:
    переведено на другие формы обучения данной
    организации на программы того же уровня / 7.0"	0	0	0	0	0	0	0	0	0	0	0	0	0	22	22	0	0	0	13	13
Приморский край	Частные; Очная	"    в том числе:
    переведено с других форм обучения данной
    образовательной организации с программ того же уровня / 2.0"	0	0	0	0	0	0	0	0	0	0	0	0	0	5	5	0	0	0	1	1
Приморский край	Частные; Очная	    восстановлены из числа ранее отчисленных / 4.0	0	0	0	0	0	0	0	0	0	0	0	0	0	11	11	0	0	0	4	4
Приморский край	Частные; Очная	    выбыло по другим причинам / 16.0	0	0	0	0	0	0	0	0	0	0	0	0	0	23	23	0	0	0	15	15
Приморский край	Частные; Очная	"    добровольно прекратили образовательные отношения
    (бросили учебу) / 10.0"	0	0	0	0	0	0	0	0	0	0	0	0	0	60	60	0	0	0	19	19
Приморский край	Частные; Очная	"    отчислено:
         по неуспеваемости / 11.0"	0	0	0	0	0	0	0	0	0	0	0	0	0	6	6	0	0	0	8	8
Приморский край	Частные; Очная	"    переведено в другие образовательные организации
    на программы того же уровня / 8.0"	0	0	0	0	0	0	0	0	0	0	0	0	0	14	14	0	0	0	3	3
Приморский край	Частные; Очная	"    переведено из других образовательных организаций 
    с программ того же уровня / 3.0"	0	0	0	0	0	0	0	0	0	0	0	0	0	16	16	0	0	0	0	0
Приморский край	Частные; Очная	    по болезни / 9.0	0	0	0	0	0	0	0	0	0	0	0	0	0	2	2	0	0	0	7	7
Приморский край	Частные; Очная	    прибыло по другим причинам / 5.0	0	0	0	0	0	0	0	0	0	0	0	0	0	0	0	0	0	0	0	0
Приморский край	Частные; Очная	Выбыло студентов - всего (сумма стр. 07-11, 13-15) / 6.0	0	0	0	0	0	0	0	0	0	0	0	0	0	134	134	0	0	0	68	68
Приморский край	Частные; Очная	Прибыло студентов - всего (сумма стр. 02-05) / 1.0	0	0	0	0	0	0	0	0	0	0	0	0	0	32	32	0	0	0	5	5
Приморский край	Частные; Очная	"Численность студентов на начало прошлого учебного года
(на 1 октября) / 17.0"	0	0	0	0	0	0	0	0	12	12	0	0	0	658	658	0	0	0	389	389
Псковская область	Государственные, муниципальные (без учета организаций в ведении ФСИН); Заочная	            из стр. 11 - не прошли итоговую аттестацию / 12.0	0	0	0	0	0	0	0	0	0	0	0	0	0	0	0	0	0	0	1	1
Псковская область	Государственные, муниципальные (без учета организаций в ведении ФСИН); Заочная	"            из стр. 11 – лица с ограниченными возможностями здоровья,
            инвалиды, дети-инвалиды / 13.0"	0	0	0	0	0	0	0	0	0	0	0	0	0	0	0	0	0	0	0	0
Псковская область	Государственные, муниципальные (без учета организаций в ведении ФСИН); Заочная	         отчислено в виде меры дисциплинарного взыскания / 14.0	0	0	0	0	0	0	0	0	0	0	0	0	0	0	0	0	0	0	0	0
Псковская область	Государственные, муниципальные (без учета организаций в ведении ФСИН); Заочная	         отчислено из-за просрочки оплаты обучения / 15.0	0	0	0	0	0	0	0	0	0	0	0	0	0	5	5	0	0	0	2	2
Псковская область	Государственные, муниципальные (без учета организаций в ведении ФСИН); Заочная	"    в том числе:
    переведено на другие формы обучения данной
    организации на программы того же уровня / 7.0"	0	0	0	0	0	0	0	0	0	0	0	0	0	2	2	0	0	0	0	0
Псковская область	Государственные, муниципальные (без учета организаций в ведении ФСИН); Заочная	"    в том числе:
    переведено с других форм обучения данной
    образовательной организации с программ того же уровня / 2.0"	0	0	0	0	0	0	0	0	0	0	0	0	0	7	7	8	0	0	8	16
Псковская область	Государственные, муниципальные (без учета организаций в ведении ФСИН); Заочная	    восстановлены из числа ранее отчисленных / 4.0	0	0	0	0	0	0	0	0	0	0	0	0	0	12	12	4	0	0	10	14
Псковская область	Государственные, муниципальные (без учета организаций в ведении ФСИН); Заочная	    выбыло по другим причинам / 16.0	0	0	0	0	0	0	0	0	0	0	0	0	0	2	2	24	0	0	7	31
Псковская область	Государственные, муниципальные (без учета организаций в ведении ФСИН); Заочная	"    добровольно прекратили образовательные отношения
    (бросили учебу) / 10.0"	0	0	0	0	0	0	0	0	0	0	0	0	2	12	14	15	0	15	30	60
Псковская область	Государственные, муниципальные (без учета организаций в ведении ФСИН); Заочная	"    отчислено:
         по неуспеваемости / 11.0"	0	0	0	0	0	0	0	0	0	0	0	0	4	13	17	36	0	0	32	68
Псковская область	Государственные, муниципальные (без учета организаций в ведении ФСИН); Заочная	"    переведено в другие образовательные организации
    на программы того же уровня / 8.0"	0	0	0	0	0	0	0	0	0	0	0	0	0	0	0	2	0	0	0	2
Псковская область	Государственные, муниципальные (без учета организаций в ведении ФСИН); Заочная	"    переведено из других образовательных организаций 
    с программ того же уровня / 3.0"	0	0	0	0	0	0	0	0	0	0	0	0	0	1	1	0	0	0	1	1
Псковская область	Государственные, муниципальные (без учета организаций в ведении ФСИН); Заочная	    по болезни / 9.0	0	0	0	0	0	0	0	0	0	0	0	0	0	0	0	0	0	0	0	0
Псковская область	Государственные, муниципальные (без учета организаций в ведении ФСИН); Заочная	    прибыло по другим причинам / 5.0	0	0	0	0	0	0	0	0	0	0	0	0	0	0	0	15	0	0	7	22
Псковская область	Государственные, муниципальные (без учета организаций в ведении ФСИН); Заочная	Выбыло студентов - всего (сумма стр. 07-11, 13-15) / 6.0	0	0	0	0	0	0	0	0	0	0	0	0	6	34	40	77	0	15	71	163
Псковская область	Государственные, муниципальные (без учета организаций в ведении ФСИН); Заочная	Прибыло студентов - всего (сумма стр. 02-05) / 1.0	0	0	0	0	0	0	0	0	0	0	0	0	0	20	20	27	0	0	26	53
Псковская область	Государственные, муниципальные (без учета организаций в ведении ФСИН); Заочная	"Численность студентов на начало прошлого учебного года
(на 1 октября) / 17.0"	0	0	0	0	0	0	0	0	0	0	0	0	103	174	277	357	0	231	410	998
Псковская область	Государственные, муниципальные (без учета организаций в ведении ФСИН); Очная	            из стр. 11 - не прошли итоговую аттестацию / 12.0	11	0	0	0	11	0	0	0	0	0	11	0	0	1	12	0	0	0	1	1
Псковская область	Государственные, муниципальные (без учета организаций в ведении ФСИН); Очная	"            из стр. 11 – лица с ограниченными возможностями здоровья,
            инвалиды, дети-инвалиды / 13.0"	0	0	0	0	0	0	0	0	0	0	0	0	0	0	0	0	0	0	0	0
Псковская область	Государственные, муниципальные (без учета организаций в ведении ФСИН); Очная	         отчислено в виде меры дисциплинарного взыскания / 14.0	0	0	0	0	0	0	0	0	0	0	3	0	0	1	4	0	0	0	0	0
Псковская область	Государственные, муниципальные (без учета организаций в ведении ФСИН); Очная	         отчислено из-за просрочки оплаты обучения / 15.0	0	0	0	0	0	0	0	0	0	0	0	0	0	2	2	0	0	0	2	2
Псковская область	Государственные, муниципальные (без учета организаций в ведении ФСИН); Очная	"    в том числе:
    переведено на другие формы обучения данной
    организации на программы того же уровня / 7.0"	2	0	0	0	2	0	0	0	0	0	18	0	3	20	41	7	0	3	0	10
Псковская область	Государственные, муниципальные (без учета организаций в ведении ФСИН); Очная	"    в том числе:
    переведено с других форм обучения данной
    образовательной организации с программ того же уровня / 2.0"	0	0	0	0	0	0	0	0	0	0	14	0	1	3	18	0	0	0	0	0
Псковская область	Государственные, муниципальные (без учета организаций в ведении ФСИН); Очная	    восстановлены из числа ранее отчисленных / 4.0	3	0	0	0	3	0	0	0	0	0	11	0	3	19	33	0	0	0	1	1
Псковская область	Государственные, муниципальные (без учета организаций в ведении ФСИН); Очная	    выбыло по другим причинам / 16.0	91	0	0	3	94	0	0	0	4	4	67	0	12	16	95	6	0	0	4	10
Псковская область	Государственные, муниципальные (без учета организаций в ведении ФСИН); Очная	"    добровольно прекратили образовательные отношения
    (бросили учебу) / 10.0"	153	0	0	3	156	0	0	0	0	0	220	0	41	91	352	29	0	5	40	74
Псковская область	Государственные, муниципальные (без учета организаций в ведении ФСИН); Очная	"    отчислено:
         по неуспеваемости / 11.0"	58	0	0	0	58	0	0	0	1	1	95	0	34	80	209	13	3	2	19	37
Псковская область	Государственные, муниципальные (без учета организаций в ведении ФСИН); Очная	"    переведено в другие образовательные организации
    на программы того же уровня / 8.0"	10	0	0	1	11	0	0	0	0	0	36	0	8	18	62	2	0	1	3	6
Псковская область	Государственные, муниципальные (без учета организаций в ведении ФСИН); Очная	"    переведено из других образовательных организаций 
    с программ того же уровня / 3.0"	4	0	0	0	4	0	0	0	0	0	23	0	4	13	40	4	0	0	1	5
Псковская область	Государственные, муниципальные (без учета организаций в ведении ФСИН); Очная	    по болезни / 9.0	0	0	0	0	0	0	0	0	0	0	0	0	0	0	0	0	0	0	0	0
Псковская область	Государственные, муниципальные (без учета организаций в ведении ФСИН); Очная	    прибыло по другим причинам / 5.0	62	0	0	0	62	0	0	0	0	0	40	0	5	4	49	3	0	4	2	9
Псковская область	Государственные, муниципальные (без учета организаций в ведении ФСИН); Очная	Выбыло студентов - всего (сумма стр. 07-11, 13-15) / 6.0	314	0	0	7	321	0	0	0	5	5	439	0	98	228	765	57	3	11	68	139
Псковская область	Государственные, муниципальные (без учета организаций в ведении ФСИН); Очная	Прибыло студентов - всего (сумма стр. 02-05) / 1.0	69	0	0	0	69	0	0	0	0	0	88	0	13	39	140	7	0	4	4	15
Псковская область	Государственные, муниципальные (без учета организаций в ведении ФСИН); Очная	"Численность студентов на начало прошлого учебного года
(на 1 октября) / 17.0"	2452	0	0	150	2602	0	0	0	35	35	3945	0	1667	1604	7216	567	0	241	551	1359
Псковская область	Очно-заочная; Государственные, муниципальные (без учета организаций в ведении ФСИН)	            из стр. 11 - не прошли итоговую аттестацию / 12.0	0	0	0	0	0	0	0	0	0	0	0	0	0	0	0	0	0	0	0	0
Псковская область	Очно-заочная; Государственные, муниципальные (без учета организаций в ведении ФСИН)	"            из стр. 11 – лица с ограниченными возможностями здоровья,
            инвалиды, дети-инвалиды / 13.0"	0	0	0	0	0	0	0	0	0	0	0	0	0	0	0	0	0	0	0	0
Псковская область	Очно-заочная; Государственные, муниципальные (без учета организаций в ведении ФСИН)	         отчислено в виде меры дисциплинарного взыскания / 14.0	0	0	0	0	0	0	0	0	0	0	0	0	0	0	0	0	0	0	0	0
Псковская область	Очно-заочная; Государственные, муниципальные (без учета организаций в ведении ФСИН)	         отчислено из-за просрочки оплаты обучения / 15.0	0	0	0	0	0	0	0	0	0	0	0	0	0	0	0	0	0	0	1	1
Псковская область	Очно-заочная; Государственные, муниципальные (без учета организаций в ведении ФСИН)	"    в том числе:
    переведено на другие формы обучения данной
    организации на программы того же уровня / 7.0"	0	0	0	0	0	0	0	0	0	0	0	0	0	0	0	0	0	0	0	0
Псковская область	Очно-заочная; Государственные, муниципальные (без учета организаций в ведении ФСИН)	"    в том числе:
    переведено с других форм обучения данной
    образовательной организации с программ того же уровня / 2.0"	0	0	0	0	0	0	0	0	0	0	0	0	0	0	0	0	0	0	0	0
Псковская область	Очно-заочная; Государственные, муниципальные (без учета организаций в ведении ФСИН)	    восстановлены из числа ранее отчисленных / 4.0	0	0	0	0	0	0	0	0	0	0	0	0	0	0	0	0	0	0	1	1
Псковская область	Очно-заочная; Государственные, муниципальные (без учета организаций в ведении ФСИН)	    выбыло по другим причинам / 16.0	0	0	0	0	0	0	0	0	0	0	0	0	0	0	0	0	0	0	0	0
Псковская область	Очно-заочная; Государственные, муниципальные (без учета организаций в ведении ФСИН)	"    добровольно прекратили образовательные отношения
    (бросили учебу) / 10.0"	0	0	0	0	0	0	0	0	0	0	0	0	0	0	0	0	0	0	6	6
Псковская область	Очно-заочная; Государственные, муниципальные (без учета организаций в ведении ФСИН)	"    отчислено:
         по неуспеваемости / 11.0"	0	0	0	0	0	0	0	0	0	0	0	0	0	0	0	0	0	0	0	0
Псковская область	Очно-заочная; Государственные, муниципальные (без учета организаций в ведении ФСИН)	"    переведено в другие образовательные организации
    на программы того же уровня / 8.0"	0	0	0	0	0	0	0	0	0	0	0	0	0	0	0	0	0	0	0	0
Псковская область	Очно-заочная; Государственные, муниципальные (без учета организаций в ведении ФСИН)	"    переведено из других образовательных организаций 
    с программ того же уровня / 3.0"	0	0	0	0	0	0	0	0	0	0	0	0	0	0	0	0	0	0	0	0
Псковская область	Очно-заочная; Государственные, муниципальные (без учета организаций в ведении ФСИН)	    по болезни / 9.0	0	0	0	0	0	0	0	0	0	0	0	0	0	0	0	0	0	0	0	0
Псковская область	Очно-заочная; Государственные, муниципальные (без учета организаций в ведении ФСИН)	    прибыло по другим причинам / 5.0	0	0	0	0	0	0	0	0	0	0	0	0	0	0	0	0	0	0	4	4
Псковская область	Очно-заочная; Государственные, муниципальные (без учета организаций в ведении ФСИН)	Выбыло студентов - всего (сумма стр. 07-11, 13-15) / 6.0	0	0	0	0	0	0	0	0	0	0	0	0	0	0	0	0	0	0	7	7
Псковская область	Очно-заочная; Государственные, муниципальные (без учета организаций в ведении ФСИН)	Прибыло студентов - всего (сумма стр. 02-05) / 1.0	0	0	0	0	0	0	0	0	0	0	0	0	0	0	0	0	0	0	5	5
Псковская область	Очно-заочная; Государственные, муниципальные (без учета организаций в ведении ФСИН)	"Численность студентов на начало прошлого учебного года
(на 1 октября) / 17.0"	0	0	0	0	0	0	0	0	0	0	0	0	0	0	0	0	0	0	128	128
Псковская область	Частные; Заочная	            из стр. 11 - не прошли итоговую аттестацию / 12.0	0	0	0	0	0	0	0	0	0	0	0	0	0	0	0	0	0	0	0	0
Псковская область	Частные; Заочная	"            из стр. 11 – лица с ограниченными возможностями здоровья,
            инвалиды, дети-инвалиды / 13.0"	0	0	0	0	0	0	0	0	0	0	0	0	0	0	0	0	0	0	0	0
Псковская область	Частные; Заочная	         отчислено в виде меры дисциплинарного взыскания / 14.0	0	0	0	0	0	0	0	0	0	0	0	0	0	0	0	0	0	0	0	0
Псковская область	Частные; Заочная	         отчислено из-за просрочки оплаты обучения / 15.0	0	0	0	0	0	0	0	0	0	0	0	0	0	1	1	0	0	0	0	0
Псковская область	Частные; Заочная	"    в том числе:
    переведено на другие формы обучения данной
    организации на программы того же уровня / 7.0"	0	0	0	0	0	0	0	0	0	0	0	0	0	1	1	0	0	0	0	0
Псковская область	Частные; Заочная	"    в том числе:
    переведено с других форм обучения данной
    образовательной организации с программ того же уровня / 2.0"	0	0	0	0	0	0	0	0	0	0	0	0	0	5	5	0	0	0	0	0
Псковская область	Частные; Заочная	    восстановлены из числа ранее отчисленных / 4.0	0	0	0	0	0	0	0	0	0	0	0	0	0	1	1	0	0	0	1	1
Псковская область	Частные; Заочная	    выбыло по другим причинам / 16.0	0	0	0	0	0	0	0	0	0	0	0	0	0	14	14	0	0	0	15	15
Псковская область	Частные; Заочная	"    добровольно прекратили образовательные отношения
    (бросили учебу) / 10.0"	0	0	0	0	0	0	0	0	0	0	0	0	0	15	15	0	0	0	12	12
Псковская область	Частные; Заочная	"    отчислено:
         по неуспеваемости / 11.0"	0	0	0	0	0	0	0	0	0	0	0	0	0	5	5	0	0	0	2	2
Псковская область	Частные; Заочная	"    переведено в другие образовательные организации
    на программы того же уровня / 8.0"	0	0	0	0	0	0	0	0	0	0	0	0	0	0	0	0	0	0	0	0
Псковская область	Частные; Заочная	"    переведено из других образовательных организаций 
    с программ того же уровня / 3.0"	0	0	0	0	0	0	0	0	0	0	0	0	0	0	0	0	0	0	1	1
Псковская область	Частные; Заочная	    по болезни / 9.0	0	0	0	0	0	0	0	0	0	0	0	0	0	0	0	0	0	0	0	0
Псковская область	Частные; Заочная	    прибыло по другим причинам / 5.0	0	0	0	0	0	0	0	0	0	0	0	0	0	6	6	0	0	0	5	5
Псковская область	Частные; Заочная	Выбыло студентов - всего (сумма стр. 07-11, 13-15) / 6.0	0	0	0	0	0	0	0	0	0	0	0	0	0	36	36	0	0	0	29	29
Псковская область	Частные; Заочная	Прибыло студентов - всего (сумма стр. 02-05) / 1.0	0	0	0	0	0	0	0	0	0	0	0	0	0	12	12	0	0	0	7	7
Псковская область	Частные; Заочная	"Численность студентов на начало прошлого учебного года
(на 1 октября) / 17.0"	0	0	0	0	0	0	0	0	0	0	0	0	0	128	128	0	0	0	138	138
Псковская область	Частные; Очная	            из стр. 11 - не прошли итоговую аттестацию / 12.0	0	0	0	0	0	0	0	0	0	0	0	0	0	1	1	0	0	0	1	1
Псковская область	Частные; Очная	"            из стр. 11 – лица с ограниченными возможностями здоровья,
            инвалиды, дети-инвалиды / 13.0"	0	0	0	0	0	0	0	0	0	0	0	0	0	0	0	0	0	0	0	0
Псковская область	Частные; Очная	         отчислено в виде меры дисциплинарного взыскания / 14.0	0	0	0	0	0	0	0	0	0	0	0	0	0	0	0	0	0	0	0	0
Псковская область	Частные; Очная	         отчислено из-за просрочки оплаты обучения / 15.0	0	0	0	0	0	0	0	0	0	0	0	0	0	0	0	0	0	0	0	0
Псковская область	Частные; Очная	"    в том числе:
    переведено на другие формы обучения данной
    организации на программы того же уровня / 7.0"	0	0	0	0	0	0	0	0	0	0	0	0	0	9	9	0	0	0	0	0
Псковская область	Частные; Очная	"    в том числе:
    переведено с других форм обучения данной
    образовательной организации с программ того же уровня / 2.0"	0	0	0	0	0	0	0	0	0	0	0	0	0	2	2	0	0	0	0	0
Псковская область	Частные; Очная	    восстановлены из числа ранее отчисленных / 4.0	0	0	0	0	0	0	0	0	0	0	0	0	0	4	4	0	0	0	0	0
Псковская область	Частные; Очная	    выбыло по другим причинам / 16.0	0	0	0	0	0	0	0	0	0	0	0	0	0	7	7	0	0	0	2	2
Псковская область	Частные; Очная	"    добровольно прекратили образовательные отношения
    (бросили учебу) / 10.0"	0	0	0	0	0	0	0	0	0	0	1	0	0	38	39	0	0	0	6	6
Псковская область	Частные; Очная	"    отчислено:
         по неуспеваемости / 11.0"	0	0	0	0	0	0	0	0	0	0	0	0	0	15	15	0	0	0	5	5
Псковская область	Частные; Очная	"    переведено в другие образовательные организации
    на программы того же уровня / 8.0"	0	0	0	0	0	0	0	0	0	0	0	0	0	1	1	0	0	0	0	0
Псковская область	Частные; Очная	"    переведено из других образовательных организаций 
    с программ того же уровня / 3.0"	0	0	0	0	0	0	0	0	0	0	0	0	0	3	3	0	0	0	0	0
Псковская область	Частные; Очная	    по болезни / 9.0	0	0	0	0	0	0	0	0	0	0	0	0	0	0	0	0	0	0	0	0
Псковская область	Частные; Очная	    прибыло по другим причинам / 5.0	0	0	0	0	0	0	0	0	0	0	0	0	0	8	8	0	0	0	6	6
Псковская область	Частные; Очная	Выбыло студентов - всего (сумма стр. 07-11, 13-15) / 6.0	0	0	0	0	0	0	0	0	0	0	1	0	0	70	71	0	0	0	13	13
Псковская область	Частные; Очная	Прибыло студентов - всего (сумма стр. 02-05) / 1.0	0	0	0	0	0	0	0	0	0	0	0	0	0	17	17	0	0	0	6	6
Псковская область	Частные; Очная	"Численность студентов на начало прошлого учебного года
(на 1 октября) / 17.0"	0	0	0	0	0	0	0	0	0	0	15	0	0	619	634	0	0	0	123	123
Республика Адыгея	Государственные, муниципальные (без учета организаций в ведении ФСИН); Заочная	            из стр. 11 - не прошли итоговую аттестацию / 12.0	0	0	0	0	0	0	0	0	0	0	0	0	0	0	0	0	0	0	0	0
Республика Адыгея	Государственные, муниципальные (без учета организаций в ведении ФСИН); Заочная	"            из стр. 11 – лица с ограниченными возможностями здоровья,
            инвалиды, дети-инвалиды / 13.0"	0	0	0	0	0	0	0	0	0	0	0	0	0	0	0	0	0	0	0	0
Республика Адыгея	Государственные, муниципальные (без учета организаций в ведении ФСИН); Заочная	         отчислено в виде меры дисциплинарного взыскания / 14.0	0	0	0	0	0	0	0	0	0	0	0	0	0	0	0	0	0	0	0	0
Республика Адыгея	Государственные, муниципальные (без учета организаций в ведении ФСИН); Заочная	         отчислено из-за просрочки оплаты обучения / 15.0	0	0	0	0	0	0	0	0	0	0	0	0	0	0	0	0	0	0	7	7
Республика Адыгея	Государственные, муниципальные (без учета организаций в ведении ФСИН); Заочная	"    в том числе:
    переведено на другие формы обучения данной
    организации на программы того же уровня / 7.0"	0	0	0	0	0	0	0	0	0	0	0	0	0	3	3	0	0	0	4	4
Республика Адыгея	Государственные, муниципальные (без учета организаций в ведении ФСИН); Заочная	"    в том числе:
    переведено с других форм обучения данной
    образовательной организации с программ того же уровня / 2.0"	0	0	0	0	0	0	0	0	0	0	0	0	0	1	1	0	0	0	10	10
Республика Адыгея	Государственные, муниципальные (без учета организаций в ведении ФСИН); Заочная	    восстановлены из числа ранее отчисленных / 4.0	0	0	0	0	0	0	0	0	0	0	0	0	0	0	0	0	0	0	4	4
Республика Адыгея	Государственные, муниципальные (без учета организаций в ведении ФСИН); Заочная	    выбыло по другим причинам / 16.0	0	0	0	0	0	0	0	0	0	0	0	0	0	0	0	0	0	0	0	0
Республика Адыгея	Государственные, муниципальные (без учета организаций в ведении ФСИН); Заочная	"    добровольно прекратили образовательные отношения
    (бросили учебу) / 10.0"	0	0	0	0	0	0	0	0	0	0	0	0	0	2	2	0	0	0	7	7
Республика Адыгея	Государственные, муниципальные (без учета организаций в ведении ФСИН); Заочная	"    отчислено:
         по неуспеваемости / 11.0"	0	0	0	0	0	0	0	0	0	0	0	0	0	0	0	0	0	0	9	9
Республика Адыгея	Государственные, муниципальные (без учета организаций в ведении ФСИН); Заочная	"    переведено в другие образовательные организации
    на программы того же уровня / 8.0"	0	0	0	0	0	0	0	0	0	0	0	0	0	0	0	0	0	0	0	0
Республика Адыгея	Государственные, муниципальные (без учета организаций в ведении ФСИН); Заочная	"    переведено из других образовательных организаций 
    с программ того же уровня / 3.0"	0	0	0	0	0	0	0	0	0	0	0	0	0	0	0	0	0	0	6	6
Республика Адыгея	Государственные, муниципальные (без учета организаций в ведении ФСИН); Заочная	    по болезни / 9.0	0	0	0	0	0	0	0	0	0	0	0	0	0	0	0	0	0	0	0	0
Республика Адыгея	Государственные, муниципальные (без учета организаций в ведении ФСИН); Заочная	    прибыло по другим причинам / 5.0	0	0	0	0	0	0	0	0	0	0	0	0	0	0	0	0	0	0	14	14
Республика Адыгея	Государственные, муниципальные (без учета организаций в ведении ФСИН); Заочная	Выбыло студентов - всего (сумма стр. 07-11, 13-15) / 6.0	0	0	0	0	0	0	0	0	0	0	0	0	0	5	5	0	0	0	27	27
Республика Адыгея	Государственные, муниципальные (без учета организаций в ведении ФСИН); Заочная	Прибыло студентов - всего (сумма стр. 02-05) / 1.0	0	0	0	0	0	0	0	0	0	0	0	0	0	1	1	0	0	0	34	34
Республика Адыгея	Государственные, муниципальные (без учета организаций в ведении ФСИН); Заочная	"Численность студентов на начало прошлого учебного года
(на 1 октября) / 17.0"	0	0	0	0	0	0	0	0	0	0	0	0	0	95	95	0	0	9	210	219
Республика Адыгея	Государственные, муниципальные (без учета организаций в ведении ФСИН); Очная	            из стр. 11 - не прошли итоговую аттестацию / 12.0	0	0	0	0	0	0	0	0	0	0	1	0	0	0	1	0	0	0	0	0
Республика Адыгея	Государственные, муниципальные (без учета организаций в ведении ФСИН); Очная	"            из стр. 11 – лица с ограниченными возможностями здоровья,
            инвалиды, дети-инвалиды / 13.0"	0	0	0	0	0	0	0	0	0	0	0	0	3	0	3	0	0	0	0	0
Республика Адыгея	Государственные, муниципальные (без учета организаций в ведении ФСИН); Очная	         отчислено в виде меры дисциплинарного взыскания / 14.0	3	0	0	0	3	0	0	0	0	0	0	0	0	0	0	0	0	0	0	0
Республика Адыгея	Государственные, муниципальные (без учета организаций в ведении ФСИН); Очная	         отчислено из-за просрочки оплаты обучения / 15.0	0	0	0	10	10	0	0	0	2	2	0	0	0	0	0	0	0	0	0	0
Республика Адыгея	Государственные, муниципальные (без учета организаций в ведении ФСИН); Очная	"    в том числе:
    переведено на другие формы обучения данной
    организации на программы того же уровня / 7.0"	8	0	0	0	8	0	0	0	0	0	8	0	0	18	26	0	0	0	8	8
Республика Адыгея	Государственные, муниципальные (без учета организаций в ведении ФСИН); Очная	"    в том числе:
    переведено с других форм обучения данной
    образовательной организации с программ того же уровня / 2.0"	0	0	0	1	1	0	0	0	0	0	9	0	0	0	9	6	0	0	1	7
Республика Адыгея	Государственные, муниципальные (без учета организаций в ведении ФСИН); Очная	    восстановлены из числа ранее отчисленных / 4.0	4	0	0	0	4	0	0	0	0	0	3	0	4	29	36	2	0	0	4	6
Республика Адыгея	Государственные, муниципальные (без учета организаций в ведении ФСИН); Очная	    выбыло по другим причинам / 16.0	70	0	0	8	78	0	0	0	0	0	72	0	31	31	134	0	0	0	0	0
Республика Адыгея	Государственные, муниципальные (без учета организаций в ведении ФСИН); Очная	"    добровольно прекратили образовательные отношения
    (бросили учебу) / 10.0"	0	0	0	0	0	0	0	0	1	1	45	0	42	140	227	21	0	3	17	41
Республика Адыгея	Государственные, муниципальные (без учета организаций в ведении ФСИН); Очная	"    отчислено:
         по неуспеваемости / 11.0"	41	0	0	0	41	0	0	0	2	2	7	0	44	110	161	4	0	3	8	15
Республика Адыгея	Государственные, муниципальные (без учета организаций в ведении ФСИН); Очная	"    переведено в другие образовательные организации
    на программы того же уровня / 8.0"	15	0	0	0	15	0	0	0	0	0	21	0	37	52	110	1	0	1	6	8
Республика Адыгея	Государственные, муниципальные (без учета организаций в ведении ФСИН); Очная	"    переведено из других образовательных организаций 
    с программ того же уровня / 3.0"	33	0	0	0	33	0	0	0	0	0	14	0	4	62	80	3	0	0	9	12
Республика Адыгея	Государственные, муниципальные (без учета организаций в ведении ФСИН); Очная	    по болезни / 9.0	3	0	0	0	3	0	0	0	0	0	0	0	0	0	0	0	0	0	0	0
Республика Адыгея	Государственные, муниципальные (без учета организаций в ведении ФСИН); Очная	    прибыло по другим причинам / 5.0	35	0	15	0	50	0	0	0	0	0	71	0	12	44	127	0	0	1	4	5
Республика Адыгея	Государственные, муниципальные (без учета организаций в ведении ФСИН); Очная	Выбыло студентов - всего (сумма стр. 07-11, 13-15) / 6.0	140	0	0	18	158	0	0	0	5	5	153	0	154	351	658	26	0	7	39	72
Республика Адыгея	Государственные, муниципальные (без учета организаций в ведении ФСИН); Очная	Прибыло студентов - всего (сумма стр. 02-05) / 1.0	72	0	15	1	88	0	0	0	0	0	97	0	20	135	252	11	0	1	18	30
Республика Адыгея	Государственные, муниципальные (без учета организаций в ведении ФСИН); Очная	"Численность студентов на начало прошлого учебного года
(на 1 октября) / 17.0"	1318	0	0	87	1405	0	0	0	154	154	1645	0	2191	2866	6702	195	0	132	350	677
Республика Адыгея	Очно-заочная; Государственные, муниципальные (без учета организаций в ведении ФСИН)	            из стр. 11 - не прошли итоговую аттестацию / 12.0	0	0	0	0	0	0	0	0	0	0	0	0	0	0	0	0	0	0	0	0
Республика Адыгея	Очно-заочная; Государственные, муниципальные (без учета организаций в ведении ФСИН)	"            из стр. 11 – лица с ограниченными возможностями здоровья,
            инвалиды, дети-инвалиды / 13.0"	0	0	0	0	0	0	0	0	0	0	0	0	0	0	0	0	0	0	0	0
Республика Адыгея	Очно-заочная; Государственные, муниципальные (без учета организаций в ведении ФСИН)	         отчислено в виде меры дисциплинарного взыскания / 14.0	0	0	0	0	0	0	0	0	0	0	0	0	0	0	0	0	0	0	0	0
Республика Адыгея	Очно-заочная; Государственные, муниципальные (без учета организаций в ведении ФСИН)	         отчислено из-за просрочки оплаты обучения / 15.0	0	0	0	0	0	0	0	0	0	0	0	0	0	0	0	0	0	0	0	0
Республика Адыгея	Очно-заочная; Государственные, муниципальные (без учета организаций в ведении ФСИН)	"    в том числе:
    переведено на другие формы обучения данной
    организации на программы того же уровня / 7.0"	0	0	0	0	0	0	0	0	0	0	0	0	0	0	0	0	0	0	5	5
Республика Адыгея	Очно-заочная; Государственные, муниципальные (без учета организаций в ведении ФСИН)	"    в том числе:
    переведено с других форм обучения данной
    образовательной организации с программ того же уровня / 2.0"	0	0	0	0	0	0	0	0	0	0	0	0	0	0	0	4	0	0	5	9
Республика Адыгея	Очно-заочная; Государственные, муниципальные (без учета организаций в ведении ФСИН)	    восстановлены из числа ранее отчисленных / 4.0	0	0	0	0	0	0	0	0	0	0	0	0	0	0	0	0	0	0	0	0
Республика Адыгея	Очно-заочная; Государственные, муниципальные (без учета организаций в ведении ФСИН)	    выбыло по другим причинам / 16.0	0	0	0	0	0	0	0	0	0	0	0	0	0	0	0	0	0	0	0	0
Республика Адыгея	Очно-заочная; Государственные, муниципальные (без учета организаций в ведении ФСИН)	"    добровольно прекратили образовательные отношения
    (бросили учебу) / 10.0"	0	0	0	0	0	0	0	0	0	0	0	0	0	0	0	11	0	0	14	25
Республика Адыгея	Очно-заочная; Государственные, муниципальные (без учета организаций в ведении ФСИН)	"    отчислено:
         по неуспеваемости / 11.0"	0	0	0	0	0	0	0	0	0	0	0	0	0	0	0	4	0	0	2	6
Республика Адыгея	Очно-заочная; Государственные, муниципальные (без учета организаций в ведении ФСИН)	"    переведено в другие образовательные организации
    на программы того же уровня / 8.0"	0	0	0	0	0	0	0	0	0	0	0	0	0	0	0	0	0	0	0	0
Республика Адыгея	Очно-заочная; Государственные, муниципальные (без учета организаций в ведении ФСИН)	"    переведено из других образовательных организаций 
    с программ того же уровня / 3.0"	0	0	0	0	0	0	0	0	0	0	0	0	0	0	0	1	0	0	5	6
Республика Адыгея	Очно-заочная; Государственные, муниципальные (без учета организаций в ведении ФСИН)	    по болезни / 9.0	0	0	0	0	0	0	0	0	0	0	0	0	0	0	0	0	0	0	0	0
Республика Адыгея	Очно-заочная; Государственные, муниципальные (без учета организаций в ведении ФСИН)	    прибыло по другим причинам / 5.0	0	0	0	0	0	0	0	0	0	0	0	0	0	0	0	0	0	0	0	0
Республика Адыгея	Очно-заочная; Государственные, муниципальные (без учета организаций в ведении ФСИН)	Выбыло студентов - всего (сумма стр. 07-11, 13-15) / 6.0	0	0	0	0	0	0	0	0	0	0	0	0	0	0	0	15	0	0	21	36
Республика Адыгея	Очно-заочная; Государственные, муниципальные (без учета организаций в ведении ФСИН)	Прибыло студентов - всего (сумма стр. 02-05) / 1.0	0	0	0	0	0	0	0	0	0	0	0	0	0	0	0	5	0	0	10	15
Республика Адыгея	Очно-заочная; Государственные, муниципальные (без учета организаций в ведении ФСИН)	"Численность студентов на начало прошлого учебного года
(на 1 октября) / 17.0"	0	0	0	0	0	0	0	0	0	0	0	0	0	0	0	80	0	0	134	214
Республика Алтай	Государственные, муниципальные (без учета организаций в ведении ФСИН); Заочная	            из стр. 11 - не прошли итоговую аттестацию / 12.0	0	0	0	0	0	0	0	0	0	0	0	0	0	0	0	0	0	0	0	0
Республика Алтай	Государственные, муниципальные (без учета организаций в ведении ФСИН); Заочная	"            из стр. 11 – лица с ограниченными возможностями здоровья,
            инвалиды, дети-инвалиды / 13.0"	0	0	0	0	0	0	0	0	0	0	0	0	0	0	0	0	0	0	0	0
Республика Алтай	Государственные, муниципальные (без учета организаций в ведении ФСИН); Заочная	         отчислено в виде меры дисциплинарного взыскания / 14.0	0	0	0	0	0	0	0	0	0	0	0	0	0	0	0	0	0	0	0	0
Республика Алтай	Государственные, муниципальные (без учета организаций в ведении ФСИН); Заочная	         отчислено из-за просрочки оплаты обучения / 15.0	0	0	0	0	0	0	0	0	0	0	0	0	0	0	0	0	0	0	0	0
Республика Алтай	Государственные, муниципальные (без учета организаций в ведении ФСИН); Заочная	"    в том числе:
    переведено на другие формы обучения данной
    организации на программы того же уровня / 7.0"	0	0	0	0	0	0	0	0	0	0	0	0	0	15	15	2	0	0	0	2
Республика Алтай	Государственные, муниципальные (без учета организаций в ведении ФСИН); Заочная	"    в том числе:
    переведено с других форм обучения данной
    образовательной организации с программ того же уровня / 2.0"	0	0	0	0	0	0	0	0	0	0	0	0	0	0	0	0	0	0	0	0
Республика Алтай	Государственные, муниципальные (без учета организаций в ведении ФСИН); Заочная	    восстановлены из числа ранее отчисленных / 4.0	0	0	0	0	0	0	0	0	0	0	0	0	0	0	0	6	0	0	0	6
Республика Алтай	Государственные, муниципальные (без учета организаций в ведении ФСИН); Заочная	    выбыло по другим причинам / 16.0	0	0	0	0	0	0	0	0	0	0	0	0	0	11	11	2	0	0	12	14
Республика Алтай	Государственные, муниципальные (без учета организаций в ведении ФСИН); Заочная	"    добровольно прекратили образовательные отношения
    (бросили учебу) / 10.0"	0	0	0	0	0	0	0	0	0	0	0	0	0	3	3	8	0	0	18	26
Республика Алтай	Государственные, муниципальные (без учета организаций в ведении ФСИН); Заочная	"    отчислено:
         по неуспеваемости / 11.0"	0	0	0	0	0	0	0	0	0	0	0	0	0	0	0	2	0	0	0	2
Республика Алтай	Государственные, муниципальные (без учета организаций в ведении ФСИН); Заочная	"    переведено в другие образовательные организации
    на программы того же уровня / 8.0"	0	0	0	0	0	0	0	0	0	0	0	0	0	0	0	1	0	0	0	1
Республика Алтай	Государственные, муниципальные (без учета организаций в ведении ФСИН); Заочная	"    переведено из других образовательных организаций 
    с программ того же уровня / 3.0"	0	0	0	0	0	0	0	0	0	0	0	0	0	0	0	0	0	0	24	24
Республика Алтай	Государственные, муниципальные (без учета организаций в ведении ФСИН); Заочная	    по болезни / 9.0	0	0	0	0	0	0	0	0	0	0	0	0	0	0	0	0	0	0	0	0
Республика Алтай	Государственные, муниципальные (без учета организаций в ведении ФСИН); Заочная	    прибыло по другим причинам / 5.0	0	0	0	0	0	0	0	0	0	0	0	0	0	0	0	6	0	0	0	6
Республика Алтай	Государственные, муниципальные (без учета организаций в ведении ФСИН); Заочная	Выбыло студентов - всего (сумма стр. 07-11, 13-15) / 6.0	0	0	0	0	0	0	0	0	0	0	0	0	0	29	29	15	0	0	30	45
Республика Алтай	Государственные, муниципальные (без учета организаций в ведении ФСИН); Заочная	Прибыло студентов - всего (сумма стр. 02-05) / 1.0	0	0	0	0	0	0	0	0	0	0	0	0	0	0	0	12	0	0	24	36
Республика Алтай	Государственные, муниципальные (без учета организаций в ведении ФСИН); Заочная	"Численность студентов на начало прошлого учебного года
(на 1 октября) / 17.0"	0	0	0	0	0	0	0	0	0	0	0	0	0	51	51	392	0	0	232	624
Республика Алтай	Государственные, муниципальные (без учета организаций в ведении ФСИН); Очная	            из стр. 11 - не прошли итоговую аттестацию / 12.0	0	0	0	0	0	0	0	0	0	0	2	0	0	0	2	0	0	0	0	0
Республика Алтай	Государственные, муниципальные (без учета организаций в ведении ФСИН); Очная	"            из стр. 11 – лица с ограниченными возможностями здоровья,
            инвалиды, дети-инвалиды / 13.0"	0	0	0	0	0	0	0	0	0	0	0	0	0	0	0	0	0	0	0	0
Республика Алтай	Государственные, муниципальные (без учета организаций в ведении ФСИН); Очная	         отчислено в виде меры дисциплинарного взыскания / 14.0	0	0	0	0	0	0	0	0	0	0	2	0	1	3	6	0	0	2	0	2
Республика Алтай	Государственные, муниципальные (без учета организаций в ведении ФСИН); Очная	         отчислено из-за просрочки оплаты обучения / 15.0	0	0	0	0	0	0	0	0	0	0	0	0	0	2	2	0	0	0	0	0
Республика Алтай	Государственные, муниципальные (без учета организаций в ведении ФСИН); Очная	"    в том числе:
    переведено на другие формы обучения данной
    организации на программы того же уровня / 7.0"	2	0	0	0	2	0	0	0	0	0	7	0	0	17	24	7	0	0	0	7
Республика Алтай	Государственные, муниципальные (без учета организаций в ведении ФСИН); Очная	"    в том числе:
    переведено с других форм обучения данной
    образовательной организации с программ того же уровня / 2.0"	12	0	0	0	12	0	0	0	0	0	2	0	0	0	2	3	0	0	0	3
Республика Алтай	Государственные, муниципальные (без учета организаций в ведении ФСИН); Очная	    восстановлены из числа ранее отчисленных / 4.0	18	0	0	0	18	3	0	0	0	3	23	0	3	7	33	2	0	1	1	4
Республика Алтай	Государственные, муниципальные (без учета организаций в ведении ФСИН); Очная	    выбыло по другим причинам / 16.0	1	0	0	0	1	0	0	0	0	0	15	0	3	1	19	13	0	0	0	13
Республика Алтай	Государственные, муниципальные (без учета организаций в ведении ФСИН); Очная	"    добровольно прекратили образовательные отношения
    (бросили учебу) / 10.0"	75	0	0	0	75	1	0	0	0	1	80	0	1	13	94	35	0	3	23	61
Республика Алтай	Государственные, муниципальные (без учета организаций в ведении ФСИН); Очная	"    отчислено:
         по неуспеваемости / 11.0"	8	0	0	0	8	1	0	0	0	1	22	0	0	1	23	9	0	1	0	10
Республика Алтай	Государственные, муниципальные (без учета организаций в ведении ФСИН); Очная	"    переведено в другие образовательные организации
    на программы того же уровня / 8.0"	6	0	0	0	6	0	0	0	0	0	46	0	0	13	59	10	0	0	0	10
Республика Алтай	Государственные, муниципальные (без учета организаций в ведении ФСИН); Очная	"    переведено из других образовательных организаций 
    с программ того же уровня / 3.0"	34	0	0	0	34	0	0	0	0	0	27	0	1	50	78	12	0	0	0	12
Республика Алтай	Государственные, муниципальные (без учета организаций в ведении ФСИН); Очная	    по болезни / 9.0	2	0	0	0	2	0	0	0	0	0	7	0	0	0	7	4	0	0	0	4
Республика Алтай	Государственные, муниципальные (без учета организаций в ведении ФСИН); Очная	    прибыло по другим причинам / 5.0	30	0	0	0	30	0	0	0	0	0	15	0	0	1	16	4	0	0	2	6
Республика Алтай	Государственные, муниципальные (без учета организаций в ведении ФСИН); Очная	Выбыло студентов - всего (сумма стр. 07-11, 13-15) / 6.0	94	0	0	0	94	2	0	0	0	2	179	0	5	50	234	78	0	6	23	107
Республика Алтай	Государственные, муниципальные (без учета организаций в ведении ФСИН); Очная	Прибыло студентов - всего (сумма стр. 02-05) / 1.0	94	0	0	0	94	3	0	0	0	3	67	0	4	58	129	21	0	1	3	25
Республика Алтай	Государственные, муниципальные (без учета организаций в ведении ФСИН); Очная	"Численность студентов на начало прошлого учебного года
(на 1 октября) / 17.0"	1298	0	0	0	1298	25	0	0	0	25	3126	0	244	218	3588	300	0	53	248	601
Республика Алтай	Частные; Заочная	            из стр. 11 - не прошли итоговую аттестацию / 12.0	0	0	0	0	0	0	0	0	0	0	0	0	0	0	0	0	0	0	0	0
Республика Алтай	Частные; Заочная	"            из стр. 11 – лица с ограниченными возможностями здоровья,
            инвалиды, дети-инвалиды / 13.0"	0	0	0	0	0	0	0	0	0	0	0	0	0	0	0	0	0	0	0	0
Республика Алтай	Частные; Заочная	         отчислено в виде меры дисциплинарного взыскания / 14.0	0	0	0	0	0	0	0	0	0	0	0	0	0	0	0	0	0	0	0	0
Республика Алтай	Частные; Заочная	         отчислено из-за просрочки оплаты обучения / 15.0	0	0	0	0	0	0	0	0	0	0	0	0	0	0	0	0	0	0	0	0
Республика Алтай	Частные; Заочная	"    в том числе:
    переведено на другие формы обучения данной
    организации на программы того же уровня / 7.0"	0	0	0	0	0	0	0	0	0	0	0	0	0	0	0	0	0	0	0	0
Республика Алтай	Частные; Заочная	"    в том числе:
    переведено с других форм обучения данной
    образовательной организации с программ того же уровня / 2.0"	0	0	0	0	0	0	0	0	0	0	0	0	0	0	0	0	0	0	3	3
Республика Алтай	Частные; Заочная	    восстановлены из числа ранее отчисленных / 4.0	0	0	0	0	0	0	0	0	0	0	0	0	0	0	0	0	0	0	0	0
Республика Алтай	Частные; Заочная	    выбыло по другим причинам / 16.0	0	0	0	0	0	0	0	0	0	0	0	0	0	0	0	0	0	0	11	11
Республика Алтай	Частные; Заочная	"    добровольно прекратили образовательные отношения
    (бросили учебу) / 10.0"	0	0	0	0	0	0	0	0	0	0	0	0	0	0	0	0	0	0	12	12
Республика Алтай	Частные; Заочная	"    отчислено:
         по неуспеваемости / 11.0"	0	0	0	0	0	0	0	0	0	0	0	0	0	0	0	0	0	0	4	4
Республика Алтай	Частные; Заочная	"    переведено в другие образовательные организации
    на программы того же уровня / 8.0"	0	0	0	0	0	0	0	0	0	0	0	0	0	0	0	0	0	0	0	0
Республика Алтай	Частные; Заочная	"    переведено из других образовательных организаций 
    с программ того же уровня / 3.0"	0	0	0	0	0	0	0	0	0	0	0	0	0	0	0	0	0	0	0	0
Республика Алтай	Частные; Заочная	    по болезни / 9.0	0	0	0	0	0	0	0	0	0	0	0	0	0	0	0	0	0	0	0	0
Республика Алтай	Частные; Заочная	    прибыло по другим причинам / 5.0	0	0	0	0	0	0	0	0	0	0	0	0	0	0	0	0	0	0	0	0
Республика Алтай	Частные; Заочная	Выбыло студентов - всего (сумма стр. 07-11, 13-15) / 6.0	0	0	0	0	0	0	0	0	0	0	0	0	0	0	0	0	0	0	27	27
Республика Алтай	Частные; Заочная	Прибыло студентов - всего (сумма стр. 02-05) / 1.0	0	0	0	0	0	0	0	0	0	0	0	0	0	0	0	0	0	0	3	3
Республика Алтай	Частные; Заочная	"Численность студентов на начало прошлого учебного года
(на 1 октября) / 17.0"	0	0	0	0	0	0	0	0	0	0	0	0	0	0	0	0	0	0	67	67
Республика Алтай	Частные; Очная	            из стр. 11 - не прошли итоговую аттестацию / 12.0	0	0	0	0	0	0	0	0	0	0	0	0	0	0	0	0	0	0	0	0
Республика Алтай	Частные; Очная	"            из стр. 11 – лица с ограниченными возможностями здоровья,
            инвалиды, дети-инвалиды / 13.0"	0	0	0	0	0	0	0	0	0	0	0	0	0	0	0	0	0	0	0	0
Республика Алтай	Частные; Очная	         отчислено в виде меры дисциплинарного взыскания / 14.0	0	0	0	0	0	0	0	0	0	0	0	0	0	0	0	0	0	0	0	0
Республика Алтай	Частные; Очная	         отчислено из-за просрочки оплаты обучения / 15.0	0	0	0	0	0	0	0	0	0	0	0	0	0	0	0	0	0	0	0	0
Республика Алтай	Частные; Очная	"    в том числе:
    переведено на другие формы обучения данной
    организации на программы того же уровня / 7.0"	0	0	0	0	0	0	0	0	0	0	0	0	0	0	0	0	0	0	5	5
Республика Алтай	Частные; Очная	"    в том числе:
    переведено с других форм обучения данной
    образовательной организации с программ того же уровня / 2.0"	0	0	0	0	0	0	0	0	0	0	0	0	0	3	3	0	0	0	0	0
Республика Алтай	Частные; Очная	    восстановлены из числа ранее отчисленных / 4.0	0	0	0	0	0	0	0	0	0	0	0	0	0	1	1	0	0	0	0	0
Республика Алтай	Частные; Очная	    выбыло по другим причинам / 16.0	0	0	0	0	0	0	0	0	0	0	0	0	0	42	42	0	0	0	40	40
Республика Алтай	Частные; Очная	"    добровольно прекратили образовательные отношения
    (бросили учебу) / 10.0"	0	0	0	0	0	0	0	0	0	0	0	0	0	4	4	0	0	0	4	4
Республика Алтай	Частные; Очная	"    отчислено:
         по неуспеваемости / 11.0"	0	0	0	0	0	0	0	0	0	0	0	0	0	3	3	0	0	0	0	0
Республика Алтай	Частные; Очная	"    переведено в другие образовательные организации
    на программы того же уровня / 8.0"	0	0	0	0	0	0	0	0	0	0	0	0	0	5	5	0	0	0	0	0
Республика Алтай	Частные; Очная	"    переведено из других образовательных организаций 
    с программ того же уровня / 3.0"	0	0	0	0	0	0	0	0	0	0	0	0	0	5	5	0	0	0	0	0
Республика Алтай	Частные; Очная	    по болезни / 9.0	0	0	0	0	0	0	0	0	0	0	0	0	0	0	0	0	0	0	0	0
Республика Алтай	Частные; Очная	    прибыло по другим причинам / 5.0	0	0	0	0	0	0	0	0	0	0	0	0	0	3	3	0	0	0	0	0
Республика Алтай	Частные; Очная	Выбыло студентов - всего (сумма стр. 07-11, 13-15) / 6.0	0	0	0	0	0	0	0	0	0	0	0	0	0	54	54	0	0	0	49	49
Республика Алтай	Частные; Очная	Прибыло студентов - всего (сумма стр. 02-05) / 1.0	0	0	0	0	0	0	0	0	0	0	0	0	0	12	12	0	0	0	0	0
Республика Алтай	Частные; Очная	"Численность студентов на начало прошлого учебного года
(на 1 октября) / 17.0"	0	0	0	0	0	0	0	0	0	0	0	0	0	266	266	0	0	0	126	126
Республика Башкортостан	Государственные, муниципальные (без учета организаций в ведении ФСИН); Заочная	            из стр. 11 - не прошли итоговую аттестацию / 12.0	0	0	0	0	0	0	0	0	0	0	0	0	0	0	0	1	0	0	0	1
Республика Башкортостан	Государственные, муниципальные (без учета организаций в ведении ФСИН); Заочная	"            из стр. 11 – лица с ограниченными возможностями здоровья,
            инвалиды, дети-инвалиды / 13.0"	0	0	0	0	0	0	0	0	0	0	0	0	0	0	0	0	0	0	0	0
Республика Башкортостан	Государственные, муниципальные (без учета организаций в ведении ФСИН); Заочная	         отчислено в виде меры дисциплинарного взыскания / 14.0	0	0	0	0	0	0	0	0	0	0	0	0	0	0	0	0	0	0	1	1
Республика Башкортостан	Государственные, муниципальные (без учета организаций в ведении ФСИН); Заочная	         отчислено из-за просрочки оплаты обучения / 15.0	0	0	0	0	0	0	0	0	0	0	0	0	0	4	4	0	0	0	94	94
Республика Башкортостан	Государственные, муниципальные (без учета организаций в ведении ФСИН); Заочная	"    в том числе:
    переведено на другие формы обучения данной
    организации на программы того же уровня / 7.0"	0	0	0	0	0	0	0	0	0	0	0	0	0	2	2	2	0	0	11	13
Республика Башкортостан	Государственные, муниципальные (без учета организаций в ведении ФСИН); Заочная	"    в том числе:
    переведено с других форм обучения данной
    образовательной организации с программ того же уровня / 2.0"	0	0	0	0	0	0	0	0	0	0	1	0	0	162	163	75	0	0	191	266
Республика Башкортостан	Государственные, муниципальные (без учета организаций в ведении ФСИН); Заочная	    восстановлены из числа ранее отчисленных / 4.0	0	0	0	0	0	0	0	0	0	0	0	0	0	51	51	48	0	0	127	175
Республика Башкортостан	Государственные, муниципальные (без учета организаций в ведении ФСИН); Заочная	    выбыло по другим причинам / 16.0	0	0	0	0	0	0	0	0	0	0	2	0	0	49	51	70	0	19	127	216
Республика Башкортостан	Государственные, муниципальные (без учета организаций в ведении ФСИН); Заочная	"    добровольно прекратили образовательные отношения
    (бросили учебу) / 10.0"	0	0	0	0	0	0	0	0	0	0	4	0	0	64	68	174	0	22	197	393
Республика Башкортостан	Государственные, муниципальные (без учета организаций в ведении ФСИН); Заочная	"    отчислено:
         по неуспеваемости / 11.0"	0	0	0	0	0	0	0	0	0	0	1	0	0	26	27	189	0	7	72	268
Республика Башкортостан	Государственные, муниципальные (без учета организаций в ведении ФСИН); Заочная	"    переведено в другие образовательные организации
    на программы того же уровня / 8.0"	0	0	0	0	0	0	0	0	0	0	0	0	0	2	2	36	0	0	11	47
Республика Башкортостан	Государственные, муниципальные (без учета организаций в ведении ФСИН); Заочная	"    переведено из других образовательных организаций 
    с программ того же уровня / 3.0"	0	0	0	0	0	0	0	0	0	0	0	0	0	11	11	6	0	0	63	69
Республика Башкортостан	Государственные, муниципальные (без учета организаций в ведении ФСИН); Заочная	    по болезни / 9.0	0	0	0	0	0	0	0	0	0	0	0	0	0	0	0	5	0	0	2	7
Республика Башкортостан	Государственные, муниципальные (без учета организаций в ведении ФСИН); Заочная	    прибыло по другим причинам / 5.0	0	0	0	0	0	0	0	0	0	0	0	0	0	47	47	28	0	0	141	169
Республика Башкортостан	Государственные, муниципальные (без учета организаций в ведении ФСИН); Заочная	Выбыло студентов - всего (сумма стр. 07-11, 13-15) / 6.0	0	0	0	0	0	0	0	0	0	0	7	0	0	147	154	476	0	48	515	1039
Республика Башкортостан	Государственные, муниципальные (без учета организаций в ведении ФСИН); Заочная	Прибыло студентов - всего (сумма стр. 02-05) / 1.0	0	0	0	0	0	0	0	0	0	0	1	0	0	271	272	157	0	0	522	679
Республика Башкортостан	Государственные, муниципальные (без учета организаций в ведении ФСИН); Заочная	"Численность студентов на начало прошлого учебного года
(на 1 октября) / 17.0"	0	0	0	0	0	0	0	0	0	0	70	0	0	584	654	3023	74	315	3626	7038
Республика Башкортостан	Государственные, муниципальные (без учета организаций в ведении ФСИН); Очная	            из стр. 11 - не прошли итоговую аттестацию / 12.0	25	0	0	0	25	0	0	0	2	2	6	0	0	2	8	1	0	0	1	2
Республика Башкортостан	Государственные, муниципальные (без учета организаций в ведении ФСИН); Очная	"            из стр. 11 – лица с ограниченными возможностями здоровья,
            инвалиды, дети-инвалиды / 13.0"	0	0	0	0	0	0	0	0	0	0	1	0	0	0	1	1	0	0	0	1
Республика Башкортостан	Государственные, муниципальные (без учета организаций в ведении ФСИН); Очная	         отчислено в виде меры дисциплинарного взыскания / 14.0	11	0	0	0	11	0	0	0	0	0	17	0	1	26	44	0	0	1	0	1
Республика Башкортостан	Государственные, муниципальные (без учета организаций в ведении ФСИН); Очная	         отчислено из-за просрочки оплаты обучения / 15.0	0	0	0	7	7	0	0	0	9	9	0	0	0	48	48	0	0	0	17	17
Республика Башкортостан	Государственные, муниципальные (без учета организаций в ведении ФСИН); Очная	"    в том числе:
    переведено на другие формы обучения данной
    организации на программы того же уровня / 7.0"	57	0	0	4	61	0	0	0	0	0	234	0	23	370	627	50	0	0	55	105
Республика Башкортостан	Государственные, муниципальные (без учета организаций в ведении ФСИН); Очная	"    в том числе:
    переведено с других форм обучения данной
    образовательной организации с программ того же уровня / 2.0"	88	0	0	11	99	0	0	0	0	0	132	0	2	48	182	29	0	16	10	55
Республика Башкортостан	Государственные, муниципальные (без учета организаций в ведении ФСИН); Очная	    восстановлены из числа ранее отчисленных / 4.0	97	0	4	0	101	1	0	1	6	8	111	0	5	69	185	21	0	0	11	32
Республика Башкортостан	Государственные, муниципальные (без учета организаций в ведении ФСИН); Очная	    выбыло по другим причинам / 16.0	353	0	24	10	387	13	0	4	1	18	414	0	17	385	816	53	0	0	91	144
Республика Башкортостан	Государственные, муниципальные (без учета организаций в ведении ФСИН); Очная	"    добровольно прекратили образовательные отношения
    (бросили учебу) / 10.0"	1109	0	31	31	1171	41	0	0	11	52	1037	0	118	623	1778	256	0	25	131	412
Республика Башкортостан	Государственные, муниципальные (без учета организаций в ведении ФСИН); Очная	"    отчислено:
         по неуспеваемости / 11.0"	320	0	3	13	336	1	0	0	2	3	289	0	34	108	431	31	0	3	38	72
Республика Башкортостан	Государственные, муниципальные (без учета организаций в ведении ФСИН); Очная	"    переведено в другие образовательные организации
    на программы того же уровня / 8.0"	289	0	4	5	298	7	0	0	0	7	456	0	69	369	894	53	0	1	46	100
Республика Башкортостан	Государственные, муниципальные (без учета организаций в ведении ФСИН); Очная	"    переведено из других образовательных организаций 
    с программ того же уровня / 3.0"	462	0	25	20	507	1	0	45	4	50	267	0	76	280	623	19	0	0	34	53
Республика Башкортостан	Государственные, муниципальные (без учета организаций в ведении ФСИН); Очная	    по болезни / 9.0	23	0	0	0	23	0	0	0	0	0	28	0	0	10	38	3	0	0	8	11
Республика Башкортостан	Государственные, муниципальные (без учета организаций в ведении ФСИН); Очная	    прибыло по другим причинам / 5.0	205	0	21	24	250	15	2	0	30	47	317	0	22	260	599	50	0	3	43	96
Республика Башкортостан	Государственные, муниципальные (без учета организаций в ведении ФСИН); Очная	Выбыло студентов - всего (сумма стр. 07-11, 13-15) / 6.0	2162	0	62	70	2294	62	0	4	23	89	2475	0	262	1939	4676	446	0	30	386	862
Республика Башкортостан	Государственные, муниципальные (без учета организаций в ведении ФСИН); Очная	Прибыло студентов - всего (сумма стр. 02-05) / 1.0	852	0	50	55	957	17	2	46	40	105	827	0	105	657	1589	119	0	19	98	236
Республика Башкортостан	Государственные, муниципальные (без учета организаций в ведении ФСИН); Очная	"Численность студентов на начало прошлого учебного года
(на 1 октября) / 17.0"	23011	0	379	598	23988	908	0	0	212	1120	38033	888	4117	20999	64037	3536	0	670	2746	6952
Республика Башкортостан	Очно-заочная; Государственные, муниципальные (без учета организаций в ведении ФСИН)	            из стр. 11 - не прошли итоговую аттестацию / 12.0	0	0	0	0	0	0	0	0	0	0	0	0	0	0	0	0	0	0	0	0
Республика Башкортостан	Очно-заочная; Государственные, муниципальные (без учета организаций в ведении ФСИН)	"            из стр. 11 – лица с ограниченными возможностями здоровья,
            инвалиды, дети-инвалиды / 13.0"	0	0	0	0	0	0	0	0	0	0	0	0	0	0	0	0	0	0	0	0
Республика Башкортостан	Очно-заочная; Государственные, муниципальные (без учета организаций в ведении ФСИН)	         отчислено в виде меры дисциплинарного взыскания / 14.0	0	0	0	0	0	0	0	0	0	0	0	0	0	0	0	0	0	0	0	0
Республика Башкортостан	Очно-заочная; Государственные, муниципальные (без учета организаций в ведении ФСИН)	         отчислено из-за просрочки оплаты обучения / 15.0	0	0	0	0	0	0	0	0	0	0	0	0	0	0	0	0	0	0	4	4
Республика Башкортостан	Очно-заочная; Государственные, муниципальные (без учета организаций в ведении ФСИН)	"    в том числе:
    переведено на другие формы обучения данной
    организации на программы того же уровня / 7.0"	0	0	0	0	0	0	0	0	0	0	0	0	0	0	0	0	0	0	0	0
Республика Башкортостан	Очно-заочная; Государственные, муниципальные (без учета организаций в ведении ФСИН)	"    в том числе:
    переведено с других форм обучения данной
    образовательной организации с программ того же уровня / 2.0"	0	0	0	0	0	0	0	0	0	0	0	0	0	2	2	1	0	0	10	11
Республика Башкортостан	Очно-заочная; Государственные, муниципальные (без учета организаций в ведении ФСИН)	    восстановлены из числа ранее отчисленных / 4.0	0	0	0	0	0	0	0	0	0	0	0	0	0	1	1	6	0	0	2	8
Республика Башкортостан	Очно-заочная; Государственные, муниципальные (без учета организаций в ведении ФСИН)	    выбыло по другим причинам / 16.0	0	0	0	0	0	0	0	0	0	0	0	0	0	2	2	30	0	0	11	41
Республика Башкортостан	Очно-заочная; Государственные, муниципальные (без учета организаций в ведении ФСИН)	"    добровольно прекратили образовательные отношения
    (бросили учебу) / 10.0"	0	0	0	0	0	0	0	0	0	0	0	0	0	11	11	5	0	0	34	39
Республика Башкортостан	Очно-заочная; Государственные, муниципальные (без учета организаций в ведении ФСИН)	"    отчислено:
         по неуспеваемости / 11.0"	0	0	0	0	0	0	0	0	0	0	0	0	0	1	1	0	0	0	2	2
Республика Башкортостан	Очно-заочная; Государственные, муниципальные (без учета организаций в ведении ФСИН)	"    переведено в другие образовательные организации
    на программы того же уровня / 8.0"	0	0	0	0	0	0	0	0	0	0	0	0	0	0	0	0	0	0	4	4
Республика Башкортостан	Очно-заочная; Государственные, муниципальные (без учета организаций в ведении ФСИН)	"    переведено из других образовательных организаций 
    с программ того же уровня / 3.0"	0	0	0	0	0	0	0	0	0	0	0	0	0	1	1	27	0	0	2	29
Республика Башкортостан	Очно-заочная; Государственные, муниципальные (без учета организаций в ведении ФСИН)	    по болезни / 9.0	0	0	0	0	0	0	0	0	0	0	0	0	0	0	0	0	0	0	0	0
Республика Башкортостан	Очно-заочная; Государственные, муниципальные (без учета организаций в ведении ФСИН)	    прибыло по другим причинам / 5.0	0	0	0	0	0	0	0	0	0	0	0	0	0	14	14	4	0	0	11	15
Республика Башкортостан	Очно-заочная; Государственные, муниципальные (без учета организаций в ведении ФСИН)	Выбыло студентов - всего (сумма стр. 07-11, 13-15) / 6.0	0	0	0	0	0	0	0	0	0	0	0	0	0	14	14	35	0	0	55	90
Республика Башкортостан	Очно-заочная; Государственные, муниципальные (без учета организаций в ведении ФСИН)	Прибыло студентов - всего (сумма стр. 02-05) / 1.0	0	0	0	0	0	0	0	0	0	0	0	0	0	18	18	38	0	0	25	63
Республика Башкортостан	Очно-заочная; Государственные, муниципальные (без учета организаций в ведении ФСИН)	"Численность студентов на начало прошлого учебного года
(на 1 октября) / 17.0"	0	0	0	0	0	0	0	0	0	0	0	0	0	141	141	262	0	0	758	1020
Республика Башкортостан	Частные; Заочная	            из стр. 11 - не прошли итоговую аттестацию / 12.0	0	0	0	0	0	0	0	0	0	0	0	0	0	0	0	0	0	0	0	0
Республика Башкортостан	Частные; Заочная	"            из стр. 11 – лица с ограниченными возможностями здоровья,
            инвалиды, дети-инвалиды / 13.0"	0	0	0	0	0	0	0	0	0	0	0	0	0	0	0	0	0	0	0	0
Республика Башкортостан	Частные; Заочная	         отчислено в виде меры дисциплинарного взыскания / 14.0	0	0	0	0	0	0	0	0	0	0	0	0	0	0	0	0	0	0	1	1
Республика Башкортостан	Частные; Заочная	         отчислено из-за просрочки оплаты обучения / 15.0	0	0	0	0	0	0	0	0	0	0	0	0	0	46	46	0	0	0	34	34
Республика Башкортостан	Частные; Заочная	"    в том числе:
    переведено на другие формы обучения данной
    организации на программы того же уровня / 7.0"	0	0	0	0	0	0	0	0	0	0	0	0	0	11	11	0	0	0	22	22
Республика Башкортостан	Частные; Заочная	"    в том числе:
    переведено с других форм обучения данной
    образовательной организации с программ того же уровня / 2.0"	0	0	0	0	0	0	0	0	0	0	0	0	0	52	52	0	0	0	18	18
Республика Башкортостан	Частные; Заочная	    восстановлены из числа ранее отчисленных / 4.0	0	0	0	0	0	0	0	0	0	0	0	0	0	16	16	0	0	0	22	22
Республика Башкортостан	Частные; Заочная	    выбыло по другим причинам / 16.0	0	0	0	0	0	0	0	0	0	0	0	0	0	7	7	0	0	0	34	34
Республика Башкортостан	Частные; Заочная	"    добровольно прекратили образовательные отношения
    (бросили учебу) / 10.0"	0	0	0	0	0	0	0	0	0	0	0	0	0	37	37	0	0	0	22	22
Республика Башкортостан	Частные; Заочная	"    отчислено:
         по неуспеваемости / 11.0"	0	0	0	0	0	0	0	0	0	0	0	0	0	19	19	0	0	0	14	14
Республика Башкортостан	Частные; Заочная	"    переведено в другие образовательные организации
    на программы того же уровня / 8.0"	0	0	0	0	0	0	0	0	0	0	0	0	0	5	5	0	0	0	0	0
Республика Башкортостан	Частные; Заочная	"    переведено из других образовательных организаций 
    с программ того же уровня / 3.0"	0	0	0	0	0	0	0	0	0	0	0	0	0	17	17	0	0	0	11	11
Республика Башкортостан	Частные; Заочная	    по болезни / 9.0	0	0	0	0	0	0	0	0	0	0	0	0	0	0	0	0	0	0	0	0
Республика Башкортостан	Частные; Заочная	    прибыло по другим причинам / 5.0	0	0	0	0	0	0	0	0	0	0	0	0	0	16	16	0	0	0	33	33
Республика Башкортостан	Частные; Заочная	Выбыло студентов - всего (сумма стр. 07-11, 13-15) / 6.0	0	0	0	0	0	0	0	0	0	0	0	0	0	125	125	0	0	0	127	127
Республика Башкортостан	Частные; Заочная	Прибыло студентов - всего (сумма стр. 02-05) / 1.0	0	0	0	0	0	0	0	0	0	0	0	0	0	101	101	0	0	0	84	84
Республика Башкортостан	Частные; Заочная	"Численность студентов на начало прошлого учебного года
(на 1 октября) / 17.0"	0	0	0	0	0	0	0	0	0	0	0	0	0	443	443	0	0	0	582	582
Республика Башкортостан	Частные; Очная	            из стр. 11 - не прошли итоговую аттестацию / 12.0	0	0	0	0	0	0	0	0	0	0	0	0	0	0	0	0	0	0	0	0
Республика Башкортостан	Частные; Очная	"            из стр. 11 – лица с ограниченными возможностями здоровья,
            инвалиды, дети-инвалиды / 13.0"	0	0	0	0	0	0	0	0	0	0	0	0	0	0	0	0	0	0	0	0
Республика Башкортостан	Частные; Очная	         отчислено в виде меры дисциплинарного взыскания / 14.0	0	0	0	0	0	0	0	0	0	0	0	0	0	0	0	0	0	0	0	0
Республика Башкортостан	Частные; Очная	         отчислено из-за просрочки оплаты обучения / 15.0	0	0	0	0	0	0	0	0	0	0	0	0	0	129	129	0	0	0	29	29
Республика Башкортостан	Частные; Очная	"    в том числе:
    переведено на другие формы обучения данной
    организации на программы того же уровня / 7.0"	0	0	0	0	0	0	0	0	0	0	2	0	0	61	63	0	0	0	6	6
Республика Башкортостан	Частные; Очная	"    в том числе:
    переведено с других форм обучения данной
    образовательной организации с программ того же уровня / 2.0"	0	0	0	0	0	0	0	0	0	0	0	0	0	15	15	0	0	0	22	22
Республика Башкортостан	Частные; Очная	    восстановлены из числа ранее отчисленных / 4.0	0	0	0	0	0	0	0	0	0	0	0	0	0	52	52	0	0	0	8	8
Республика Башкортостан	Частные; Очная	    выбыло по другим причинам / 16.0	0	0	0	0	0	0	0	0	0	0	1	0	0	141	142	0	0	0	70	70
Республика Башкортостан	Частные; Очная	"    добровольно прекратили образовательные отношения
    (бросили учебу) / 10.0"	0	0	0	0	0	0	0	0	0	0	21	0	0	112	133	0	0	0	31	31
Республика Башкортостан	Частные; Очная	"    отчислено:
         по неуспеваемости / 11.0"	0	0	0	0	0	0	0	0	0	0	0	0	0	75	75	0	0	0	11	11
Республика Башкортостан	Частные; Очная	"    переведено в другие образовательные организации
    на программы того же уровня / 8.0"	0	0	0	0	0	0	0	0	0	0	3	0	0	58	61	0	0	0	4	4
Республика Башкортостан	Частные; Очная	"    переведено из других образовательных организаций 
    с программ того же уровня / 3.0"	0	0	0	0	0	0	0	0	0	0	0	0	0	72	72	0	0	0	1	1
Республика Башкортостан	Частные; Очная	    по болезни / 9.0	0	0	0	0	0	0	0	0	0	0	0	0	0	1	1	0	0	0	0	0
Республика Башкортостан	Частные; Очная	    прибыло по другим причинам / 5.0	0	0	0	0	0	0	0	0	0	0	0	0	0	221	221	0	0	0	71	71
Республика Башкортостан	Частные; Очная	Выбыло студентов - всего (сумма стр. 07-11, 13-15) / 6.0	0	0	0	0	0	0	0	0	0	0	27	0	0	577	604	0	0	0	151	151
Республика Башкортостан	Частные; Очная	Прибыло студентов - всего (сумма стр. 02-05) / 1.0	0	0	0	0	0	0	0	0	0	0	0	0	0	360	360	0	0	0	102	102
Республика Башкортостан	Частные; Очная	"Численность студентов на начало прошлого учебного года
(на 1 октября) / 17.0"	0	0	0	0	0	0	0	0	0	0	334	0	0	3508	3842	0	0	0	513	513
Республика Бурятия	Государственные, муниципальные (без учета организаций в ведении ФСИН); Заочная	            из стр. 11 - не прошли итоговую аттестацию / 12.0	0	0	0	0	0	0	0	0	0	0	0	0	0	1	1	0	0	0	2	2
Республика Бурятия	Государственные, муниципальные (без учета организаций в ведении ФСИН); Заочная	"            из стр. 11 – лица с ограниченными возможностями здоровья,
            инвалиды, дети-инвалиды / 13.0"	0	0	0	0	0	0	0	0	0	0	0	0	0	0	0	0	0	0	0	0
Республика Бурятия	Государственные, муниципальные (без учета организаций в ведении ФСИН); Заочная	         отчислено в виде меры дисциплинарного взыскания / 14.0	0	0	0	0	0	0	0	0	0	0	0	0	0	0	0	0	0	0	0	0
Республика Бурятия	Государственные, муниципальные (без учета организаций в ведении ФСИН); Заочная	         отчислено из-за просрочки оплаты обучения / 15.0	0	0	0	0	0	0	0	0	0	0	0	0	0	0	0	0	0	0	12	12
Республика Бурятия	Государственные, муниципальные (без учета организаций в ведении ФСИН); Заочная	"    в том числе:
    переведено на другие формы обучения данной
    организации на программы того же уровня / 7.0"	0	0	0	0	0	0	0	0	0	0	0	0	0	0	0	0	0	0	0	0
Республика Бурятия	Государственные, муниципальные (без учета организаций в ведении ФСИН); Заочная	"    в том числе:
    переведено с других форм обучения данной
    образовательной организации с программ того же уровня / 2.0"	0	0	0	0	0	0	0	0	0	0	0	0	1	15	16	0	0	0	50	50
Республика Бурятия	Государственные, муниципальные (без учета организаций в ведении ФСИН); Заочная	    восстановлены из числа ранее отчисленных / 4.0	0	0	0	0	0	0	0	0	0	0	0	0	0	10	10	1	0	5	53	59
Республика Бурятия	Государственные, муниципальные (без учета организаций в ведении ФСИН); Заочная	    выбыло по другим причинам / 16.0	0	0	0	0	0	0	0	0	0	0	0	0	0	5	5	0	0	0	10	10
Республика Бурятия	Государственные, муниципальные (без учета организаций в ведении ФСИН); Заочная	"    добровольно прекратили образовательные отношения
    (бросили учебу) / 10.0"	0	0	0	0	0	0	0	0	0	0	0	0	0	1	1	7	0	27	150	184
Республика Бурятия	Государственные, муниципальные (без учета организаций в ведении ФСИН); Заочная	"    отчислено:
         по неуспеваемости / 11.0"	0	0	0	0	0	0	0	0	0	0	0	0	0	11	11	0	0	0	32	32
Республика Бурятия	Государственные, муниципальные (без учета организаций в ведении ФСИН); Заочная	"    переведено в другие образовательные организации
    на программы того же уровня / 8.0"	0	0	0	0	0	0	0	0	0	0	0	0	0	2	2	0	0	0	2	2
Республика Бурятия	Государственные, муниципальные (без учета организаций в ведении ФСИН); Заочная	"    переведено из других образовательных организаций 
    с программ того же уровня / 3.0"	0	0	0	0	0	0	0	0	0	0	0	0	0	0	0	0	0	0	3	3
Республика Бурятия	Государственные, муниципальные (без учета организаций в ведении ФСИН); Заочная	    по болезни / 9.0	0	0	0	0	0	0	0	0	0	0	0	0	0	0	0	0	0	0	0	0
Республика Бурятия	Государственные, муниципальные (без учета организаций в ведении ФСИН); Заочная	    прибыло по другим причинам / 5.0	0	0	0	0	0	0	0	0	0	0	0	0	0	1	1	0	0	0	61	61
Республика Бурятия	Государственные, муниципальные (без учета организаций в ведении ФСИН); Заочная	Выбыло студентов - всего (сумма стр. 07-11, 13-15) / 6.0	0	0	0	0	0	0	0	0	0	0	0	0	0	19	19	7	0	27	206	240
Республика Бурятия	Государственные, муниципальные (без учета организаций в ведении ФСИН); Заочная	Прибыло студентов - всего (сумма стр. 02-05) / 1.0	0	0	0	0	0	0	0	0	0	0	0	0	1	26	27	1	0	5	167	173
Республика Бурятия	Государственные, муниципальные (без учета организаций в ведении ФСИН); Заочная	"Численность студентов на начало прошлого учебного года
(на 1 октября) / 17.0"	0	0	0	0	0	0	0	0	0	0	0	0	1	149	150	33	0	445	1580	2058
Республика Бурятия	Государственные, муниципальные (без учета организаций в ведении ФСИН); Очная	            из стр. 11 - не прошли итоговую аттестацию / 12.0	92	0	0	2	94	0	0	0	0	0	54	0	0	3	57	8	0	0	3	11
Республика Бурятия	Государственные, муниципальные (без учета организаций в ведении ФСИН); Очная	"            из стр. 11 – лица с ограниченными возможностями здоровья,
            инвалиды, дети-инвалиды / 13.0"	0	0	0	0	0	0	0	0	0	0	0	0	1	0	1	0	0	0	0	0
Республика Бурятия	Государственные, муниципальные (без учета организаций в ведении ФСИН); Очная	         отчислено в виде меры дисциплинарного взыскания / 14.0	2	0	0	0	2	0	0	0	0	0	6	0	1	5	12	0	0	0	0	0
Республика Бурятия	Государственные, муниципальные (без учета организаций в ведении ФСИН); Очная	         отчислено из-за просрочки оплаты обучения / 15.0	0	0	0	0	0	0	0	0	0	0	0	0	0	19	19	0	0	0	8	8
Республика Бурятия	Государственные, муниципальные (без учета организаций в ведении ФСИН); Очная	"    в том числе:
    переведено на другие формы обучения данной
    организации на программы того же уровня / 7.0"	16	0	0	6	22	0	0	0	0	0	26	0	8	145	179	0	0	2	11	13
Республика Бурятия	Государственные, муниципальные (без учета организаций в ведении ФСИН); Очная	"    в том числе:
    переведено с других форм обучения данной
    образовательной организации с программ того же уровня / 2.0"	22	0	0	0	22	0	0	0	0	0	76	0	14	0	90	1	0	3	2	6
Республика Бурятия	Государственные, муниципальные (без учета организаций в ведении ФСИН); Очная	    восстановлены из числа ранее отчисленных / 4.0	19	0	0	1	20	0	0	0	0	0	27	0	2	29	58	1	0	1	18	20
Республика Бурятия	Государственные, муниципальные (без учета организаций в ведении ФСИН); Очная	    выбыло по другим причинам / 16.0	110	0	0	11	121	3	0	0	0	3	179	14	56	116	365	22	0	12	49	83
Республика Бурятия	Государственные, муниципальные (без учета организаций в ведении ФСИН); Очная	"    добровольно прекратили образовательные отношения
    (бросили учебу) / 10.0"	197	0	0	17	214	3	0	0	0	3	283	0	49	324	656	84	0	34	105	223
Республика Бурятия	Государственные, муниципальные (без учета организаций в ведении ФСИН); Очная	"    отчислено:
         по неуспеваемости / 11.0"	208	0	0	4	212	7	0	0	0	7	192	0	10	130	332	12	0	24	85	121
Республика Бурятия	Государственные, муниципальные (без учета организаций в ведении ФСИН); Очная	"    переведено в другие образовательные организации
    на программы того же уровня / 8.0"	141	0	0	5	146	0	0	0	0	0	260	0	49	133	442	3	0	7	42	52
Республика Бурятия	Государственные, муниципальные (без учета организаций в ведении ФСИН); Очная	"    переведено из других образовательных организаций 
    с программ того же уровня / 3.0"	79	0	0	2	81	1	0	0	0	1	92	0	16	37	145	4	0	4	19	27
Республика Бурятия	Государственные, муниципальные (без учета организаций в ведении ФСИН); Очная	    по болезни / 9.0	0	0	0	0	0	0	0	0	0	0	4	0	0	3	7	0	0	0	0	0
Республика Бурятия	Государственные, муниципальные (без учета организаций в ведении ФСИН); Очная	    прибыло по другим причинам / 5.0	62	0	0	12	74	0	0	0	0	0	84	1	13	61	159	4	0	3	5	12
Республика Бурятия	Государственные, муниципальные (без учета организаций в ведении ФСИН); Очная	Выбыло студентов - всего (сумма стр. 07-11, 13-15) / 6.0	674	0	0	43	717	13	0	0	0	13	950	14	173	875	2012	121	0	79	300	500
Республика Бурятия	Государственные, муниципальные (без учета организаций в ведении ФСИН); Очная	Прибыло студентов - всего (сумма стр. 02-05) / 1.0	182	0	0	15	197	1	0	0	0	1	279	1	45	127	452	10	0	11	44	65
Республика Бурятия	Государственные, муниципальные (без учета организаций в ведении ФСИН); Очная	"Численность студентов на начало прошлого учебного года
(на 1 октября) / 17.0"	5310	0	0	108	5418	163	0	0	14	177	10565	0	2487	3656	16708	1382	0	658	1226	3266
Республика Бурятия	Очно-заочная; Государственные, муниципальные (без учета организаций в ведении ФСИН)	            из стр. 11 - не прошли итоговую аттестацию / 12.0	0	0	0	0	0	0	0	0	0	0	0	0	0	0	0	0	0	0	0	0
Республика Бурятия	Очно-заочная; Государственные, муниципальные (без учета организаций в ведении ФСИН)	"            из стр. 11 – лица с ограниченными возможностями здоровья,
            инвалиды, дети-инвалиды / 13.0"	0	0	0	0	0	0	0	0	0	0	0	0	0	0	0	0	0	0	0	0
Республика Бурятия	Очно-заочная; Государственные, муниципальные (без учета организаций в ведении ФСИН)	         отчислено в виде меры дисциплинарного взыскания / 14.0	0	0	0	0	0	0	0	0	0	0	0	0	0	0	0	0	0	0	0	0
Республика Бурятия	Очно-заочная; Государственные, муниципальные (без учета организаций в ведении ФСИН)	         отчислено из-за просрочки оплаты обучения / 15.0	0	0	0	0	0	0	0	0	0	0	0	0	0	0	0	0	0	0	0	0
Республика Бурятия	Очно-заочная; Государственные, муниципальные (без учета организаций в ведении ФСИН)	"    в том числе:
    переведено на другие формы обучения данной
    организации на программы того же уровня / 7.0"	0	0	0	0	0	0	0	0	0	0	0	0	0	0	0	0	0	0	0	0
Республика Бурятия	Очно-заочная; Государственные, муниципальные (без учета организаций в ведении ФСИН)	"    в том числе:
    переведено с других форм обучения данной
    образовательной организации с программ того же уровня / 2.0"	0	0	0	0	0	0	0	0	0	0	0	0	0	0	0	0	0	0	0	0
Республика Бурятия	Очно-заочная; Государственные, муниципальные (без учета организаций в ведении ФСИН)	    восстановлены из числа ранее отчисленных / 4.0	0	0	0	0	0	0	0	0	0	0	0	0	0	0	0	0	0	0	0	0
Республика Бурятия	Очно-заочная; Государственные, муниципальные (без учета организаций в ведении ФСИН)	    выбыло по другим причинам / 16.0	0	0	0	0	0	0	0	0	0	0	0	0	0	0	0	0	0	0	0	0
Республика Бурятия	Очно-заочная; Государственные, муниципальные (без учета организаций в ведении ФСИН)	"    добровольно прекратили образовательные отношения
    (бросили учебу) / 10.0"	0	0	0	0	0	0	0	0	0	0	0	0	0	0	0	0	0	0	0	0
Республика Бурятия	Очно-заочная; Государственные, муниципальные (без учета организаций в ведении ФСИН)	"    отчислено:
         по неуспеваемости / 11.0"	0	0	0	0	0	0	0	0	0	0	0	0	0	0	0	0	0	0	0	0
Республика Бурятия	Очно-заочная; Государственные, муниципальные (без учета организаций в ведении ФСИН)	"    переведено в другие образовательные организации
    на программы того же уровня / 8.0"	0	0	0	0	0	0	0	0	0	0	0	0	0	0	0	0	0	0	0	0
Республика Бурятия	Очно-заочная; Государственные, муниципальные (без учета организаций в ведении ФСИН)	"    переведено из других образовательных организаций 
    с программ того же уровня / 3.0"	0	0	0	0	0	0	0	0	0	0	0	0	0	0	0	0	0	0	3	3
Республика Бурятия	Очно-заочная; Государственные, муниципальные (без учета организаций в ведении ФСИН)	    по болезни / 9.0	0	0	0	0	0	0	0	0	0	0	0	0	0	0	0	0	0	0	0	0
Республика Бурятия	Очно-заочная; Государственные, муниципальные (без учета организаций в ведении ФСИН)	    прибыло по другим причинам / 5.0	0	0	0	0	0	0	0	0	0	0	0	0	0	0	0	0	0	0	1	1
Республика Бурятия	Очно-заочная; Государственные, муниципальные (без учета организаций в ведении ФСИН)	Выбыло студентов - всего (сумма стр. 07-11, 13-15) / 6.0	0	0	0	0	0	0	0	0	0	0	0	0	0	0	0	0	0	0	0	0
Республика Бурятия	Очно-заочная; Государственные, муниципальные (без учета организаций в ведении ФСИН)	Прибыло студентов - всего (сумма стр. 02-05) / 1.0	0	0	0	0	0	0	0	0	0	0	0	0	0	0	0	0	0	0	4	4
Республика Бурятия	Очно-заочная; Государственные, муниципальные (без учета организаций в ведении ФСИН)	"Численность студентов на начало прошлого учебного года
(на 1 октября) / 17.0"	0	0	0	0	0	0	0	0	0	0	0	0	0	0	0	0	0	0	37	37
Республика Бурятия	Частные; Заочная	            из стр. 11 - не прошли итоговую аттестацию / 12.0	0	0	0	0	0	0	0	0	0	0	0	0	0	2	2	0	0	0	0	0
Республика Бурятия	Частные; Заочная	"            из стр. 11 – лица с ограниченными возможностями здоровья,
            инвалиды, дети-инвалиды / 13.0"	0	0	0	0	0	0	0	0	0	0	0	0	0	0	0	0	0	0	0	0
Республика Бурятия	Частные; Заочная	         отчислено в виде меры дисциплинарного взыскания / 14.0	0	0	0	0	0	0	0	0	0	0	0	0	0	0	0	0	0	0	0	0
Республика Бурятия	Частные; Заочная	         отчислено из-за просрочки оплаты обучения / 15.0	0	0	0	0	0	0	0	0	0	0	0	0	0	0	0	0	0	0	3	3
Республика Бурятия	Частные; Заочная	"    в том числе:
    переведено на другие формы обучения данной
    организации на программы того же уровня / 7.0"	0	0	0	0	0	0	0	0	0	0	0	0	0	0	0	0	0	0	25	25
Республика Бурятия	Частные; Заочная	"    в том числе:
    переведено с других форм обучения данной
    образовательной организации с программ того же уровня / 2.0"	0	0	0	0	0	0	0	0	0	0	0	0	0	4	4	0	0	0	21	21
Республика Бурятия	Частные; Заочная	    восстановлены из числа ранее отчисленных / 4.0	0	0	0	0	0	0	0	0	0	0	0	0	0	0	0	0	0	0	3	3
Республика Бурятия	Частные; Заочная	    выбыло по другим причинам / 16.0	0	0	0	0	0	0	0	0	0	0	0	0	0	1	1	0	0	0	7	7
Республика Бурятия	Частные; Заочная	"    добровольно прекратили образовательные отношения
    (бросили учебу) / 10.0"	0	0	0	0	0	0	0	0	0	0	0	0	0	3	3	0	0	0	10	10
Республика Бурятия	Частные; Заочная	"    отчислено:
         по неуспеваемости / 11.0"	0	0	0	0	0	0	0	0	0	0	0	0	0	3	3	0	0	0	3	3
Республика Бурятия	Частные; Заочная	"    переведено в другие образовательные организации
    на программы того же уровня / 8.0"	0	0	0	0	0	0	0	0	0	0	0	0	0	1	1	0	0	0	0	0
Республика Бурятия	Частные; Заочная	"    переведено из других образовательных организаций 
    с программ того же уровня / 3.0"	0	0	0	0	0	0	0	0	0	0	0	0	0	0	0	0	0	0	0	0
Республика Бурятия	Частные; Заочная	    по болезни / 9.0	0	0	0	0	0	0	0	0	0	0	0	0	0	0	0	0	0	0	2	2
Республика Бурятия	Частные; Заочная	    прибыло по другим причинам / 5.0	0	0	0	0	0	0	0	0	0	0	0	0	0	0	0	0	0	0	19	19
Республика Бурятия	Частные; Заочная	Выбыло студентов - всего (сумма стр. 07-11, 13-15) / 6.0	0	0	0	0	0	0	0	0	0	0	0	0	0	8	8	0	0	0	50	50
Республика Бурятия	Частные; Заочная	Прибыло студентов - всего (сумма стр. 02-05) / 1.0	0	0	0	0	0	0	0	0	0	0	0	0	0	4	4	0	0	0	43	43
Республика Бурятия	Частные; Заочная	"Численность студентов на начало прошлого учебного года
(на 1 октября) / 17.0"	0	0	0	0	0	0	0	0	0	0	0	0	0	42	42	0	0	0	113	113
Республика Бурятия	Частные; Очная	            из стр. 11 - не прошли итоговую аттестацию / 12.0	0	0	0	0	0	0	0	0	0	0	0	0	0	1	1	0	0	0	2	2
Республика Бурятия	Частные; Очная	"            из стр. 11 – лица с ограниченными возможностями здоровья,
            инвалиды, дети-инвалиды / 13.0"	0	0	0	0	0	0	0	0	0	0	0	0	0	0	0	0	0	0	0	0
Республика Бурятия	Частные; Очная	         отчислено в виде меры дисциплинарного взыскания / 14.0	0	0	0	0	0	0	0	0	0	0	0	0	0	0	0	0	0	0	0	0
Республика Бурятия	Частные; Очная	         отчислено из-за просрочки оплаты обучения / 15.0	0	0	0	0	0	0	0	0	0	0	0	0	0	0	0	0	0	0	0	0
Республика Бурятия	Частные; Очная	"    в том числе:
    переведено на другие формы обучения данной
    организации на программы того же уровня / 7.0"	0	0	0	0	0	0	0	0	0	0	0	0	0	20	20	0	0	0	5	5
Республика Бурятия	Частные; Очная	"    в том числе:
    переведено с других форм обучения данной
    образовательной организации с программ того же уровня / 2.0"	0	0	0	0	0	0	0	0	0	0	0	0	0	0	0	0	0	0	0	0
Республика Бурятия	Частные; Очная	    восстановлены из числа ранее отчисленных / 4.0	0	0	0	0	0	0	0	0	0	0	0	0	0	0	0	0	0	0	0	0
Республика Бурятия	Частные; Очная	    выбыло по другим причинам / 16.0	0	0	0	0	0	0	0	0	0	0	0	0	0	9	9	0	0	0	24	24
Республика Бурятия	Частные; Очная	"    добровольно прекратили образовательные отношения
    (бросили учебу) / 10.0"	0	0	0	0	0	0	0	0	0	0	0	0	0	20	20	0	0	0	10	10
Республика Бурятия	Частные; Очная	"    отчислено:
         по неуспеваемости / 11.0"	0	0	0	0	0	0	0	0	0	0	0	0	0	6	6	0	0	0	2	2
Республика Бурятия	Частные; Очная	"    переведено в другие образовательные организации
    на программы того же уровня / 8.0"	0	0	0	0	0	0	0	0	0	0	0	0	0	13	13	0	0	0	4	4
Республика Бурятия	Частные; Очная	"    переведено из других образовательных организаций 
    с программ того же уровня / 3.0"	0	0	0	0	0	0	0	0	0	0	0	0	0	5	5	0	0	0	1	1
Республика Бурятия	Частные; Очная	    по болезни / 9.0	0	0	0	0	0	0	0	0	0	0	0	0	0	0	0	0	0	0	0	0
Республика Бурятия	Частные; Очная	    прибыло по другим причинам / 5.0	0	0	0	0	0	0	0	0	0	0	0	0	0	4	4	0	0	0	6	6
Республика Бурятия	Частные; Очная	Выбыло студентов - всего (сумма стр. 07-11, 13-15) / 6.0	0	0	0	0	0	0	0	0	0	0	0	0	0	68	68	0	0	0	45	45
Республика Бурятия	Частные; Очная	Прибыло студентов - всего (сумма стр. 02-05) / 1.0	0	0	0	0	0	0	0	0	0	0	0	0	0	9	9	0	0	0	7	7
Республика Бурятия	Частные; Очная	"Численность студентов на начало прошлого учебного года
(на 1 октября) / 17.0"	0	0	0	0	0	0	0	0	0	0	0	0	0	829	829	0	0	0	169	169
Республика Дагестан	Государственные, муниципальные (без учета организаций в ведении ФСИН); Заочная	            из стр. 11 - не прошли итоговую аттестацию / 12.0	0	0	0	0	0	0	0	0	0	0	0	0	0	10	10	0	0	1	21	22
Республика Дагестан	Государственные, муниципальные (без учета организаций в ведении ФСИН); Заочная	"            из стр. 11 – лица с ограниченными возможностями здоровья,
            инвалиды, дети-инвалиды / 13.0"	0	0	0	0	0	0	0	0	0	0	0	0	0	0	0	0	0	0	0	0
Республика Дагестан	Государственные, муниципальные (без учета организаций в ведении ФСИН); Заочная	         отчислено в виде меры дисциплинарного взыскания / 14.0	0	0	0	0	0	0	0	0	0	0	0	0	0	0	0	0	0	0	0	0
Республика Дагестан	Государственные, муниципальные (без учета организаций в ведении ФСИН); Заочная	         отчислено из-за просрочки оплаты обучения / 15.0	0	0	0	0	0	0	0	0	0	0	0	0	0	135	135	0	0	0	54	54
Республика Дагестан	Государственные, муниципальные (без учета организаций в ведении ФСИН); Заочная	"    в том числе:
    переведено на другие формы обучения данной
    организации на программы того же уровня / 7.0"	0	0	0	0	0	0	0	0	0	0	0	0	0	107	107	0	0	0	15	15
Республика Дагестан	Государственные, муниципальные (без учета организаций в ведении ФСИН); Заочная	"    в том числе:
    переведено с других форм обучения данной
    образовательной организации с программ того же уровня / 2.0"	0	0	0	0	0	0	0	0	0	0	0	0	0	399	399	0	0	0	274	274
Республика Дагестан	Государственные, муниципальные (без учета организаций в ведении ФСИН); Заочная	    восстановлены из числа ранее отчисленных / 4.0	0	0	0	0	0	0	0	0	0	0	0	0	0	173	173	0	0	0	159	159
Республика Дагестан	Государственные, муниципальные (без учета организаций в ведении ФСИН); Заочная	    выбыло по другим причинам / 16.0	0	0	0	0	0	0	0	0	0	0	0	0	0	151	151	0	0	0	37	37
Республика Дагестан	Государственные, муниципальные (без учета организаций в ведении ФСИН); Заочная	"    добровольно прекратили образовательные отношения
    (бросили учебу) / 10.0"	0	0	0	0	0	0	0	0	0	0	0	0	5	117	122	0	0	0	36	36
Республика Дагестан	Государственные, муниципальные (без учета организаций в ведении ФСИН); Заочная	"    отчислено:
         по неуспеваемости / 11.0"	0	0	0	0	0	0	0	0	0	0	0	0	0	599	599	0	0	3	145	148
Республика Дагестан	Государственные, муниципальные (без учета организаций в ведении ФСИН); Заочная	"    переведено в другие образовательные организации
    на программы того же уровня / 8.0"	0	0	0	0	0	0	0	0	0	0	0	0	0	49	49	0	0	0	22	22
Республика Дагестан	Государственные, муниципальные (без учета организаций в ведении ФСИН); Заочная	"    переведено из других образовательных организаций 
    с программ того же уровня / 3.0"	0	0	0	0	0	0	0	0	0	0	0	0	0	39	39	0	0	0	87	87
Республика Дагестан	Государственные, муниципальные (без учета организаций в ведении ФСИН); Заочная	    по болезни / 9.0	0	0	0	0	0	0	0	0	0	0	0	0	0	5	5	0	0	0	2	2
Республика Дагестан	Государственные, муниципальные (без учета организаций в ведении ФСИН); Заочная	    прибыло по другим причинам / 5.0	0	0	0	0	0	0	0	0	0	0	0	0	0	75	75	0	0	0	133	133
Республика Дагестан	Государственные, муниципальные (без учета организаций в ведении ФСИН); Заочная	Выбыло студентов - всего (сумма стр. 07-11, 13-15) / 6.0	0	0	0	0	0	0	0	0	0	0	0	0	5	1163	1168	0	0	3	311	314
Республика Дагестан	Государственные, муниципальные (без учета организаций в ведении ФСИН); Заочная	Прибыло студентов - всего (сумма стр. 02-05) / 1.0	0	0	0	0	0	0	0	0	0	0	0	0	0	686	686	0	0	0	653	653
Республика Дагестан	Государственные, муниципальные (без учета организаций в ведении ФСИН); Заочная	"Численность студентов на начало прошлого учебного года
(на 1 октября) / 17.0"	0	0	0	0	0	0	0	0	0	0	0	0	60	6383	6443	0	0	13	3767	3780
Республика Дагестан	Государственные, муниципальные (без учета организаций в ведении ФСИН); Очная	            из стр. 11 - не прошли итоговую аттестацию / 12.0	26	0	0	0	26	0	0	0	0	0	40	0	0	13	53	0	0	0	0	0
Республика Дагестан	Государственные, муниципальные (без учета организаций в ведении ФСИН); Очная	"            из стр. 11 – лица с ограниченными возможностями здоровья,
            инвалиды, дети-инвалиды / 13.0"	0	0	0	0	0	0	0	0	0	0	0	0	0	0	0	0	0	0	0	0
Республика Дагестан	Государственные, муниципальные (без учета организаций в ведении ФСИН); Очная	         отчислено в виде меры дисциплинарного взыскания / 14.0	104	0	0	0	104	0	0	0	0	0	83	0	0	19	102	0	0	0	0	0
Республика Дагестан	Государственные, муниципальные (без учета организаций в ведении ФСИН); Очная	         отчислено из-за просрочки оплаты обучения / 15.0	0	0	0	9	9	0	0	0	30	30	0	0	0	24	24	0	0	0	1	1
Республика Дагестан	Государственные, муниципальные (без учета организаций в ведении ФСИН); Очная	"    в том числе:
    переведено на другие формы обучения данной
    организации на программы того же уровня / 7.0"	10	0	0	1	11	0	0	0	0	0	480	0	67	392	939	9	0	2	26	37
Республика Дагестан	Государственные, муниципальные (без учета организаций в ведении ФСИН); Очная	"    в том числе:
    переведено с других форм обучения данной
    образовательной организации с программ того же уровня / 2.0"	10	0	0	0	10	1	0	0	11	12	91	0	11	113	215	4	0	0	20	24
Республика Дагестан	Государственные, муниципальные (без учета организаций в ведении ФСИН); Очная	    восстановлены из числа ранее отчисленных / 4.0	20	0	0	2	22	15	0	0	1	16	110	0	0	76	186	11	0	0	21	32
Республика Дагестан	Государственные, муниципальные (без учета организаций в ведении ФСИН); Очная	    выбыло по другим причинам / 16.0	256	0	0	5	261	27	0	0	0	27	212	0	33	146	391	1	0	7	66	74
Республика Дагестан	Государственные, муниципальные (без учета организаций в ведении ФСИН); Очная	"    добровольно прекратили образовательные отношения
    (бросили учебу) / 10.0"	233	0	0	5	238	8	0	0	5	13	323	0	7	142	472	18	0	6	52	76
Республика Дагестан	Государственные, муниципальные (без учета организаций в ведении ФСИН); Очная	"    отчислено:
         по неуспеваемости / 11.0"	105	0	0	1	106	5	0	0	9	14	267	8	11	210	496	47	0	0	22	69
Республика Дагестан	Государственные, муниципальные (без учета организаций в ведении ФСИН); Очная	"    переведено в другие образовательные организации
    на программы того же уровня / 8.0"	34	0	0	2	36	0	0	0	1	1	207	0	8	146	361	14	0	2	23	39
Республика Дагестан	Государственные, муниципальные (без учета организаций в ведении ФСИН); Очная	"    переведено из других образовательных организаций 
    с программ того же уровня / 3.0"	27	0	0	0	27	0	0	0	64	64	70	0	5	138	213	12	0	0	15	27
Республика Дагестан	Государственные, муниципальные (без учета организаций в ведении ФСИН); Очная	    по болезни / 9.0	8	0	0	0	8	0	0	0	0	0	34	0	2	16	52	0	0	1	2	3
Республика Дагестан	Государственные, муниципальные (без учета организаций в ведении ФСИН); Очная	    прибыло по другим причинам / 5.0	152	0	0	1	153	25	0	0	14	39	108	0	11	194	313	17	0	4	61	82
Республика Дагестан	Государственные, муниципальные (без учета организаций в ведении ФСИН); Очная	Выбыло студентов - всего (сумма стр. 07-11, 13-15) / 6.0	750	0	0	23	773	40	0	0	45	85	1606	8	128	1095	2837	89	0	18	192	299
Республика Дагестан	Государственные, муниципальные (без учета организаций в ведении ФСИН); Очная	Прибыло студентов - всего (сумма стр. 02-05) / 1.0	209	0	0	3	212	41	0	0	90	131	379	0	27	521	927	44	0	4	117	165
Республика Дагестан	Государственные, муниципальные (без учета организаций в ведении ФСИН); Очная	"Численность студентов на начало прошлого учебного года
(на 1 октября) / 17.0"	5880	0	0	162	6042	375	0	0	344	719	20056	0	2298	10411	32765	2436	0	529	1704	4669
Республика Дагестан	Очно-заочная; Государственные, муниципальные (без учета организаций в ведении ФСИН)	            из стр. 11 - не прошли итоговую аттестацию / 12.0	0	0	0	0	0	0	0	0	0	0	0	0	0	0	0	0	0	0	0	0
Республика Дагестан	Очно-заочная; Государственные, муниципальные (без учета организаций в ведении ФСИН)	"            из стр. 11 – лица с ограниченными возможностями здоровья,
            инвалиды, дети-инвалиды / 13.0"	0	0	0	0	0	0	0	0	0	0	0	0	0	0	0	0	0	0	0	0
Республика Дагестан	Очно-заочная; Государственные, муниципальные (без учета организаций в ведении ФСИН)	         отчислено в виде меры дисциплинарного взыскания / 14.0	0	0	0	0	0	0	0	0	0	0	0	0	0	0	0	0	0	0	0	0
Республика Дагестан	Очно-заочная; Государственные, муниципальные (без учета организаций в ведении ФСИН)	         отчислено из-за просрочки оплаты обучения / 15.0	0	0	0	0	0	0	0	0	0	0	0	0	0	1	1	0	0	0	0	0
Республика Дагестан	Очно-заочная; Государственные, муниципальные (без учета организаций в ведении ФСИН)	"    в том числе:
    переведено на другие формы обучения данной
    организации на программы того же уровня / 7.0"	0	0	0	0	0	0	0	0	0	0	0	0	0	0	0	0	0	0	0	0
Республика Дагестан	Очно-заочная; Государственные, муниципальные (без учета организаций в ведении ФСИН)	"    в том числе:
    переведено с других форм обучения данной
    образовательной организации с программ того же уровня / 2.0"	0	0	0	0	0	0	0	0	0	0	0	0	0	0	0	0	0	0	0	0
Республика Дагестан	Очно-заочная; Государственные, муниципальные (без учета организаций в ведении ФСИН)	    восстановлены из числа ранее отчисленных / 4.0	0	0	0	0	0	0	0	0	0	0	0	0	0	0	0	0	0	0	0	0
Республика Дагестан	Очно-заочная; Государственные, муниципальные (без учета организаций в ведении ФСИН)	    выбыло по другим причинам / 16.0	0	0	0	0	0	0	0	0	0	0	0	0	0	0	0	0	0	0	0	0
Республика Дагестан	Очно-заочная; Государственные, муниципальные (без учета организаций в ведении ФСИН)	"    добровольно прекратили образовательные отношения
    (бросили учебу) / 10.0"	0	0	0	0	0	0	0	0	0	0	0	0	0	3	3	0	0	0	0	0
Республика Дагестан	Очно-заочная; Государственные, муниципальные (без учета организаций в ведении ФСИН)	"    отчислено:
         по неуспеваемости / 11.0"	0	0	0	0	0	0	0	0	0	0	0	0	0	1	1	0	0	0	0	0
Республика Дагестан	Очно-заочная; Государственные, муниципальные (без учета организаций в ведении ФСИН)	"    переведено в другие образовательные организации
    на программы того же уровня / 8.0"	0	0	0	0	0	0	0	0	0	0	0	0	0	0	0	0	0	0	0	0
Республика Дагестан	Очно-заочная; Государственные, муниципальные (без учета организаций в ведении ФСИН)	"    переведено из других образовательных организаций 
    с программ того же уровня / 3.0"	0	0	0	0	0	0	0	0	0	0	0	0	0	0	0	2	0	0	0	2
Республика Дагестан	Очно-заочная; Государственные, муниципальные (без учета организаций в ведении ФСИН)	    по болезни / 9.0	0	0	0	0	0	0	0	0	0	0	0	0	0	0	0	0	0	0	0	0
Республика Дагестан	Очно-заочная; Государственные, муниципальные (без учета организаций в ведении ФСИН)	    прибыло по другим причинам / 5.0	0	0	0	0	0	0	0	0	0	0	0	0	0	0	0	0	0	0	0	0
Республика Дагестан	Очно-заочная; Государственные, муниципальные (без учета организаций в ведении ФСИН)	Выбыло студентов - всего (сумма стр. 07-11, 13-15) / 6.0	0	0	0	0	0	0	0	0	0	0	0	0	0	5	5	0	0	0	0	0
Республика Дагестан	Очно-заочная; Государственные, муниципальные (без учета организаций в ведении ФСИН)	Прибыло студентов - всего (сумма стр. 02-05) / 1.0	0	0	0	0	0	0	0	0	0	0	0	0	0	0	0	2	0	0	0	2
Республика Дагестан	Очно-заочная; Государственные, муниципальные (без учета организаций в ведении ФСИН)	"Численность студентов на начало прошлого учебного года
(на 1 октября) / 17.0"	0	0	0	0	0	0	0	0	0	0	0	0	0	46	46	107	0	0	0	107
Республика Дагестан	Частные; Заочная	            из стр. 11 - не прошли итоговую аттестацию / 12.0	0	0	0	0	0	0	0	0	0	0	0	0	0	11	11	0	0	0	7	7
Республика Дагестан	Частные; Заочная	"            из стр. 11 – лица с ограниченными возможностями здоровья,
            инвалиды, дети-инвалиды / 13.0"	0	0	0	0	0	0	0	0	0	0	0	0	0	0	0	0	0	0	0	0
Республика Дагестан	Частные; Заочная	         отчислено в виде меры дисциплинарного взыскания / 14.0	0	0	0	0	0	0	0	0	0	0	0	0	0	0	0	0	0	0	12	12
Республика Дагестан	Частные; Заочная	         отчислено из-за просрочки оплаты обучения / 15.0	0	0	0	0	0	0	0	0	0	0	0	0	0	92	92	0	0	0	74	74
Республика Дагестан	Частные; Заочная	"    в том числе:
    переведено на другие формы обучения данной
    организации на программы того же уровня / 7.0"	0	0	0	0	0	0	0	0	0	0	0	0	0	74	74	0	0	0	4	4
Республика Дагестан	Частные; Заочная	"    в том числе:
    переведено с других форм обучения данной
    образовательной организации с программ того же уровня / 2.0"	0	0	0	0	0	0	0	0	0	0	0	0	0	65	65	0	0	0	8	8
Республика Дагестан	Частные; Заочная	    восстановлены из числа ранее отчисленных / 4.0	0	0	0	0	0	0	0	0	0	0	0	0	0	40	40	0	0	0	15	15
Республика Дагестан	Частные; Заочная	    выбыло по другим причинам / 16.0	0	0	0	0	0	0	0	0	0	0	0	0	0	58	58	0	0	0	73	73
Республика Дагестан	Частные; Заочная	"    добровольно прекратили образовательные отношения
    (бросили учебу) / 10.0"	0	0	0	0	0	0	0	0	0	0	0	0	0	154	154	0	0	0	60	60
Республика Дагестан	Частные; Заочная	"    отчислено:
         по неуспеваемости / 11.0"	0	0	0	0	0	0	0	0	0	0	0	0	0	42	42	0	0	0	46	46
Республика Дагестан	Частные; Заочная	"    переведено в другие образовательные организации
    на программы того же уровня / 8.0"	0	0	0	0	0	0	0	0	0	0	0	0	0	252	252	0	0	0	110	110
Республика Дагестан	Частные; Заочная	"    переведено из других образовательных организаций 
    с программ того же уровня / 3.0"	0	0	0	0	0	0	0	0	0	0	0	0	0	455	455	0	0	0	168	168
Республика Дагестан	Частные; Заочная	    по болезни / 9.0	0	0	0	0	0	0	0	0	0	0	0	0	0	0	0	0	0	0	0	0
Республика Дагестан	Частные; Заочная	    прибыло по другим причинам / 5.0	0	0	0	0	0	0	0	0	0	0	0	0	0	422	422	0	0	0	60	60
Республика Дагестан	Частные; Заочная	Выбыло студентов - всего (сумма стр. 07-11, 13-15) / 6.0	0	0	0	0	0	0	0	0	0	0	0	0	0	672	672	0	0	0	379	379
Республика Дагестан	Частные; Заочная	Прибыло студентов - всего (сумма стр. 02-05) / 1.0	0	0	0	0	0	0	0	0	0	0	0	0	0	982	982	0	0	0	251	251
Республика Дагестан	Частные; Заочная	"Численность студентов на начало прошлого учебного года
(на 1 октября) / 17.0"	0	0	0	0	0	0	0	0	0	0	0	0	0	4310	4310	0	0	0	1233	1233
Республика Дагестан	Частные; Очная	            из стр. 11 - не прошли итоговую аттестацию / 12.0	2	0	1	0	3	0	0	0	0	0	4	0	0	9	13	0	0	0	4	4
Республика Дагестан	Частные; Очная	"            из стр. 11 – лица с ограниченными возможностями здоровья,
            инвалиды, дети-инвалиды / 13.0"	0	0	0	0	0	0	0	0	0	0	0	0	0	0	0	0	0	0	0	0
Республика Дагестан	Частные; Очная	         отчислено в виде меры дисциплинарного взыскания / 14.0	0	0	0	0	0	0	0	0	0	0	0	0	0	61	61	0	0	0	3	3
Республика Дагестан	Частные; Очная	         отчислено из-за просрочки оплаты обучения / 15.0	0	0	0	13	13	0	0	0	10	10	0	0	0	43	43	0	0	0	63	63
Республика Дагестан	Частные; Очная	"    в том числе:
    переведено на другие формы обучения данной
    организации на программы того же уровня / 7.0"	0	0	0	0	0	0	0	0	0	0	2	0	0	74	76	0	0	0	10	10
Республика Дагестан	Частные; Очная	"    в том числе:
    переведено с других форм обучения данной
    образовательной организации с программ того же уровня / 2.0"	0	0	0	0	0	0	0	0	0	0	1	0	0	81	82	0	0	0	5	5
Республика Дагестан	Частные; Очная	    восстановлены из числа ранее отчисленных / 4.0	1	0	0	0	1	0	0	0	0	0	0	0	0	55	55	0	0	0	9	9
Республика Дагестан	Частные; Очная	    выбыло по другим причинам / 16.0	2	0	0	0	2	0	0	0	0	0	0	0	0	714	714	0	0	0	56	56
Республика Дагестан	Частные; Очная	"    добровольно прекратили образовательные отношения
    (бросили учебу) / 10.0"	0	0	0	1	1	0	0	0	1	1	3	0	0	179	182	0	0	0	86	86
Республика Дагестан	Частные; Очная	"    отчислено:
         по неуспеваемости / 11.0"	2	0	1	0	3	0	0	0	5	5	12	0	0	132	144	0	0	0	38	38
Республика Дагестан	Частные; Очная	"    переведено в другие образовательные организации
    на программы того же уровня / 8.0"	0	0	0	0	0	0	0	0	65	65	1	0	0	243	244	0	0	0	71	71
Республика Дагестан	Частные; Очная	"    переведено из других образовательных организаций 
    с программ того же уровня / 3.0"	1	0	0	28	29	0	0	0	1	1	3	0	0	1732	1735	0	0	0	319	319
Республика Дагестан	Частные; Очная	    по болезни / 9.0	0	0	0	0	0	0	0	0	0	0	0	0	0	4	4	0	0	0	2	2
Республика Дагестан	Частные; Очная	    прибыло по другим причинам / 5.0	0	0	0	53	53	0	0	0	28	28	125	0	0	936	1061	0	0	0	156	156
Республика Дагестан	Частные; Очная	Выбыло студентов - всего (сумма стр. 07-11, 13-15) / 6.0	4	0	1	14	19	0	0	0	81	81	18	0	0	1450	1468	0	0	0	329	329
Республика Дагестан	Частные; Очная	Прибыло студентов - всего (сумма стр. 02-05) / 1.0	2	0	0	81	83	0	0	0	29	29	129	0	0	2804	2933	0	0	0	489	489
Республика Дагестан	Частные; Очная	"Численность студентов на начало прошлого учебного года
(на 1 октября) / 17.0"	143	0	34	33	210	0	0	0	191	191	274	0	0	12014	12288	0	0	0	3182	3182
Республика Дагестан	Частные; Очно-заочная	            из стр. 11 - не прошли итоговую аттестацию / 12.0	0	0	0	0	0	0	0	0	0	0	0	0	0	0	0	0	0	0	0	0
Республика Дагестан	Частные; Очно-заочная	"            из стр. 11 – лица с ограниченными возможностями здоровья,
            инвалиды, дети-инвалиды / 13.0"	0	0	0	0	0	0	0	0	0	0	0	0	0	0	0	0	0	0	0	0
Республика Дагестан	Частные; Очно-заочная	         отчислено в виде меры дисциплинарного взыскания / 14.0	0	0	0	0	0	0	0	0	0	0	0	0	0	0	0	0	0	0	0	0
Республика Дагестан	Частные; Очно-заочная	         отчислено из-за просрочки оплаты обучения / 15.0	0	0	0	0	0	0	0	0	0	0	0	0	0	27	27	0	0	0	0	0
Республика Дагестан	Частные; Очно-заочная	"    в том числе:
    переведено на другие формы обучения данной
    организации на программы того же уровня / 7.0"	0	0	0	0	0	0	0	0	0	0	0	0	0	40	40	0	0	0	0	0
Республика Дагестан	Частные; Очно-заочная	"    в том числе:
    переведено с других форм обучения данной
    образовательной организации с программ того же уровня / 2.0"	0	0	0	0	0	0	0	0	0	0	0	0	0	1	1	0	0	0	0	0
Республика Дагестан	Частные; Очно-заочная	    восстановлены из числа ранее отчисленных / 4.0	0	0	0	0	0	0	0	0	0	0	0	0	0	0	0	0	0	0	0	0
Республика Дагестан	Частные; Очно-заочная	    выбыло по другим причинам / 16.0	0	0	0	7	7	0	0	0	0	0	0	0	0	5	5	0	0	0	1	1
Республика Дагестан	Частные; Очно-заочная	"    добровольно прекратили образовательные отношения
    (бросили учебу) / 10.0"	0	0	0	10	10	0	0	0	0	0	0	0	0	11	11	0	0	0	1	1
Республика Дагестан	Частные; Очно-заочная	"    отчислено:
         по неуспеваемости / 11.0"	0	0	0	0	0	0	0	0	0	0	0	0	0	0	0	0	0	0	0	0
Республика Дагестан	Частные; Очно-заочная	"    переведено в другие образовательные организации
    на программы того же уровня / 8.0"	0	0	0	0	0	0	0	0	0	0	0	0	0	10	10	0	0	0	21	21
Республика Дагестан	Частные; Очно-заочная	"    переведено из других образовательных организаций 
    с программ того же уровня / 3.0"	0	0	0	0	0	0	0	0	0	0	0	0	0	318	318	0	0	0	294	294
Республика Дагестан	Частные; Очно-заочная	    по болезни / 9.0	0	0	0	0	0	0	0	0	0	0	0	0	0	0	0	0	0	0	0	0
Республика Дагестан	Частные; Очно-заочная	    прибыло по другим причинам / 5.0	0	0	0	7	7	0	0	0	0	0	0	0	0	10	10	0	0	0	2	2
Республика Дагестан	Частные; Очно-заочная	Выбыло студентов - всего (сумма стр. 07-11, 13-15) / 6.0	0	0	0	17	17	0	0	0	0	0	0	0	0	93	93	0	0	0	23	23
Республика Дагестан	Частные; Очно-заочная	Прибыло студентов - всего (сумма стр. 02-05) / 1.0	0	0	0	7	7	0	0	0	0	0	0	0	0	329	329	0	0	0	296	296
Республика Дагестан	Частные; Очно-заочная	"Численность студентов на начало прошлого учебного года
(на 1 октября) / 17.0"	0	0	0	10	10	0	0	0	0	0	0	0	0	137	137	0	0	0	265	265
Республика Ингушетия	Государственные, муниципальные (без учета организаций в ведении ФСИН); Заочная	            из стр. 11 - не прошли итоговую аттестацию / 12.0	0	0	0	0	0	0	0	0	0	0	2	0	0	0	2	1	0	0	0	1
Республика Ингушетия	Государственные, муниципальные (без учета организаций в ведении ФСИН); Заочная	"            из стр. 11 – лица с ограниченными возможностями здоровья,
            инвалиды, дети-инвалиды / 13.0"	0	0	0	0	0	0	0	0	0	0	0	0	0	0	0	0	0	0	0	0
Республика Ингушетия	Государственные, муниципальные (без учета организаций в ведении ФСИН); Заочная	         отчислено в виде меры дисциплинарного взыскания / 14.0	0	0	0	0	0	0	0	0	0	0	0	0	0	0	0	0	0	0	0	0
Республика Ингушетия	Государственные, муниципальные (без учета организаций в ведении ФСИН); Заочная	         отчислено из-за просрочки оплаты обучения / 15.0	0	0	0	0	0	0	0	0	0	0	0	0	0	0	0	0	0	0	0	0
Республика Ингушетия	Государственные, муниципальные (без учета организаций в ведении ФСИН); Заочная	"    в том числе:
    переведено на другие формы обучения данной
    организации на программы того же уровня / 7.0"	0	0	0	0	0	0	0	0	0	0	43	0	0	0	43	1	0	0	0	1
Республика Ингушетия	Государственные, муниципальные (без учета организаций в ведении ФСИН); Заочная	"    в том числе:
    переведено с других форм обучения данной
    образовательной организации с программ того же уровня / 2.0"	0	0	0	0	0	0	0	0	0	0	70	0	0	0	70	28	0	0	0	28
Республика Ингушетия	Государственные, муниципальные (без учета организаций в ведении ФСИН); Заочная	    восстановлены из числа ранее отчисленных / 4.0	0	0	0	0	0	0	0	0	0	0	0	0	0	0	0	18	0	0	0	18
Республика Ингушетия	Государственные, муниципальные (без учета организаций в ведении ФСИН); Заочная	    выбыло по другим причинам / 16.0	0	0	0	0	0	0	0	0	0	0	1	0	0	0	1	9	0	0	0	9
Республика Ингушетия	Государственные, муниципальные (без учета организаций в ведении ФСИН); Заочная	"    добровольно прекратили образовательные отношения
    (бросили учебу) / 10.0"	0	0	0	0	0	0	0	0	0	0	0	0	0	0	0	14	0	0	0	14
Республика Ингушетия	Государственные, муниципальные (без учета организаций в ведении ФСИН); Заочная	"    отчислено:
         по неуспеваемости / 11.0"	0	0	0	0	0	0	0	0	0	0	82	0	0	26	108	4	0	0	21	25
Республика Ингушетия	Государственные, муниципальные (без учета организаций в ведении ФСИН); Заочная	"    переведено в другие образовательные организации
    на программы того же уровня / 8.0"	0	0	0	0	0	0	0	0	0	0	2	0	0	0	2	0	0	0	0	0
Республика Ингушетия	Государственные, муниципальные (без учета организаций в ведении ФСИН); Заочная	"    переведено из других образовательных организаций 
    с программ того же уровня / 3.0"	0	0	0	0	0	0	0	0	0	0	3	0	0	0	3	25	0	0	0	25
Республика Ингушетия	Государственные, муниципальные (без учета организаций в ведении ФСИН); Заочная	    по болезни / 9.0	0	0	0	0	0	0	0	0	0	0	0	0	0	0	0	0	0	0	0	0
Республика Ингушетия	Государственные, муниципальные (без учета организаций в ведении ФСИН); Заочная	    прибыло по другим причинам / 5.0	0	0	0	0	0	0	0	0	0	0	0	0	0	0	0	21	0	0	0	21
Республика Ингушетия	Государственные, муниципальные (без учета организаций в ведении ФСИН); Заочная	Выбыло студентов - всего (сумма стр. 07-11, 13-15) / 6.0	0	0	0	0	0	0	0	0	0	0	128	0	0	26	154	28	0	0	21	49
Республика Ингушетия	Государственные, муниципальные (без учета организаций в ведении ФСИН); Заочная	Прибыло студентов - всего (сумма стр. 02-05) / 1.0	0	0	0	0	0	0	0	0	0	0	73	0	0	0	73	92	0	0	0	92
Республика Ингушетия	Государственные, муниципальные (без учета организаций в ведении ФСИН); Заочная	"Численность студентов на начало прошлого учебного года
(на 1 октября) / 17.0"	0	0	0	0	0	0	0	0	0	0	413	0	0	459	872	1116	0	0	305	1421
Республика Ингушетия	Государственные, муниципальные (без учета организаций в ведении ФСИН); Очная	            из стр. 11 - не прошли итоговую аттестацию / 12.0	0	0	0	0	0	0	0	0	0	0	2	0	0	0	2	0	0	0	0	0
Республика Ингушетия	Государственные, муниципальные (без учета организаций в ведении ФСИН); Очная	"            из стр. 11 – лица с ограниченными возможностями здоровья,
            инвалиды, дети-инвалиды / 13.0"	0	0	0	0	0	0	0	0	0	0	0	0	0	0	0	0	0	0	0	0
Республика Ингушетия	Государственные, муниципальные (без учета организаций в ведении ФСИН); Очная	         отчислено в виде меры дисциплинарного взыскания / 14.0	0	0	0	0	0	0	0	0	0	0	0	0	0	0	0	0	0	0	0	0
Республика Ингушетия	Государственные, муниципальные (без учета организаций в ведении ФСИН); Очная	         отчислено из-за просрочки оплаты обучения / 15.0	0	0	0	0	0	0	0	0	0	0	0	0	0	0	0	0	0	0	1	1
Республика Ингушетия	Государственные, муниципальные (без учета организаций в ведении ФСИН); Очная	"    в том числе:
    переведено на другие формы обучения данной
    организации на программы того же уровня / 7.0"	0	0	0	0	0	0	0	0	0	0	90	0	0	0	90	6	0	0	1	7
Республика Ингушетия	Государственные, муниципальные (без учета организаций в ведении ФСИН); Очная	"    в том числе:
    переведено с других форм обучения данной
    образовательной организации с программ того же уровня / 2.0"	0	0	0	0	0	0	0	0	0	0	42	0	0	0	42	0	0	0	0	0
Республика Ингушетия	Государственные, муниципальные (без учета организаций в ведении ФСИН); Очная	    восстановлены из числа ранее отчисленных / 4.0	0	0	0	0	0	0	0	0	0	0	2	0	0	1	3	0	0	0	1	1
Республика Ингушетия	Государственные, муниципальные (без учета организаций в ведении ФСИН); Очная	    выбыло по другим причинам / 16.0	5	0	0	0	5	5	0	0	0	5	70	0	0	6	76	9	0	0	1	10
Республика Ингушетия	Государственные, муниципальные (без учета организаций в ведении ФСИН); Очная	"    добровольно прекратили образовательные отношения
    (бросили учебу) / 10.0"	0	0	0	0	0	4	0	0	0	4	24	0	1	26	51	11	0	0	1	12
Республика Ингушетия	Государственные, муниципальные (без учета организаций в ведении ФСИН); Очная	"    отчислено:
         по неуспеваемости / 11.0"	3	0	0	0	3	0	0	0	0	0	25	0	4	63	92	2	0	0	2	4
Республика Ингушетия	Государственные, муниципальные (без учета организаций в ведении ФСИН); Очная	"    переведено в другие образовательные организации
    на программы того же уровня / 8.0"	3	0	0	0	3	0	0	0	0	0	23	0	0	24	47	0	0	0	0	0
Республика Ингушетия	Государственные, муниципальные (без учета организаций в ведении ФСИН); Очная	"    переведено из других образовательных организаций 
    с программ того же уровня / 3.0"	8	0	0	0	8	0	0	0	0	0	35	0	8	16	59	0	0	0	2	2
Республика Ингушетия	Государственные, муниципальные (без учета организаций в ведении ФСИН); Очная	    по болезни / 9.0	0	0	0	0	0	0	0	0	0	0	12	0	0	0	12	0	0	0	0	0
Республика Ингушетия	Государственные, муниципальные (без учета организаций в ведении ФСИН); Очная	    прибыло по другим причинам / 5.0	3	0	0	0	3	0	0	0	0	0	17	0	0	3	20	4	0	0	5	9
Республика Ингушетия	Государственные, муниципальные (без учета организаций в ведении ФСИН); Очная	Выбыло студентов - всего (сумма стр. 07-11, 13-15) / 6.0	11	0	0	0	11	9	0	0	0	9	244	0	5	119	368	28	0	0	6	34
Республика Ингушетия	Государственные, муниципальные (без учета организаций в ведении ФСИН); Очная	Прибыло студентов - всего (сумма стр. 02-05) / 1.0	11	0	0	0	11	0	0	0	0	0	96	0	8	20	124	4	0	0	8	12
Республика Ингушетия	Государственные, муниципальные (без учета организаций в ведении ФСИН); Очная	"Численность студентов на начало прошлого учебного года
(на 1 октября) / 17.0"	1079	0	0	0	1079	405	0	0	0	405	3258	0	731	1583	5572	1100	0	0	177	1277
Республика Ингушетия	Очно-заочная; Государственные, муниципальные (без учета организаций в ведении ФСИН)	            из стр. 11 - не прошли итоговую аттестацию / 12.0	0	0	0	0	0	0	0	0	0	0	0	0	0	0	0	0	0	0	0	0
Республика Ингушетия	Очно-заочная; Государственные, муниципальные (без учета организаций в ведении ФСИН)	"            из стр. 11 – лица с ограниченными возможностями здоровья,
            инвалиды, дети-инвалиды / 13.0"	0	0	0	0	0	0	0	0	0	0	0	0	0	0	0	0	0	0	0	0
Республика Ингушетия	Очно-заочная; Государственные, муниципальные (без учета организаций в ведении ФСИН)	         отчислено в виде меры дисциплинарного взыскания / 14.0	0	0	0	0	0	0	0	0	0	0	0	0	0	0	0	0	0	0	0	0
Республика Ингушетия	Очно-заочная; Государственные, муниципальные (без учета организаций в ведении ФСИН)	         отчислено из-за просрочки оплаты обучения / 15.0	0	0	0	0	0	0	0	0	0	0	0	0	0	0	0	0	0	0	0	0
Республика Ингушетия	Очно-заочная; Государственные, муниципальные (без учета организаций в ведении ФСИН)	"    в том числе:
    переведено на другие формы обучения данной
    организации на программы того же уровня / 7.0"	0	0	0	0	0	0	0	0	0	0	0	0	0	0	0	0	0	0	0	0
Республика Ингушетия	Очно-заочная; Государственные, муниципальные (без учета организаций в ведении ФСИН)	"    в том числе:
    переведено с других форм обучения данной
    образовательной организации с программ того же уровня / 2.0"	0	0	0	0	0	0	0	0	0	0	0	0	0	0	0	0	0	0	0	0
Республика Ингушетия	Очно-заочная; Государственные, муниципальные (без учета организаций в ведении ФСИН)	    восстановлены из числа ранее отчисленных / 4.0	0	0	0	0	0	0	0	0	0	0	0	0	0	0	0	0	0	0	0	0
Республика Ингушетия	Очно-заочная; Государственные, муниципальные (без учета организаций в ведении ФСИН)	    выбыло по другим причинам / 16.0	0	0	0	0	0	0	0	0	0	0	0	0	0	0	0	0	0	0	0	0
Республика Ингушетия	Очно-заочная; Государственные, муниципальные (без учета организаций в ведении ФСИН)	"    добровольно прекратили образовательные отношения
    (бросили учебу) / 10.0"	0	0	0	0	0	0	0	0	0	0	0	0	0	0	0	0	0	0	0	0
Республика Ингушетия	Очно-заочная; Государственные, муниципальные (без учета организаций в ведении ФСИН)	"    отчислено:
         по неуспеваемости / 11.0"	0	0	0	0	0	0	0	0	0	0	0	0	0	0	0	0	0	0	0	0
Республика Ингушетия	Очно-заочная; Государственные, муниципальные (без учета организаций в ведении ФСИН)	"    переведено в другие образовательные организации
    на программы того же уровня / 8.0"	0	0	0	0	0	0	0	0	0	0	0	0	0	0	0	0	0	0	0	0
Республика Ингушетия	Очно-заочная; Государственные, муниципальные (без учета организаций в ведении ФСИН)	"    переведено из других образовательных организаций 
    с программ того же уровня / 3.0"	0	0	0	0	0	0	0	0	0	0	0	0	0	0	0	0	0	0	0	0
Республика Ингушетия	Очно-заочная; Государственные, муниципальные (без учета организаций в ведении ФСИН)	    по болезни / 9.0	0	0	0	0	0	0	0	0	0	0	0	0	0	0	0	0	0	0	0	0
Республика Ингушетия	Очно-заочная; Государственные, муниципальные (без учета организаций в ведении ФСИН)	    прибыло по другим причинам / 5.0	0	0	0	0	0	0	0	0	0	0	0	0	0	0	0	0	0	0	0	0
Республика Ингушетия	Очно-заочная; Государственные, муниципальные (без учета организаций в ведении ФСИН)	Выбыло студентов - всего (сумма стр. 07-11, 13-15) / 6.0	0	0	0	0	0	0	0	0	0	0	0	0	0	0	0	0	0	0	0	0
Республика Ингушетия	Очно-заочная; Государственные, муниципальные (без учета организаций в ведении ФСИН)	Прибыло студентов - всего (сумма стр. 02-05) / 1.0	0	0	0	0	0	0	0	0	0	0	0	0	0	0	0	0	0	0	0	0
Республика Ингушетия	Очно-заочная; Государственные, муниципальные (без учета организаций в ведении ФСИН)	"Численность студентов на начало прошлого учебного года
(на 1 октября) / 17.0"	0	0	0	0	0	25	0	0	0	25	0	0	0	0	0	0	0	0	0	0
Республика Ингушетия	Частные; Заочная	            из стр. 11 - не прошли итоговую аттестацию / 12.0	0	0	0	0	0	0	0	0	0	0	0	0	0	0	0	0	0	0	0	0
Республика Ингушетия	Частные; Заочная	"            из стр. 11 – лица с ограниченными возможностями здоровья,
            инвалиды, дети-инвалиды / 13.0"	0	0	0	0	0	0	0	0	0	0	0	0	0	0	0	0	0	0	0	0
Республика Ингушетия	Частные; Заочная	         отчислено в виде меры дисциплинарного взыскания / 14.0	0	0	0	0	0	0	0	0	0	0	0	0	0	5	5	0	0	0	0	0
Республика Ингушетия	Частные; Заочная	         отчислено из-за просрочки оплаты обучения / 15.0	0	0	0	0	0	0	0	0	0	0	0	0	0	21	21	0	0	0	6	6
Республика Ингушетия	Частные; Заочная	"    в том числе:
    переведено на другие формы обучения данной
    организации на программы того же уровня / 7.0"	0	0	0	0	0	0	0	0	0	0	0	0	0	23	23	0	0	0	6	6
Республика Ингушетия	Частные; Заочная	"    в том числе:
    переведено с других форм обучения данной
    образовательной организации с программ того же уровня / 2.0"	0	0	0	0	0	0	0	0	0	0	0	0	0	21	21	0	0	0	6	6
Республика Ингушетия	Частные; Заочная	    восстановлены из числа ранее отчисленных / 4.0	0	0	0	0	0	0	0	0	0	0	0	0	0	9	9	0	0	0	6	6
Республика Ингушетия	Частные; Заочная	    выбыло по другим причинам / 16.0	0	0	0	0	0	0	0	0	0	0	0	0	0	21	21	0	0	0	11	11
Республика Ингушетия	Частные; Заочная	"    добровольно прекратили образовательные отношения
    (бросили учебу) / 10.0"	0	0	0	0	0	0	0	0	0	0	0	0	0	10	10	0	0	0	4	4
Республика Ингушетия	Частные; Заочная	"    отчислено:
         по неуспеваемости / 11.0"	0	0	0	0	0	0	0	0	0	0	0	0	0	47	47	0	0	0	21	21
Республика Ингушетия	Частные; Заочная	"    переведено в другие образовательные организации
    на программы того же уровня / 8.0"	0	0	0	0	0	0	0	0	0	0	0	0	0	15	15	0	0	0	7	7
Республика Ингушетия	Частные; Заочная	"    переведено из других образовательных организаций 
    с программ того же уровня / 3.0"	0	0	0	0	0	0	0	0	0	0	0	0	0	17	17	0	0	0	6	6
Республика Ингушетия	Частные; Заочная	    по болезни / 9.0	0	0	0	0	0	0	0	0	0	0	0	0	0	4	4	0	0	0	0	0
Республика Ингушетия	Частные; Заочная	    прибыло по другим причинам / 5.0	0	0	0	0	0	0	0	0	0	0	0	0	0	18	18	0	0	0	4	4
Республика Ингушетия	Частные; Заочная	Выбыло студентов - всего (сумма стр. 07-11, 13-15) / 6.0	0	0	0	0	0	0	0	0	0	0	0	0	0	146	146	0	0	0	55	55
Республика Ингушетия	Частные; Заочная	Прибыло студентов - всего (сумма стр. 02-05) / 1.0	0	0	0	0	0	0	0	0	0	0	0	0	0	65	65	0	0	0	22	22
Республика Ингушетия	Частные; Заочная	"Численность студентов на начало прошлого учебного года
(на 1 октября) / 17.0"	0	0	0	0	0	0	0	0	0	0	0	0	0	384	384	0	0	0	179	179
Республика Ингушетия	Частные; Очная	            из стр. 11 - не прошли итоговую аттестацию / 12.0	0	0	0	0	0	0	0	0	0	0	0	0	0	0	0	0	0	0	0	0
Республика Ингушетия	Частные; Очная	"            из стр. 11 – лица с ограниченными возможностями здоровья,
            инвалиды, дети-инвалиды / 13.0"	0	0	0	0	0	0	0	0	0	0	0	0	0	0	0	0	0	0	0	0
Республика Ингушетия	Частные; Очная	         отчислено в виде меры дисциплинарного взыскания / 14.0	0	0	0	0	0	0	0	0	0	0	0	0	0	17	17	0	0	0	5	5
Республика Ингушетия	Частные; Очная	         отчислено из-за просрочки оплаты обучения / 15.0	0	0	0	0	0	0	0	0	0	0	0	0	0	135	135	0	0	0	8	8
Республика Ингушетия	Частные; Очная	"    в том числе:
    переведено на другие формы обучения данной
    организации на программы того же уровня / 7.0"	0	0	0	0	0	0	0	0	0	0	0	0	0	21	21	0	0	0	6	6
Республика Ингушетия	Частные; Очная	"    в том числе:
    переведено с других форм обучения данной
    образовательной организации с программ того же уровня / 2.0"	0	0	0	0	0	0	0	0	0	0	0	0	0	97	97	0	0	0	6	6
Республика Ингушетия	Частные; Очная	    восстановлены из числа ранее отчисленных / 4.0	0	0	0	0	0	0	0	0	0	0	0	0	0	24	24	0	0	0	5	5
Республика Ингушетия	Частные; Очная	    выбыло по другим причинам / 16.0	0	0	0	0	0	0	0	0	0	0	0	0	0	176	176	0	0	0	43	43
Республика Ингушетия	Частные; Очная	"    добровольно прекратили образовательные отношения
    (бросили учебу) / 10.0"	0	0	0	0	0	0	0	0	0	0	0	0	0	62	62	0	0	0	6	6
Республика Ингушетия	Частные; Очная	"    отчислено:
         по неуспеваемости / 11.0"	0	0	0	0	0	0	0	0	0	0	0	0	0	127	127	0	0	0	27	27
Республика Ингушетия	Частные; Очная	"    переведено в другие образовательные организации
    на программы того же уровня / 8.0"	0	0	0	0	0	0	0	0	0	0	0	0	0	88	88	0	0	0	50	50
Республика Ингушетия	Частные; Очная	"    переведено из других образовательных организаций 
    с программ того же уровня / 3.0"	0	0	0	0	0	0	0	0	0	0	0	0	0	71	71	0	0	0	29	29
Республика Ингушетия	Частные; Очная	    по болезни / 9.0	0	0	0	0	0	0	0	0	0	0	0	0	0	3	3	0	0	0	0	0
Республика Ингушетия	Частные; Очная	    прибыло по другим причинам / 5.0	0	0	0	0	0	0	0	0	100	100	0	0	0	306	306	0	0	0	84	84
Республика Ингушетия	Частные; Очная	Выбыло студентов - всего (сумма стр. 07-11, 13-15) / 6.0	0	0	0	0	0	0	0	0	0	0	0	0	0	629	629	0	0	0	145	145
Республика Ингушетия	Частные; Очная	Прибыло студентов - всего (сумма стр. 02-05) / 1.0	0	0	0	0	0	0	0	0	100	100	0	0	0	498	498	0	0	0	124	124
Республика Ингушетия	Частные; Очная	"Численность студентов на начало прошлого учебного года
(на 1 октября) / 17.0"	0	0	0	0	0	0	0	0	211	211	0	0	0	2268	2268	0	0	0	646	646
Республика Ингушетия	Частные; Очно-заочная	            из стр. 11 - не прошли итоговую аттестацию / 12.0	0	0	0	0	0	0	0	0	0	0	0	0	0	0	0	0	0	0	0	0
Республика Ингушетия	Частные; Очно-заочная	"            из стр. 11 – лица с ограниченными возможностями здоровья,
            инвалиды, дети-инвалиды / 13.0"	0	0	0	0	0	0	0	0	0	0	0	0	0	0	0	0	0	0	0	0
Республика Ингушетия	Частные; Очно-заочная	         отчислено в виде меры дисциплинарного взыскания / 14.0	0	0	0	0	0	0	0	0	0	0	0	0	0	0	0	0	0	0	0	0
Республика Ингушетия	Частные; Очно-заочная	         отчислено из-за просрочки оплаты обучения / 15.0	0	0	0	0	0	0	0	0	0	0	0	0	0	1	1	0	0	0	0	0
Республика Ингушетия	Частные; Очно-заочная	"    в том числе:
    переведено на другие формы обучения данной
    организации на программы того же уровня / 7.0"	0	0	0	0	0	0	0	0	0	0	0	0	0	0	0	0	0	0	0	0
Республика Ингушетия	Частные; Очно-заочная	"    в том числе:
    переведено с других форм обучения данной
    образовательной организации с программ того же уровня / 2.0"	0	0	0	0	0	0	0	0	0	0	0	0	0	0	0	0	0	0	0	0
Республика Ингушетия	Частные; Очно-заочная	    восстановлены из числа ранее отчисленных / 4.0	0	0	0	0	0	0	0	0	0	0	0	0	0	0	0	0	0	0	0	0
Республика Ингушетия	Частные; Очно-заочная	    выбыло по другим причинам / 16.0	0	0	0	0	0	0	0	0	0	0	0	0	0	1	1	0	0	0	0	0
Республика Ингушетия	Частные; Очно-заочная	"    добровольно прекратили образовательные отношения
    (бросили учебу) / 10.0"	0	0	0	0	0	0	0	0	0	0	0	0	0	2	2	0	0	0	1	1
Республика Ингушетия	Частные; Очно-заочная	"    отчислено:
         по неуспеваемости / 11.0"	0	0	0	0	0	0	0	0	0	0	0	0	0	3	3	0	0	0	0	0
Республика Ингушетия	Частные; Очно-заочная	"    переведено в другие образовательные организации
    на программы того же уровня / 8.0"	0	0	0	0	0	0	0	0	0	0	0	0	0	3	3	0	0	0	1	1
Республика Ингушетия	Частные; Очно-заочная	"    переведено из других образовательных организаций 
    с программ того же уровня / 3.0"	0	0	0	0	0	0	0	0	0	0	0	0	0	0	0	0	0	0	0	0
Республика Ингушетия	Частные; Очно-заочная	    по болезни / 9.0	0	0	0	0	0	0	0	0	0	0	0	0	0	0	0	0	0	0	0	0
Республика Ингушетия	Частные; Очно-заочная	    прибыло по другим причинам / 5.0	0	0	0	0	0	0	0	0	0	0	0	0	0	0	0	0	0	0	0	0
Республика Ингушетия	Частные; Очно-заочная	Выбыло студентов - всего (сумма стр. 07-11, 13-15) / 6.0	0	0	0	0	0	0	0	0	0	0	0	0	0	10	10	0	0	0	2	2
Республика Ингушетия	Частные; Очно-заочная	Прибыло студентов - всего (сумма стр. 02-05) / 1.0	0	0	0	0	0	0	0	0	0	0	0	0	0	0	0	0	0	0	0	0
Республика Ингушетия	Частные; Очно-заочная	"Численность студентов на начало прошлого учебного года
(на 1 октября) / 17.0"	0	0	0	0	0	0	0	0	0	0	0	0	0	34	34	0	0	0	4	4
Республика Калмыкия	Государственные, муниципальные (без учета организаций в ведении ФСИН); Заочная	            из стр. 11 - не прошли итоговую аттестацию / 12.0	0	0	0	0	0	0	0	0	0	0	0	0	0	0	0	2	0	0	1	3
Республика Калмыкия	Государственные, муниципальные (без учета организаций в ведении ФСИН); Заочная	"            из стр. 11 – лица с ограниченными возможностями здоровья,
            инвалиды, дети-инвалиды / 13.0"	0	0	0	0	0	0	0	0	0	0	0	0	0	0	0	0	0	0	0	0
Республика Калмыкия	Государственные, муниципальные (без учета организаций в ведении ФСИН); Заочная	         отчислено в виде меры дисциплинарного взыскания / 14.0	0	0	0	0	0	0	0	0	0	0	0	0	0	0	0	0	0	0	0	0
Республика Калмыкия	Государственные, муниципальные (без учета организаций в ведении ФСИН); Заочная	         отчислено из-за просрочки оплаты обучения / 15.0	0	0	0	0	0	0	0	0	0	0	0	0	0	0	0	0	0	0	44	44
Республика Калмыкия	Государственные, муниципальные (без учета организаций в ведении ФСИН); Заочная	"    в том числе:
    переведено на другие формы обучения данной
    организации на программы того же уровня / 7.0"	0	0	0	0	0	0	0	0	0	0	0	0	0	0	0	7	0	0	3	10
Республика Калмыкия	Государственные, муниципальные (без учета организаций в ведении ФСИН); Заочная	"    в том числе:
    переведено с других форм обучения данной
    образовательной организации с программ того же уровня / 2.0"	0	0	0	0	0	0	0	0	0	0	0	0	4	0	4	18	0	0	12	30
Республика Калмыкия	Государственные, муниципальные (без учета организаций в ведении ФСИН); Заочная	    восстановлены из числа ранее отчисленных / 4.0	0	0	0	0	0	0	0	0	0	0	0	0	1	0	1	19	0	0	9	28
Республика Калмыкия	Государственные, муниципальные (без учета организаций в ведении ФСИН); Заочная	    выбыло по другим причинам / 16.0	0	0	0	0	0	0	0	0	0	0	0	0	4	0	4	30	0	0	2	32
Республика Калмыкия	Государственные, муниципальные (без учета организаций в ведении ФСИН); Заочная	"    добровольно прекратили образовательные отношения
    (бросили учебу) / 10.0"	0	0	0	0	0	0	0	0	0	0	0	0	11	22	33	57	0	2	4	63
Республика Калмыкия	Государственные, муниципальные (без учета организаций в ведении ФСИН); Заочная	"    отчислено:
         по неуспеваемости / 11.0"	0	0	0	0	0	0	0	0	0	0	0	0	0	0	0	23	0	2	5	30
Республика Калмыкия	Государственные, муниципальные (без учета организаций в ведении ФСИН); Заочная	"    переведено в другие образовательные организации
    на программы того же уровня / 8.0"	0	0	0	0	0	0	0	0	0	0	0	0	0	0	0	7	0	0	2	9
Республика Калмыкия	Государственные, муниципальные (без учета организаций в ведении ФСИН); Заочная	"    переведено из других образовательных организаций 
    с программ того же уровня / 3.0"	0	0	0	0	0	0	0	0	0	0	0	0	0	5	5	11	0	0	1	12
Республика Калмыкия	Государственные, муниципальные (без учета организаций в ведении ФСИН); Заочная	    по болезни / 9.0	0	0	0	0	0	0	0	0	0	0	0	0	0	0	0	0	0	0	0	0
Республика Калмыкия	Государственные, муниципальные (без учета организаций в ведении ФСИН); Заочная	    прибыло по другим причинам / 5.0	0	0	0	0	0	0	0	0	0	0	0	0	0	0	0	12	0	0	0	12
Республика Калмыкия	Государственные, муниципальные (без учета организаций в ведении ФСИН); Заочная	Выбыло студентов - всего (сумма стр. 07-11, 13-15) / 6.0	0	0	0	0	0	0	0	0	0	0	0	0	15	22	37	124	0	4	60	188
Республика Калмыкия	Государственные, муниципальные (без учета организаций в ведении ФСИН); Заочная	Прибыло студентов - всего (сумма стр. 02-05) / 1.0	0	0	0	0	0	0	0	0	0	0	0	0	5	5	10	60	0	0	22	82
Республика Калмыкия	Государственные, муниципальные (без учета организаций в ведении ФСИН); Заочная	"Численность студентов на начало прошлого учебного года
(на 1 октября) / 17.0"	0	0	0	0	0	0	0	0	0	0	104	0	0	17	121	899	0	55	396	1350
Республика Калмыкия	Государственные, муниципальные (без учета организаций в ведении ФСИН); Очная	            из стр. 11 - не прошли итоговую аттестацию / 12.0	3	0	0	0	3	0	0	2	0	2	2	0	0	1	3	1	0	0	0	1
Республика Калмыкия	Государственные, муниципальные (без учета организаций в ведении ФСИН); Очная	"            из стр. 11 – лица с ограниченными возможностями здоровья,
            инвалиды, дети-инвалиды / 13.0"	0	0	0	0	0	0	0	0	0	0	0	0	0	0	0	0	0	0	0	0
Республика Калмыкия	Государственные, муниципальные (без учета организаций в ведении ФСИН); Очная	         отчислено в виде меры дисциплинарного взыскания / 14.0	0	0	0	0	0	0	0	0	0	0	4	0	0	0	4	1	0	0	0	1
Республика Калмыкия	Государственные, муниципальные (без учета организаций в ведении ФСИН); Очная	         отчислено из-за просрочки оплаты обучения / 15.0	0	0	0	0	0	0	0	0	0	0	0	0	0	1	1	0	0	0	4	4
Республика Калмыкия	Государственные, муниципальные (без учета организаций в ведении ФСИН); Очная	"    в том числе:
    переведено на другие формы обучения данной
    организации на программы того же уровня / 7.0"	7	0	0	0	7	0	0	0	0	0	39	0	0	1	40	6	0	0	0	6
Республика Калмыкия	Государственные, муниципальные (без учета организаций в ведении ФСИН); Очная	"    в том числе:
    переведено с других форм обучения данной
    образовательной организации с программ того же уровня / 2.0"	2	0	0	0	2	0	0	0	0	0	6	0	0	0	6	2	0	0	0	2
Республика Калмыкия	Государственные, муниципальные (без учета организаций в ведении ФСИН); Очная	    восстановлены из числа ранее отчисленных / 4.0	2	0	0	0	2	0	0	0	0	0	14	0	1	2	17	2	0	0	3	5
Республика Калмыкия	Государственные, муниципальные (без учета организаций в ведении ФСИН); Очная	    выбыло по другим причинам / 16.0	54	0	0	0	54	35	0	0	0	35	21	0	4	9	34	50	0	0	4	54
Республика Калмыкия	Государственные, муниципальные (без учета организаций в ведении ФСИН); Очная	"    добровольно прекратили образовательные отношения
    (бросили учебу) / 10.0"	36	0	2	0	38	34	0	4	0	38	78	0	35	46	159	43	0	2	22	67
Республика Калмыкия	Государственные, муниципальные (без учета организаций в ведении ФСИН); Очная	"    отчислено:
         по неуспеваемости / 11.0"	3	0	0	0	3	0	0	2	0	2	27	0	4	17	48	7	0	0	7	14
Республика Калмыкия	Государственные, муниципальные (без учета организаций в ведении ФСИН); Очная	"    переведено в другие образовательные организации
    на программы того же уровня / 8.0"	3	0	1	0	4	0	0	0	0	0	13	0	9	15	37	4	0	0	0	4
Республика Калмыкия	Государственные, муниципальные (без учета организаций в ведении ФСИН); Очная	"    переведено из других образовательных организаций 
    с программ того же уровня / 3.0"	3	0	0	0	3	0	0	0	0	0	10	0	0	16	26	0	0	0	2	2
Республика Калмыкия	Государственные, муниципальные (без учета организаций в ведении ФСИН); Очная	    по болезни / 9.0	6	0	0	0	6	0	0	0	0	0	0	0	0	0	0	0	0	0	0	0
Республика Калмыкия	Государственные, муниципальные (без учета организаций в ведении ФСИН); Очная	    прибыло по другим причинам / 5.0	131	0	0	0	131	142	0	0	0	142	51	0	7	8	66	131	0	2	1	134
Республика Калмыкия	Государственные, муниципальные (без учета организаций в ведении ФСИН); Очная	Выбыло студентов - всего (сумма стр. 07-11, 13-15) / 6.0	109	0	3	0	112	69	0	6	0	75	182	0	52	89	323	111	0	2	37	150
Республика Калмыкия	Государственные, муниципальные (без учета организаций в ведении ФСИН); Очная	Прибыло студентов - всего (сумма стр. 02-05) / 1.0	138	0	0	0	138	142	0	0	0	142	81	0	8	26	115	135	0	2	6	143
Республика Калмыкия	Государственные, муниципальные (без учета организаций в ведении ФСИН); Очная	"Численность студентов на начало прошлого учебного года
(на 1 октября) / 17.0"	391	0	73	0	464	182	0	30	3	215	1896	0	1087	1189	4172	362	0	103	279	744
Республика Калмыкия	Очно-заочная; Государственные, муниципальные (без учета организаций в ведении ФСИН)	            из стр. 11 - не прошли итоговую аттестацию / 12.0	0	0	0	0	0	0	0	0	0	0	0	0	0	0	0	0	0	0	0	0
Республика Калмыкия	Очно-заочная; Государственные, муниципальные (без учета организаций в ведении ФСИН)	"            из стр. 11 – лица с ограниченными возможностями здоровья,
            инвалиды, дети-инвалиды / 13.0"	0	0	0	0	0	0	0	0	0	0	0	0	0	0	0	0	0	0	0	0
Республика Калмыкия	Очно-заочная; Государственные, муниципальные (без учета организаций в ведении ФСИН)	         отчислено в виде меры дисциплинарного взыскания / 14.0	0	0	0	0	0	0	0	0	0	0	0	0	0	0	0	0	0	0	0	0
Республика Калмыкия	Очно-заочная; Государственные, муниципальные (без учета организаций в ведении ФСИН)	         отчислено из-за просрочки оплаты обучения / 15.0	0	0	0	0	0	0	0	0	0	0	0	0	0	0	0	0	0	0	0	0
Республика Калмыкия	Очно-заочная; Государственные, муниципальные (без учета организаций в ведении ФСИН)	"    в том числе:
    переведено на другие формы обучения данной
    организации на программы того же уровня / 7.0"	0	0	0	0	0	0	0	0	0	0	0	0	0	0	0	0	0	0	0	0
Республика Калмыкия	Очно-заочная; Государственные, муниципальные (без учета организаций в ведении ФСИН)	"    в том числе:
    переведено с других форм обучения данной
    образовательной организации с программ того же уровня / 2.0"	0	0	0	0	0	0	0	0	0	0	0	0	0	0	0	0	0	0	0	0
Республика Калмыкия	Очно-заочная; Государственные, муниципальные (без учета организаций в ведении ФСИН)	    восстановлены из числа ранее отчисленных / 4.0	0	0	0	0	0	0	0	0	0	0	0	0	0	0	0	0	0	0	2	2
Республика Калмыкия	Очно-заочная; Государственные, муниципальные (без учета организаций в ведении ФСИН)	    выбыло по другим причинам / 16.0	0	0	0	0	0	0	0	0	0	0	0	0	0	0	0	0	0	0	0	0
Республика Калмыкия	Очно-заочная; Государственные, муниципальные (без учета организаций в ведении ФСИН)	"    добровольно прекратили образовательные отношения
    (бросили учебу) / 10.0"	0	0	0	0	0	0	0	0	0	0	0	0	0	0	0	0	0	0	14	14
Республика Калмыкия	Очно-заочная; Государственные, муниципальные (без учета организаций в ведении ФСИН)	"    отчислено:
         по неуспеваемости / 11.0"	0	0	0	0	0	1	0	0	0	1	0	0	0	0	0	0	0	0	5	5
Республика Калмыкия	Очно-заочная; Государственные, муниципальные (без учета организаций в ведении ФСИН)	"    переведено в другие образовательные организации
    на программы того же уровня / 8.0"	0	0	0	0	0	0	0	0	0	0	0	0	0	0	0	0	0	0	0	0
Республика Калмыкия	Очно-заочная; Государственные, муниципальные (без учета организаций в ведении ФСИН)	"    переведено из других образовательных организаций 
    с программ того же уровня / 3.0"	0	0	0	0	0	0	0	0	0	0	0	0	0	0	0	0	0	0	0	0
Республика Калмыкия	Очно-заочная; Государственные, муниципальные (без учета организаций в ведении ФСИН)	    по болезни / 9.0	0	0	0	0	0	0	0	0	0	0	0	0	0	0	0	0	0	0	0	0
Республика Калмыкия	Очно-заочная; Государственные, муниципальные (без учета организаций в ведении ФСИН)	    прибыло по другим причинам / 5.0	0	0	0	0	0	0	0	0	0	0	0	0	0	0	0	0	0	0	0	0
Республика Калмыкия	Очно-заочная; Государственные, муниципальные (без учета организаций в ведении ФСИН)	Выбыло студентов - всего (сумма стр. 07-11, 13-15) / 6.0	0	0	0	0	0	1	0	0	0	1	0	0	0	0	0	0	0	0	19	19
Республика Калмыкия	Очно-заочная; Государственные, муниципальные (без учета организаций в ведении ФСИН)	Прибыло студентов - всего (сумма стр. 02-05) / 1.0	0	0	0	0	0	0	0	0	0	0	0	0	0	0	0	0	0	0	2	2
Республика Калмыкия	Очно-заочная; Государственные, муниципальные (без учета организаций в ведении ФСИН)	"Численность студентов на начало прошлого учебного года
(на 1 октября) / 17.0"	0	0	0	0	0	13	0	0	0	13	0	0	0	0	0	0	0	0	281	281
Республика Калмыкия	Частные; Заочная	            из стр. 11 - не прошли итоговую аттестацию / 12.0	0	0	0	0	0	0	0	0	0	0	0	0	0	0	0	0	0	0	0	0
Республика Калмыкия	Частные; Заочная	"            из стр. 11 – лица с ограниченными возможностями здоровья,
            инвалиды, дети-инвалиды / 13.0"	0	0	0	0	0	0	0	0	0	0	0	0	0	0	0	0	0	0	0	0
Республика Калмыкия	Частные; Заочная	         отчислено в виде меры дисциплинарного взыскания / 14.0	0	0	0	0	0	0	0	0	0	0	0	0	0	0	0	0	0	0	0	0
Республика Калмыкия	Частные; Заочная	         отчислено из-за просрочки оплаты обучения / 15.0	0	0	0	0	0	0	0	0	0	0	0	0	0	0	0	0	0	0	0	0
Республика Калмыкия	Частные; Заочная	"    в том числе:
    переведено на другие формы обучения данной
    организации на программы того же уровня / 7.0"	0	0	0	0	0	0	0	0	0	0	0	0	0	8	8	0	0	0	3	3
Республика Калмыкия	Частные; Заочная	"    в том числе:
    переведено с других форм обучения данной
    образовательной организации с программ того же уровня / 2.0"	0	0	0	0	0	0	0	0	0	0	0	0	0	3	3	0	0	0	0	0
Республика Калмыкия	Частные; Заочная	    восстановлены из числа ранее отчисленных / 4.0	0	0	0	0	0	0	0	0	0	0	0	0	0	0	0	0	0	0	0	0
Республика Калмыкия	Частные; Заочная	    выбыло по другим причинам / 16.0	0	0	0	0	0	0	0	0	0	0	0	0	0	19	19	0	0	0	13	13
Республика Калмыкия	Частные; Заочная	"    добровольно прекратили образовательные отношения
    (бросили учебу) / 10.0"	0	0	0	0	0	0	0	0	0	0	0	0	0	13	13	0	0	0	3	3
Республика Калмыкия	Частные; Заочная	"    отчислено:
         по неуспеваемости / 11.0"	0	0	0	0	0	0	0	0	0	0	0	0	0	0	0	0	0	0	0	0
Республика Калмыкия	Частные; Заочная	"    переведено в другие образовательные организации
    на программы того же уровня / 8.0"	0	0	0	0	0	0	0	0	0	0	0	0	0	1	1	0	0	0	0	0
Республика Калмыкия	Частные; Заочная	"    переведено из других образовательных организаций 
    с программ того же уровня / 3.0"	0	0	0	0	0	0	0	0	0	0	0	0	0	1	1	0	0	0	0	0
Республика Калмыкия	Частные; Заочная	    по болезни / 9.0	0	0	0	0	0	0	0	0	0	0	0	0	0	0	0	0	0	0	0	0
Республика Калмыкия	Частные; Заочная	    прибыло по другим причинам / 5.0	0	0	0	0	0	0	0	0	0	0	0	0	0	0	0	0	0	0	0	0
Республика Калмыкия	Частные; Заочная	Выбыло студентов - всего (сумма стр. 07-11, 13-15) / 6.0	0	0	0	0	0	0	0	0	0	0	0	0	0	41	41	0	0	0	19	19
Республика Калмыкия	Частные; Заочная	Прибыло студентов - всего (сумма стр. 02-05) / 1.0	0	0	0	0	0	0	0	0	0	0	0	0	0	4	4	0	0	0	0	0
Республика Калмыкия	Частные; Заочная	"Численность студентов на начало прошлого учебного года
(на 1 октября) / 17.0"	0	0	0	0	0	0	0	0	0	0	0	0	0	80	80	0	0	0	32	32
Республика Калмыкия	Частные; Очная	            из стр. 11 - не прошли итоговую аттестацию / 12.0	0	0	0	0	0	0	0	0	0	0	0	0	0	0	0	0	0	0	0	0
Республика Калмыкия	Частные; Очная	"            из стр. 11 – лица с ограниченными возможностями здоровья,
            инвалиды, дети-инвалиды / 13.0"	0	0	0	0	0	0	0	0	0	0	0	0	0	0	0	0	0	0	0	0
Республика Калмыкия	Частные; Очная	         отчислено в виде меры дисциплинарного взыскания / 14.0	0	0	0	0	0	0	0	0	0	0	0	0	0	0	0	0	0	0	0	0
Республика Калмыкия	Частные; Очная	         отчислено из-за просрочки оплаты обучения / 15.0	0	0	0	0	0	0	0	0	0	0	0	0	0	0	0	0	0	0	0	0
Республика Калмыкия	Частные; Очная	"    в том числе:
    переведено на другие формы обучения данной
    организации на программы того же уровня / 7.0"	0	0	0	0	0	0	0	0	0	0	0	0	0	3	3	0	0	0	0	0
Республика Калмыкия	Частные; Очная	"    в том числе:
    переведено с других форм обучения данной
    образовательной организации с программ того же уровня / 2.0"	0	0	0	0	0	0	0	0	0	0	0	0	0	8	8	0	0	0	3	3
Республика Калмыкия	Частные; Очная	    восстановлены из числа ранее отчисленных / 4.0	0	0	0	0	0	0	0	0	0	0	0	0	0	0	0	0	0	0	0	0
Республика Калмыкия	Частные; Очная	    выбыло по другим причинам / 16.0	0	0	0	0	0	0	0	0	0	0	0	0	0	8	8	0	0	0	0	0
Республика Калмыкия	Частные; Очная	"    добровольно прекратили образовательные отношения
    (бросили учебу) / 10.0"	0	0	0	0	0	0	0	0	0	0	0	0	0	2	2	0	0	0	2	2
Республика Калмыкия	Частные; Очная	"    отчислено:
         по неуспеваемости / 11.0"	0	0	0	0	0	0	0	0	0	0	0	0	0	0	0	0	0	0	0	0
Республика Калмыкия	Частные; Очная	"    переведено в другие образовательные организации
    на программы того же уровня / 8.0"	0	0	0	0	0	0	0	0	0	0	0	0	0	0	0	0	0	0	0	0
Республика Калмыкия	Частные; Очная	"    переведено из других образовательных организаций 
    с программ того же уровня / 3.0"	0	0	0	0	0	0	0	0	0	0	0	0	0	0	0	0	0	0	0	0
Республика Калмыкия	Частные; Очная	    по болезни / 9.0	0	0	0	0	0	0	0	0	0	0	0	0	0	0	0	0	0	0	0	0
Республика Калмыкия	Частные; Очная	    прибыло по другим причинам / 5.0	0	0	0	0	0	0	0	0	0	0	0	0	0	0	0	0	0	0	0	0
Республика Калмыкия	Частные; Очная	Выбыло студентов - всего (сумма стр. 07-11, 13-15) / 6.0	0	0	0	0	0	0	0	0	0	0	0	0	0	13	13	0	0	0	2	2
Республика Калмыкия	Частные; Очная	Прибыло студентов - всего (сумма стр. 02-05) / 1.0	0	0	0	0	0	0	0	0	0	0	0	0	0	8	8	0	0	0	3	3
Республика Калмыкия	Частные; Очная	"Численность студентов на начало прошлого учебного года
(на 1 октября) / 17.0"	0	0	0	0	0	0	0	0	0	0	0	0	0	34	34	0	0	0	1	1
Республика Карелия	Государственные, муниципальные (без учета организаций в ведении ФСИН); Заочная	            из стр. 11 - не прошли итоговую аттестацию / 12.0	0	0	0	0	0	0	0	0	0	0	0	0	0	0	0	0	0	0	0	0
Республика Карелия	Государственные, муниципальные (без учета организаций в ведении ФСИН); Заочная	"            из стр. 11 – лица с ограниченными возможностями здоровья,
            инвалиды, дети-инвалиды / 13.0"	0	0	0	0	0	0	0	0	0	0	0	0	0	0	0	0	0	0	0	0
Республика Карелия	Государственные, муниципальные (без учета организаций в ведении ФСИН); Заочная	         отчислено в виде меры дисциплинарного взыскания / 14.0	0	0	0	0	0	0	0	0	0	0	0	0	0	0	0	0	0	0	0	0
Республика Карелия	Государственные, муниципальные (без учета организаций в ведении ФСИН); Заочная	         отчислено из-за просрочки оплаты обучения / 15.0	0	0	0	0	0	0	0	0	0	0	0	0	0	17	17	0	0	0	22	22
Республика Карелия	Государственные, муниципальные (без учета организаций в ведении ФСИН); Заочная	"    в том числе:
    переведено на другие формы обучения данной
    организации на программы того же уровня / 7.0"	0	0	0	0	0	0	0	0	0	0	0	0	0	1	1	0	0	0	2	2
Республика Карелия	Государственные, муниципальные (без учета организаций в ведении ФСИН); Заочная	"    в том числе:
    переведено с других форм обучения данной
    образовательной организации с программ того же уровня / 2.0"	0	0	0	0	0	0	0	0	0	0	0	0	0	4	4	0	0	0	25	25
Республика Карелия	Государственные, муниципальные (без учета организаций в ведении ФСИН); Заочная	    восстановлены из числа ранее отчисленных / 4.0	0	0	0	0	0	0	0	0	0	0	0	0	0	8	8	0	0	1	23	24
Республика Карелия	Государственные, муниципальные (без учета организаций в ведении ФСИН); Заочная	    выбыло по другим причинам / 16.0	0	0	0	0	0	0	0	0	0	0	0	0	0	17	17	0	0	0	12	12
Республика Карелия	Государственные, муниципальные (без учета организаций в ведении ФСИН); Заочная	"    добровольно прекратили образовательные отношения
    (бросили учебу) / 10.0"	0	0	0	0	0	0	0	0	0	0	0	0	0	30	30	0	0	19	59	78
Республика Карелия	Государственные, муниципальные (без учета организаций в ведении ФСИН); Заочная	"    отчислено:
         по неуспеваемости / 11.0"	0	0	0	0	0	0	0	0	0	0	0	0	0	10	10	0	0	16	15	31
Республика Карелия	Государственные, муниципальные (без учета организаций в ведении ФСИН); Заочная	"    переведено в другие образовательные организации
    на программы того же уровня / 8.0"	0	0	0	0	0	0	0	0	0	0	0	0	0	0	0	0	0	0	1	1
Республика Карелия	Государственные, муниципальные (без учета организаций в ведении ФСИН); Заочная	"    переведено из других образовательных организаций 
    с программ того же уровня / 3.0"	0	0	0	0	0	0	0	0	0	0	0	0	0	0	0	0	0	0	1	1
Республика Карелия	Государственные, муниципальные (без учета организаций в ведении ФСИН); Заочная	    по болезни / 9.0	0	0	0	0	0	0	0	0	0	0	0	0	0	0	0	0	0	0	0	0
Республика Карелия	Государственные, муниципальные (без учета организаций в ведении ФСИН); Заочная	    прибыло по другим причинам / 5.0	0	0	0	0	0	0	0	0	0	0	0	0	0	35	35	0	0	0	12	12
Республика Карелия	Государственные, муниципальные (без учета организаций в ведении ФСИН); Заочная	Выбыло студентов - всего (сумма стр. 07-11, 13-15) / 6.0	0	0	0	0	0	0	0	0	0	0	0	0	0	75	75	0	0	35	111	146
Республика Карелия	Государственные, муниципальные (без учета организаций в ведении ФСИН); Заочная	Прибыло студентов - всего (сумма стр. 02-05) / 1.0	0	0	0	0	0	0	0	0	0	0	0	0	0	47	47	0	0	1	61	62
Республика Карелия	Государственные, муниципальные (без учета организаций в ведении ФСИН); Заочная	"Численность студентов на начало прошлого учебного года
(на 1 октября) / 17.0"	0	0	0	0	0	0	0	0	0	0	0	0	0	278	278	0	0	331	874	1205
Республика Карелия	Государственные, муниципальные (без учета организаций в ведении ФСИН); Очная	            из стр. 11 - не прошли итоговую аттестацию / 12.0	3	0	0	0	3	0	0	0	0	0	1	0	0	2	3	1	0	0	0	1
Республика Карелия	Государственные, муниципальные (без учета организаций в ведении ФСИН); Очная	"            из стр. 11 – лица с ограниченными возможностями здоровья,
            инвалиды, дети-инвалиды / 13.0"	0	0	0	0	0	0	0	0	0	0	0	0	0	0	0	0	0	0	0	0
Республика Карелия	Государственные, муниципальные (без учета организаций в ведении ФСИН); Очная	         отчислено в виде меры дисциплинарного взыскания / 14.0	0	0	0	0	0	0	0	0	0	0	4	0	0	1	5	0	0	0	0	0
Республика Карелия	Государственные, муниципальные (без учета организаций в ведении ФСИН); Очная	         отчислено из-за просрочки оплаты обучения / 15.0	0	0	0	2	2	0	0	0	0	0	0	0	0	10	10	0	0	0	4	4
Республика Карелия	Государственные, муниципальные (без учета организаций в ведении ФСИН); Очная	"    в том числе:
    переведено на другие формы обучения данной
    организации на программы того же уровня / 7.0"	1	0	0	1	2	0	0	0	0	0	5	0	0	6	11	7	0	2	17	26
Республика Карелия	Государственные, муниципальные (без учета организаций в ведении ФСИН); Очная	"    в том числе:
    переведено с других форм обучения данной
    образовательной организации с программ того же уровня / 2.0"	1	0	0	2	3	0	0	0	0	0	0	0	0	2	2	5	0	0	9	14
Республика Карелия	Государственные, муниципальные (без учета организаций в ведении ФСИН); Очная	    восстановлены из числа ранее отчисленных / 4.0	51	0	0	8	59	3	0	0	2	5	20	0	13	11	44	7	0	0	5	12
Республика Карелия	Государственные, муниципальные (без учета организаций в ведении ФСИН); Очная	    выбыло по другим причинам / 16.0	19	0	0	28	47	0	0	0	0	0	41	0	2	56	99	14	0	0	88	102
Республика Карелия	Государственные, муниципальные (без учета организаций в ведении ФСИН); Очная	"    добровольно прекратили образовательные отношения
    (бросили учебу) / 10.0"	136	0	0	76	212	13	0	0	3	16	210	0	45	156	411	103	0	10	59	172
Республика Карелия	Государственные, муниципальные (без учета организаций в ведении ФСИН); Очная	"    отчислено:
         по неуспеваемости / 11.0"	72	0	0	5	77	4	0	0	0	4	40	0	5	14	59	9	0	4	1	14
Республика Карелия	Государственные, муниципальные (без учета организаций в ведении ФСИН); Очная	"    переведено в другие образовательные организации
    на программы того же уровня / 8.0"	4	0	0	2	6	0	0	0	0	0	24	0	27	13	64	2	0	1	2	5
Республика Карелия	Государственные, муниципальные (без учета организаций в ведении ФСИН); Очная	"    переведено из других образовательных организаций 
    с программ того же уровня / 3.0"	6	0	0	4	10	0	0	0	0	0	8	0	19	11	38	5	0	1	3	9
Республика Карелия	Государственные, муниципальные (без учета организаций в ведении ФСИН); Очная	    по болезни / 9.0	1	0	0	0	1	0	0	0	0	0	0	0	0	0	0	0	0	0	0	0
Республика Карелия	Государственные, муниципальные (без учета организаций в ведении ФСИН); Очная	    прибыло по другим причинам / 5.0	19	0	0	7	26	2	0	0	2	4	27	0	5	67	99	28	0	3	6	37
Республика Карелия	Государственные, муниципальные (без учета организаций в ведении ФСИН); Очная	Выбыло студентов - всего (сумма стр. 07-11, 13-15) / 6.0	233	0	0	114	347	17	0	0	3	20	324	0	79	256	659	135	0	17	171	323
Республика Карелия	Государственные, муниципальные (без учета организаций в ведении ФСИН); Очная	Прибыло студентов - всего (сумма стр. 02-05) / 1.0	77	0	0	21	98	5	0	0	4	9	55	0	37	91	183	45	0	4	23	72
Республика Карелия	Государственные, муниципальные (без учета организаций в ведении ФСИН); Очная	"Численность студентов на начало прошлого учебного года
(на 1 октября) / 17.0"	2288	0	0	516	2804	71	0	0	12	83	4039	0	1029	1190	6258	1475	0	238	802	2515
Республика Карелия	Очно-заочная; Государственные, муниципальные (без учета организаций в ведении ФСИН)	            из стр. 11 - не прошли итоговую аттестацию / 12.0	0	0	0	0	0	0	0	0	0	0	0	0	0	0	0	0	0	0	0	0
Республика Карелия	Очно-заочная; Государственные, муниципальные (без учета организаций в ведении ФСИН)	"            из стр. 11 – лица с ограниченными возможностями здоровья,
            инвалиды, дети-инвалиды / 13.0"	0	0	0	0	0	0	0	0	0	0	0	0	0	0	0	0	0	0	0	0
Республика Карелия	Очно-заочная; Государственные, муниципальные (без учета организаций в ведении ФСИН)	         отчислено в виде меры дисциплинарного взыскания / 14.0	0	0	0	0	0	0	0	0	0	0	0	0	0	0	0	0	0	0	0	0
Республика Карелия	Очно-заочная; Государственные, муниципальные (без учета организаций в ведении ФСИН)	         отчислено из-за просрочки оплаты обучения / 15.0	0	0	0	0	0	0	0	0	0	0	0	0	0	0	0	0	0	0	0	0
Республика Карелия	Очно-заочная; Государственные, муниципальные (без учета организаций в ведении ФСИН)	"    в том числе:
    переведено на другие формы обучения данной
    организации на программы того же уровня / 7.0"	0	0	0	0	0	0	0	0	0	0	0	0	0	0	0	5	0	0	1	6
Республика Карелия	Очно-заочная; Государственные, муниципальные (без учета организаций в ведении ФСИН)	"    в том числе:
    переведено с других форм обучения данной
    образовательной организации с программ того же уровня / 2.0"	0	0	0	0	0	0	0	0	0	0	0	0	0	0	0	3	0	0	0	3
Республика Карелия	Очно-заочная; Государственные, муниципальные (без учета организаций в ведении ФСИН)	    восстановлены из числа ранее отчисленных / 4.0	0	0	0	0	0	0	0	0	0	0	0	0	0	0	0	0	0	0	5	5
Республика Карелия	Очно-заочная; Государственные, муниципальные (без учета организаций в ведении ФСИН)	    выбыло по другим причинам / 16.0	0	0	0	0	0	0	0	0	0	0	0	0	0	0	0	5	0	0	7	12
Республика Карелия	Очно-заочная; Государственные, муниципальные (без учета организаций в ведении ФСИН)	"    добровольно прекратили образовательные отношения
    (бросили учебу) / 10.0"	0	0	0	0	0	0	0	0	0	0	0	0	0	0	0	24	0	0	28	52
Республика Карелия	Очно-заочная; Государственные, муниципальные (без учета организаций в ведении ФСИН)	"    отчислено:
         по неуспеваемости / 11.0"	0	0	0	0	0	0	0	0	0	0	0	0	0	0	0	0	0	0	0	0
Республика Карелия	Очно-заочная; Государственные, муниципальные (без учета организаций в ведении ФСИН)	"    переведено в другие образовательные организации
    на программы того же уровня / 8.0"	0	0	0	0	0	0	0	0	0	0	0	0	0	0	0	0	0	0	1	1
Республика Карелия	Очно-заочная; Государственные, муниципальные (без учета организаций в ведении ФСИН)	"    переведено из других образовательных организаций 
    с программ того же уровня / 3.0"	0	0	0	0	0	0	0	0	0	0	0	0	0	0	0	0	0	0	0	0
Республика Карелия	Очно-заочная; Государственные, муниципальные (без учета организаций в ведении ФСИН)	    по болезни / 9.0	0	0	0	0	0	0	0	0	0	0	0	0	0	0	0	0	0	0	0	0
Республика Карелия	Очно-заочная; Государственные, муниципальные (без учета организаций в ведении ФСИН)	    прибыло по другим причинам / 5.0	0	0	0	0	0	0	0	0	0	0	0	0	0	0	0	0	0	0	0	0
Республика Карелия	Очно-заочная; Государственные, муниципальные (без учета организаций в ведении ФСИН)	Выбыло студентов - всего (сумма стр. 07-11, 13-15) / 6.0	0	0	0	0	0	0	0	0	0	0	0	0	0	0	0	34	0	0	37	71
Республика Карелия	Очно-заочная; Государственные, муниципальные (без учета организаций в ведении ФСИН)	Прибыло студентов - всего (сумма стр. 02-05) / 1.0	0	0	0	0	0	0	0	0	0	0	0	0	0	0	0	3	0	0	5	8
Республика Карелия	Очно-заочная; Государственные, муниципальные (без учета организаций в ведении ФСИН)	"Численность студентов на начало прошлого учебного года
(на 1 октября) / 17.0"	0	0	0	0	0	0	0	0	0	0	0	0	0	0	0	238	0	0	378	616
Республика Карелия	Частные; Заочная	            из стр. 11 - не прошли итоговую аттестацию / 12.0	0	0	0	0	0	0	0	0	0	0	0	0	0	0	0	0	0	0	0	0
Республика Карелия	Частные; Заочная	"            из стр. 11 – лица с ограниченными возможностями здоровья,
            инвалиды, дети-инвалиды / 13.0"	0	0	0	0	0	0	0	0	0	0	0	0	0	0	0	0	0	0	0	0
Республика Карелия	Частные; Заочная	         отчислено в виде меры дисциплинарного взыскания / 14.0	0	0	0	0	0	0	0	0	0	0	0	0	0	0	0	0	0	0	0	0
Республика Карелия	Частные; Заочная	         отчислено из-за просрочки оплаты обучения / 15.0	0	0	0	0	0	0	0	0	0	0	0	0	0	0	0	0	0	0	0	0
Республика Карелия	Частные; Заочная	"    в том числе:
    переведено на другие формы обучения данной
    организации на программы того же уровня / 7.0"	0	0	0	0	0	0	0	0	0	0	0	0	0	0	0	0	0	0	2	2
Республика Карелия	Частные; Заочная	"    в том числе:
    переведено с других форм обучения данной
    образовательной организации с программ того же уровня / 2.0"	0	0	0	0	0	0	0	0	0	0	0	0	0	21	21	0	0	0	28	28
Республика Карелия	Частные; Заочная	    восстановлены из числа ранее отчисленных / 4.0	0	0	0	0	0	0	0	0	0	0	0	0	0	2	2	0	0	0	7	7
Республика Карелия	Частные; Заочная	    выбыло по другим причинам / 16.0	0	0	0	0	0	0	0	0	0	0	0	0	0	0	0	0	0	0	2	2
Республика Карелия	Частные; Заочная	"    добровольно прекратили образовательные отношения
    (бросили учебу) / 10.0"	0	0	0	0	0	0	0	0	0	0	0	0	0	2	2	0	0	0	31	31
Республика Карелия	Частные; Заочная	"    отчислено:
         по неуспеваемости / 11.0"	0	0	0	0	0	0	0	0	0	0	0	0	0	0	0	0	0	0	4	4
Республика Карелия	Частные; Заочная	"    переведено в другие образовательные организации
    на программы того же уровня / 8.0"	0	0	0	0	0	0	0	0	0	0	0	0	0	0	0	0	0	0	0	0
Республика Карелия	Частные; Заочная	"    переведено из других образовательных организаций 
    с программ того же уровня / 3.0"	0	0	0	0	0	0	0	0	0	0	0	0	0	0	0	0	0	0	0	0
Республика Карелия	Частные; Заочная	    по болезни / 9.0	0	0	0	0	0	0	0	0	0	0	0	0	0	0	0	0	0	0	0	0
Республика Карелия	Частные; Заочная	    прибыло по другим причинам / 5.0	0	0	0	0	0	0	0	0	0	0	0	0	0	0	0	0	0	0	0	0
Республика Карелия	Частные; Заочная	Выбыло студентов - всего (сумма стр. 07-11, 13-15) / 6.0	0	0	0	0	0	0	0	0	0	0	0	0	0	2	2	0	0	0	39	39
Республика Карелия	Частные; Заочная	Прибыло студентов - всего (сумма стр. 02-05) / 1.0	0	0	0	0	0	0	0	0	0	0	0	0	0	23	23	0	0	0	35	35
Республика Карелия	Частные; Заочная	"Численность студентов на начало прошлого учебного года
(на 1 октября) / 17.0"	0	0	0	0	0	0	0	0	0	0	0	0	0	4	4	0	0	0	151	151
Республика Карелия	Частные; Очная	            из стр. 11 - не прошли итоговую аттестацию / 12.0	0	0	0	0	0	0	0	0	0	0	0	0	0	0	0	0	0	0	0	0
Республика Карелия	Частные; Очная	"            из стр. 11 – лица с ограниченными возможностями здоровья,
            инвалиды, дети-инвалиды / 13.0"	0	0	0	0	0	0	0	0	0	0	0	0	0	0	0	0	0	0	0	0
Республика Карелия	Частные; Очная	         отчислено в виде меры дисциплинарного взыскания / 14.0	0	0	0	0	0	0	0	0	0	0	0	0	0	0	0	0	0	0	0	0
Республика Карелия	Частные; Очная	         отчислено из-за просрочки оплаты обучения / 15.0	0	0	0	0	0	0	0	0	0	0	0	0	0	10	10	0	0	0	4	4
Республика Карелия	Частные; Очная	"    в том числе:
    переведено на другие формы обучения данной
    организации на программы того же уровня / 7.0"	0	0	0	0	0	0	0	0	0	0	0	0	0	21	21	0	0	0	28	28
Республика Карелия	Частные; Очная	"    в том числе:
    переведено с других форм обучения данной
    образовательной организации с программ того же уровня / 2.0"	0	0	0	0	0	0	0	0	0	0	0	0	0	0	0	0	0	0	2	2
Республика Карелия	Частные; Очная	    восстановлены из числа ранее отчисленных / 4.0	0	0	0	0	0	0	0	0	0	0	0	0	0	10	10	0	0	0	7	7
Республика Карелия	Частные; Очная	    выбыло по другим причинам / 16.0	0	0	0	0	0	0	0	0	0	0	0	0	0	46	46	0	0	0	0	0
Республика Карелия	Частные; Очная	"    добровольно прекратили образовательные отношения
    (бросили учебу) / 10.0"	0	0	0	0	0	0	0	0	0	0	0	0	0	99	99	0	0	0	20	20
Республика Карелия	Частные; Очная	"    отчислено:
         по неуспеваемости / 11.0"	0	0	0	0	0	0	0	0	0	0	0	0	0	39	39	0	0	0	6	6
Республика Карелия	Частные; Очная	"    переведено в другие образовательные организации
    на программы того же уровня / 8.0"	0	0	0	0	0	0	0	0	0	0	0	0	0	18	18	0	0	0	1	1
Республика Карелия	Частные; Очная	"    переведено из других образовательных организаций 
    с программ того же уровня / 3.0"	0	0	0	0	0	0	0	0	0	0	0	0	0	4	4	0	0	0	1	1
Республика Карелия	Частные; Очная	    по болезни / 9.0	0	0	0	0	0	0	0	0	0	0	0	0	0	0	0	0	0	0	0	0
Республика Карелия	Частные; Очная	    прибыло по другим причинам / 5.0	0	0	0	0	0	0	0	0	0	0	0	0	0	0	0	0	0	0	0	0
Республика Карелия	Частные; Очная	Выбыло студентов - всего (сумма стр. 07-11, 13-15) / 6.0	0	0	0	0	0	0	0	0	0	0	0	0	0	233	233	0	0	0	59	59
Республика Карелия	Частные; Очная	Прибыло студентов - всего (сумма стр. 02-05) / 1.0	0	0	0	0	0	0	0	0	0	0	0	0	0	14	14	0	0	0	10	10
Республика Карелия	Частные; Очная	"Численность студентов на начало прошлого учебного года
(на 1 октября) / 17.0"	0	0	0	0	0	0	0	0	0	0	0	0	0	1353	1353	0	0	0	411	411
Республика Коми	Государственные, муниципальные (без учета организаций в ведении ФСИН); Заочная	            из стр. 11 - не прошли итоговую аттестацию / 12.0	0	0	0	0	0	0	0	0	0	0	0	0	0	0	0	0	0	0	1	1
Республика Коми	Государственные, муниципальные (без учета организаций в ведении ФСИН); Заочная	"            из стр. 11 – лица с ограниченными возможностями здоровья,
            инвалиды, дети-инвалиды / 13.0"	0	0	0	0	0	0	0	0	0	0	0	0	0	0	0	0	0	0	0	0
Республика Коми	Государственные, муниципальные (без учета организаций в ведении ФСИН); Заочная	         отчислено в виде меры дисциплинарного взыскания / 14.0	0	0	0	0	0	0	0	0	0	0	0	0	0	0	0	11	0	0	1	12
Республика Коми	Государственные, муниципальные (без учета организаций в ведении ФСИН); Заочная	         отчислено из-за просрочки оплаты обучения / 15.0	0	0	0	0	0	0	0	0	0	0	0	0	0	8	8	0	0	0	19	19
Республика Коми	Государственные, муниципальные (без учета организаций в ведении ФСИН); Заочная	"    в том числе:
    переведено на другие формы обучения данной
    организации на программы того же уровня / 7.0"	0	0	0	0	0	0	0	0	0	0	0	0	0	0	0	1	0	0	0	1
Республика Коми	Государственные, муниципальные (без учета организаций в ведении ФСИН); Заочная	"    в том числе:
    переведено с других форм обучения данной
    образовательной организации с программ того же уровня / 2.0"	0	0	0	0	0	0	0	0	0	0	5	0	0	13	18	14	0	1	4	19
Республика Коми	Государственные, муниципальные (без учета организаций в ведении ФСИН); Заочная	    восстановлены из числа ранее отчисленных / 4.0	0	0	0	0	0	0	0	0	0	0	2	0	0	14	16	26	0	2	10	38
Республика Коми	Государственные, муниципальные (без учета организаций в ведении ФСИН); Заочная	    выбыло по другим причинам / 16.0	0	0	0	0	0	0	0	0	0	0	0	0	0	2	2	20	0	8	9	37
Республика Коми	Государственные, муниципальные (без учета организаций в ведении ФСИН); Заочная	"    добровольно прекратили образовательные отношения
    (бросили учебу) / 10.0"	0	0	0	0	0	0	0	0	0	0	15	0	0	24	39	84	0	0	23	107
Республика Коми	Государственные, муниципальные (без учета организаций в ведении ФСИН); Заочная	"    отчислено:
         по неуспеваемости / 11.0"	0	0	0	0	0	0	0	0	0	0	2	0	0	14	16	34	0	0	19	53
Республика Коми	Государственные, муниципальные (без учета организаций в ведении ФСИН); Заочная	"    переведено в другие образовательные организации
    на программы того же уровня / 8.0"	0	0	0	0	0	0	0	0	0	0	0	0	0	0	0	2	0	0	1	3
Республика Коми	Государственные, муниципальные (без учета организаций в ведении ФСИН); Заочная	"    переведено из других образовательных организаций 
    с программ того же уровня / 3.0"	0	0	0	0	0	0	0	0	0	0	0	0	0	4	4	2	0	0	1	3
Республика Коми	Государственные, муниципальные (без учета организаций в ведении ФСИН); Заочная	    по болезни / 9.0	0	0	0	0	0	0	0	0	0	0	0	0	0	0	0	0	0	0	0	0
Республика Коми	Государственные, муниципальные (без учета организаций в ведении ФСИН); Заочная	    прибыло по другим причинам / 5.0	0	0	0	0	0	0	0	0	0	0	0	0	0	0	0	4	0	0	28	32
Республика Коми	Государственные, муниципальные (без учета организаций в ведении ФСИН); Заочная	Выбыло студентов - всего (сумма стр. 07-11, 13-15) / 6.0	0	0	0	0	0	0	0	0	0	0	17	0	0	48	65	152	0	8	72	232
Республика Коми	Государственные, муниципальные (без учета организаций в ведении ФСИН); Заочная	Прибыло студентов - всего (сумма стр. 02-05) / 1.0	0	0	0	0	0	0	0	0	0	0	7	0	0	31	38	46	0	3	43	92
Республика Коми	Государственные, муниципальные (без учета организаций в ведении ФСИН); Заочная	"Численность студентов на начало прошлого учебного года
(на 1 октября) / 17.0"	0	0	0	0	0	0	0	0	0	0	134	0	20	280	434	1054	0	175	433	1662
Республика Коми	Государственные, муниципальные (без учета организаций в ведении ФСИН); Очная	            из стр. 11 - не прошли итоговую аттестацию / 12.0	33	0	0	0	33	3	0	0	0	3	12	0	0	0	12	0	0	1	0	1
Республика Коми	Государственные, муниципальные (без учета организаций в ведении ФСИН); Очная	"            из стр. 11 – лица с ограниченными возможностями здоровья,
            инвалиды, дети-инвалиды / 13.0"	0	0	0	0	0	0	0	0	0	0	1	0	0	0	1	0	0	0	0	0
Республика Коми	Государственные, муниципальные (без учета организаций в ведении ФСИН); Очная	         отчислено в виде меры дисциплинарного взыскания / 14.0	19	0	0	2	21	0	0	0	0	0	12	0	0	2	14	4	0	0	1	5
Республика Коми	Государственные, муниципальные (без учета организаций в ведении ФСИН); Очная	         отчислено из-за просрочки оплаты обучения / 15.0	0	0	0	1	1	0	0	0	0	0	0	0	0	8	8	0	0	0	10	10
Республика Коми	Государственные, муниципальные (без учета организаций в ведении ФСИН); Очная	"    в том числе:
    переведено на другие формы обучения данной
    организации на программы того же уровня / 7.0"	12	0	0	9	21	0	0	0	0	0	25	0	3	35	63	2	0	0	5	7
Республика Коми	Государственные, муниципальные (без учета организаций в ведении ФСИН); Очная	"    в том числе:
    переведено с других форм обучения данной
    образовательной организации с программ того же уровня / 2.0"	41	0	0	3	44	0	0	0	0	0	20	0	3	3	26	4	0	0	0	4
Республика Коми	Государственные, муниципальные (без учета организаций в ведении ФСИН); Очная	    восстановлены из числа ранее отчисленных / 4.0	46	0	0	2	48	1	0	0	0	1	98	0	19	33	150	15	0	4	18	37
Республика Коми	Государственные, муниципальные (без учета организаций в ведении ФСИН); Очная	    выбыло по другим причинам / 16.0	45	4	0	1	50	1	0	0	0	1	77	0	16	53	146	13	0	2	34	49
Республика Коми	Государственные, муниципальные (без учета организаций в ведении ФСИН); Очная	"    добровольно прекратили образовательные отношения
    (бросили учебу) / 10.0"	339	0	1	50	390	17	0	0	3	20	498	0	87	194	779	83	0	15	47	145
Республика Коми	Государственные, муниципальные (без учета организаций в ведении ФСИН); Очная	"    отчислено:
         по неуспеваемости / 11.0"	201	0	0	7	208	3	0	0	0	3	185	0	35	74	294	22	0	12	12	46
Республика Коми	Государственные, муниципальные (без учета организаций в ведении ФСИН); Очная	"    переведено в другие образовательные организации
    на программы того же уровня / 8.0"	36	0	0	7	43	0	0	0	0	0	52	0	16	18	86	3	0	0	2	5
Республика Коми	Государственные, муниципальные (без учета организаций в ведении ФСИН); Очная	"    переведено из других образовательных организаций 
    с программ того же уровня / 3.0"	29	0	0	5	34	0	0	0	0	0	38	0	17	9	64	2	0	0	2	4
Республика Коми	Государственные, муниципальные (без учета организаций в ведении ФСИН); Очная	    по болезни / 9.0	1	0	0	0	1	0	0	0	0	0	1	0	0	0	1	0	0	0	0	0
Республика Коми	Государственные, муниципальные (без учета организаций в ведении ФСИН); Очная	    прибыло по другим причинам / 5.0	48	0	0	8	56	1	0	0	0	1	61	0	26	27	114	18	0	11	19	48
Республика Коми	Государственные, муниципальные (без учета организаций в ведении ФСИН); Очная	Выбыло студентов - всего (сумма стр. 07-11, 13-15) / 6.0	653	4	1	77	735	21	0	0	3	24	850	0	157	384	1391	127	0	29	111	267
Республика Коми	Государственные, муниципальные (без учета организаций в ведении ФСИН); Очная	Прибыло студентов - всего (сумма стр. 02-05) / 1.0	164	0	0	18	182	2	0	0	0	2	217	0	65	72	354	39	0	15	39	93
Республика Коми	Государственные, муниципальные (без учета организаций в ведении ФСИН); Очная	"Численность студентов на начало прошлого учебного года
(на 1 октября) / 17.0"	4075	306	85	319	4785	74	0	0	24	98	7424	39	1333	1927	10723	657	0	315	499	1471
Республика Коми	Очно-заочная; Государственные, муниципальные (без учета организаций в ведении ФСИН)	            из стр. 11 - не прошли итоговую аттестацию / 12.0	0	0	0	0	0	0	0	0	0	0	0	0	0	0	0	0	0	0	0	0
Республика Коми	Очно-заочная; Государственные, муниципальные (без учета организаций в ведении ФСИН)	"            из стр. 11 – лица с ограниченными возможностями здоровья,
            инвалиды, дети-инвалиды / 13.0"	0	0	0	0	0	0	0	0	0	0	0	0	0	0	0	0	0	0	0	0
Республика Коми	Очно-заочная; Государственные, муниципальные (без учета организаций в ведении ФСИН)	         отчислено в виде меры дисциплинарного взыскания / 14.0	0	0	0	0	0	0	0	0	0	0	0	0	0	0	0	0	0	0	0	0
Республика Коми	Очно-заочная; Государственные, муниципальные (без учета организаций в ведении ФСИН)	         отчислено из-за просрочки оплаты обучения / 15.0	0	0	0	0	0	0	0	0	0	0	0	0	0	0	0	0	0	0	1	1
Республика Коми	Очно-заочная; Государственные, муниципальные (без учета организаций в ведении ФСИН)	"    в том числе:
    переведено на другие формы обучения данной
    организации на программы того же уровня / 7.0"	0	0	0	0	0	0	0	0	0	0	0	0	0	0	0	0	0	0	0	0
Республика Коми	Очно-заочная; Государственные, муниципальные (без учета организаций в ведении ФСИН)	"    в том числе:
    переведено с других форм обучения данной
    образовательной организации с программ того же уровня / 2.0"	0	0	0	0	0	0	0	0	0	0	0	0	0	0	0	0	0	0	0	0
Республика Коми	Очно-заочная; Государственные, муниципальные (без учета организаций в ведении ФСИН)	    восстановлены из числа ранее отчисленных / 4.0	0	0	0	0	0	0	0	0	0	0	0	0	0	0	0	1	0	0	3	4
Республика Коми	Очно-заочная; Государственные, муниципальные (без учета организаций в ведении ФСИН)	    выбыло по другим причинам / 16.0	0	0	0	0	0	0	0	0	0	0	0	0	0	0	0	0	0	0	6	6
Республика Коми	Очно-заочная; Государственные, муниципальные (без учета организаций в ведении ФСИН)	"    добровольно прекратили образовательные отношения
    (бросили учебу) / 10.0"	0	0	0	0	0	0	0	0	0	0	0	0	0	0	0	5	0	0	37	42
Республика Коми	Очно-заочная; Государственные, муниципальные (без учета организаций в ведении ФСИН)	"    отчислено:
         по неуспеваемости / 11.0"	0	0	0	0	0	0	0	0	0	0	0	0	0	0	0	7	0	0	3	10
Республика Коми	Очно-заочная; Государственные, муниципальные (без учета организаций в ведении ФСИН)	"    переведено в другие образовательные организации
    на программы того же уровня / 8.0"	0	0	0	0	0	0	0	0	0	0	0	0	0	0	0	0	0	0	0	0
Республика Коми	Очно-заочная; Государственные, муниципальные (без учета организаций в ведении ФСИН)	"    переведено из других образовательных организаций 
    с программ того же уровня / 3.0"	0	0	0	0	0	0	0	0	0	0	0	0	0	0	0	0	0	0	0	0
Республика Коми	Очно-заочная; Государственные, муниципальные (без учета организаций в ведении ФСИН)	    по болезни / 9.0	0	0	0	0	0	0	0	0	0	0	0	0	0	0	0	0	0	0	0	0
Республика Коми	Очно-заочная; Государственные, муниципальные (без учета организаций в ведении ФСИН)	    прибыло по другим причинам / 5.0	0	0	0	0	0	0	0	0	0	0	0	0	0	0	0	2	0	0	4	6
Республика Коми	Очно-заочная; Государственные, муниципальные (без учета организаций в ведении ФСИН)	Выбыло студентов - всего (сумма стр. 07-11, 13-15) / 6.0	0	0	0	0	0	0	0	0	0	0	0	0	0	0	0	12	0	0	47	59
Республика Коми	Очно-заочная; Государственные, муниципальные (без учета организаций в ведении ФСИН)	Прибыло студентов - всего (сумма стр. 02-05) / 1.0	0	0	0	0	0	0	0	0	0	0	0	0	0	0	0	3	0	0	7	10
Республика Коми	Очно-заочная; Государственные, муниципальные (без учета организаций в ведении ФСИН)	"Численность студентов на начало прошлого учебного года
(на 1 октября) / 17.0"	0	0	0	0	0	0	0	0	0	0	0	0	0	0	0	136	0	0	290	426
Республика Коми	Частные; Заочная	            из стр. 11 - не прошли итоговую аттестацию / 12.0	0	0	0	0	0	0	0	0	0	0	0	0	0	1	1	0	0	0	0	0
Республика Коми	Частные; Заочная	"            из стр. 11 – лица с ограниченными возможностями здоровья,
            инвалиды, дети-инвалиды / 13.0"	0	0	0	0	0	0	0	0	0	0	0	0	0	0	0	0	0	0	0	0
Республика Коми	Частные; Заочная	         отчислено в виде меры дисциплинарного взыскания / 14.0	0	0	0	0	0	0	0	0	0	0	0	0	0	0	0	0	0	0	0	0
Республика Коми	Частные; Заочная	         отчислено из-за просрочки оплаты обучения / 15.0	0	0	0	0	0	0	0	0	0	0	0	0	0	0	0	0	0	0	0	0
Республика Коми	Частные; Заочная	"    в том числе:
    переведено на другие формы обучения данной
    организации на программы того же уровня / 7.0"	0	0	0	0	0	0	0	0	0	0	0	0	0	0	0	0	0	0	0	0
Республика Коми	Частные; Заочная	"    в том числе:
    переведено с других форм обучения данной
    образовательной организации с программ того же уровня / 2.0"	0	0	0	0	0	0	0	0	0	0	0	0	0	3	3	0	0	0	0	0
Республика Коми	Частные; Заочная	    восстановлены из числа ранее отчисленных / 4.0	0	0	0	0	0	0	0	0	0	0	0	0	0	3	3	0	0	0	9	9
Республика Коми	Частные; Заочная	    выбыло по другим причинам / 16.0	0	0	0	0	0	0	0	0	0	0	0	0	0	0	0	0	0	0	5	5
Республика Коми	Частные; Заочная	"    добровольно прекратили образовательные отношения
    (бросили учебу) / 10.0"	0	0	0	0	0	0	0	0	0	0	0	0	0	17	17	0	0	0	16	16
Республика Коми	Частные; Заочная	"    отчислено:
         по неуспеваемости / 11.0"	0	0	0	0	0	0	0	0	0	0	0	0	0	16	16	0	0	0	13	13
Республика Коми	Частные; Заочная	"    переведено в другие образовательные организации
    на программы того же уровня / 8.0"	0	0	0	0	0	0	0	0	0	0	0	0	0	0	0	0	0	0	0	0
Республика Коми	Частные; Заочная	"    переведено из других образовательных организаций 
    с программ того же уровня / 3.0"	0	0	0	0	0	0	0	0	0	0	0	0	0	7	7	0	0	0	6	6
Республика Коми	Частные; Заочная	    по болезни / 9.0	0	0	0	0	0	0	0	0	0	0	0	0	0	0	0	0	0	0	0	0
Республика Коми	Частные; Заочная	    прибыло по другим причинам / 5.0	0	0	0	0	0	0	0	0	0	0	0	0	0	0	0	0	0	0	4	4
Республика Коми	Частные; Заочная	Выбыло студентов - всего (сумма стр. 07-11, 13-15) / 6.0	0	0	0	0	0	0	0	0	0	0	0	0	0	33	33	0	0	0	34	34
Республика Коми	Частные; Заочная	Прибыло студентов - всего (сумма стр. 02-05) / 1.0	0	0	0	0	0	0	0	0	0	0	0	0	0	13	13	0	0	0	19	19
Республика Коми	Частные; Заочная	"Численность студентов на начало прошлого учебного года
(на 1 октября) / 17.0"	0	0	0	0	0	0	0	0	0	0	0	0	0	132	132	0	0	0	158	158
Республика Коми	Частные; Очная	            из стр. 11 - не прошли итоговую аттестацию / 12.0	0	0	0	0	0	0	0	0	0	0	0	0	0	2	2	0	0	0	2	2
Республика Коми	Частные; Очная	"            из стр. 11 – лица с ограниченными возможностями здоровья,
            инвалиды, дети-инвалиды / 13.0"	0	0	0	0	0	0	0	0	0	0	0	0	0	0	0	0	0	0	0	0
Республика Коми	Частные; Очная	         отчислено в виде меры дисциплинарного взыскания / 14.0	0	0	0	0	0	0	0	0	0	0	0	0	0	0	0	0	0	0	0	0
Республика Коми	Частные; Очная	         отчислено из-за просрочки оплаты обучения / 15.0	0	0	0	0	0	0	0	0	0	0	0	0	0	0	0	0	0	0	0	0
Республика Коми	Частные; Очная	"    в том числе:
    переведено на другие формы обучения данной
    организации на программы того же уровня / 7.0"	0	0	0	0	0	0	0	0	0	0	0	0	0	2	2	0	0	0	0	0
Республика Коми	Частные; Очная	"    в том числе:
    переведено с других форм обучения данной
    образовательной организации с программ того же уровня / 2.0"	0	0	0	0	0	0	0	0	0	0	0	0	0	0	0	0	0	0	0	0
Республика Коми	Частные; Очная	    восстановлены из числа ранее отчисленных / 4.0	0	0	0	0	0	0	0	0	0	0	0	0	0	15	15	0	0	0	1	1
Республика Коми	Частные; Очная	    выбыло по другим причинам / 16.0	0	0	0	0	0	0	0	0	0	0	0	0	0	4	4	0	0	0	2	2
Республика Коми	Частные; Очная	"    добровольно прекратили образовательные отношения
    (бросили учебу) / 10.0"	0	0	0	0	0	0	0	0	0	0	0	0	0	52	52	0	0	0	7	7
Республика Коми	Частные; Очная	"    отчислено:
         по неуспеваемости / 11.0"	0	0	0	0	0	0	0	0	0	0	0	0	0	24	24	0	0	0	2	2
Республика Коми	Частные; Очная	"    переведено в другие образовательные организации
    на программы того же уровня / 8.0"	0	0	0	0	0	0	0	0	0	0	0	0	0	8	8	0	0	0	0	0
Республика Коми	Частные; Очная	"    переведено из других образовательных организаций 
    с программ того же уровня / 3.0"	0	0	0	0	0	0	0	0	0	0	0	0	0	3	3	0	0	0	2	2
Республика Коми	Частные; Очная	    по болезни / 9.0	0	0	0	0	0	0	0	0	0	0	0	0	0	1	1	0	0	0	0	0
Республика Коми	Частные; Очная	    прибыло по другим причинам / 5.0	0	0	0	0	0	0	0	0	0	0	0	0	0	5	5	0	0	0	0	0
Республика Коми	Частные; Очная	Выбыло студентов - всего (сумма стр. 07-11, 13-15) / 6.0	0	0	0	0	0	0	0	0	0	0	0	0	0	91	91	0	0	0	11	11
Республика Коми	Частные; Очная	Прибыло студентов - всего (сумма стр. 02-05) / 1.0	0	0	0	0	0	0	0	0	0	0	0	0	0	23	23	0	0	0	3	3
Республика Коми	Частные; Очная	"Численность студентов на начало прошлого учебного года
(на 1 октября) / 17.0"	0	0	0	0	0	0	0	0	0	0	0	0	0	549	549	0	0	0	72	72
Республика Крым	Государственные, муниципальные (без учета организаций в ведении ФСИН); Заочная	            из стр. 11 - не прошли итоговую аттестацию / 12.0	0	0	0	0	0	0	0	0	0	0	0	0	0	0	0	0	0	0	3	3
Республика Крым	Государственные, муниципальные (без учета организаций в ведении ФСИН); Заочная	"            из стр. 11 – лица с ограниченными возможностями здоровья,
            инвалиды, дети-инвалиды / 13.0"	0	0	0	0	0	0	0	0	0	0	0	0	0	0	0	0	0	0	0	0
Республика Крым	Государственные, муниципальные (без учета организаций в ведении ФСИН); Заочная	         отчислено в виде меры дисциплинарного взыскания / 14.0	0	0	0	0	0	0	0	0	0	0	0	0	0	0	0	0	0	0	0	0
Республика Крым	Государственные, муниципальные (без учета организаций в ведении ФСИН); Заочная	         отчислено из-за просрочки оплаты обучения / 15.0	0	0	0	0	0	0	0	0	0	0	0	0	0	1	1	0	0	0	44	44
Республика Крым	Государственные, муниципальные (без учета организаций в ведении ФСИН); Заочная	"    в том числе:
    переведено на другие формы обучения данной
    организации на программы того же уровня / 7.0"	0	0	0	0	0	0	0	0	0	0	0	0	0	3	3	0	0	0	10	10
Республика Крым	Государственные, муниципальные (без учета организаций в ведении ФСИН); Заочная	"    в том числе:
    переведено с других форм обучения данной
    образовательной организации с программ того же уровня / 2.0"	0	0	0	0	0	0	0	0	0	0	0	0	0	22	22	0	0	1	42	43
Республика Крым	Государственные, муниципальные (без учета организаций в ведении ФСИН); Заочная	    восстановлены из числа ранее отчисленных / 4.0	0	0	0	0	0	0	0	0	0	0	0	0	0	6	6	0	0	0	26	26
Республика Крым	Государственные, муниципальные (без учета организаций в ведении ФСИН); Заочная	    выбыло по другим причинам / 16.0	0	0	0	0	0	0	0	0	0	0	0	0	0	0	0	0	0	0	18	18
Республика Крым	Государственные, муниципальные (без учета организаций в ведении ФСИН); Заочная	"    добровольно прекратили образовательные отношения
    (бросили учебу) / 10.0"	0	0	0	0	0	0	0	0	0	0	0	0	0	15	15	0	0	1	96	97
Республика Крым	Государственные, муниципальные (без учета организаций в ведении ФСИН); Заочная	"    отчислено:
         по неуспеваемости / 11.0"	0	0	0	0	0	0	0	0	0	0	0	0	0	8	8	0	0	9	37	46
Республика Крым	Государственные, муниципальные (без учета организаций в ведении ФСИН); Заочная	"    переведено в другие образовательные организации
    на программы того же уровня / 8.0"	0	0	0	0	0	0	0	0	0	0	0	0	0	4	4	0	0	0	3	3
Республика Крым	Государственные, муниципальные (без учета организаций в ведении ФСИН); Заочная	"    переведено из других образовательных организаций 
    с программ того же уровня / 3.0"	0	0	0	0	0	0	0	0	0	0	0	0	0	10	10	0	0	0	8	8
Республика Крым	Государственные, муниципальные (без учета организаций в ведении ФСИН); Заочная	    по болезни / 9.0	0	0	0	0	0	0	0	0	0	0	0	0	0	1	1	0	0	0	0	0
Республика Крым	Государственные, муниципальные (без учета организаций в ведении ФСИН); Заочная	    прибыло по другим причинам / 5.0	0	0	0	0	0	0	0	0	0	0	0	0	0	5	5	0	0	0	2	2
Республика Крым	Государственные, муниципальные (без учета организаций в ведении ФСИН); Заочная	Выбыло студентов - всего (сумма стр. 07-11, 13-15) / 6.0	0	0	0	0	0	0	0	0	0	0	0	0	0	32	32	0	0	10	208	218
Республика Крым	Государственные, муниципальные (без учета организаций в ведении ФСИН); Заочная	Прибыло студентов - всего (сумма стр. 02-05) / 1.0	0	0	0	0	0	0	0	0	0	0	0	0	0	43	43	0	0	1	78	79
Республика Крым	Государственные, муниципальные (без учета организаций в ведении ФСИН); Заочная	"Численность студентов на начало прошлого учебного года
(на 1 октября) / 17.0"	0	0	0	0	0	0	0	0	0	0	0	0	0	257	257	0	0	125	1755	1880
Республика Крым	Государственные, муниципальные (без учета организаций в ведении ФСИН); Очная	            из стр. 11 - не прошли итоговую аттестацию / 12.0	10	0	0	0	10	0	0	0	0	0	0	0	1	4	5	0	0	1	21	22
Республика Крым	Государственные, муниципальные (без учета организаций в ведении ФСИН); Очная	"            из стр. 11 – лица с ограниченными возможностями здоровья,
            инвалиды, дети-инвалиды / 13.0"	0	0	0	0	0	0	0	0	0	0	0	0	0	0	0	0	0	0	0	0
Республика Крым	Государственные, муниципальные (без учета организаций в ведении ФСИН); Очная	         отчислено в виде меры дисциплинарного взыскания / 14.0	15	0	0	0	15	0	0	0	0	0	6	0	0	3	9	0	0	0	0	0
Республика Крым	Государственные, муниципальные (без учета организаций в ведении ФСИН); Очная	         отчислено из-за просрочки оплаты обучения / 15.0	0	0	0	1	1	0	0	0	0	0	0	0	0	34	34	0	0	0	8	8
Республика Крым	Государственные, муниципальные (без учета организаций в ведении ФСИН); Очная	"    в том числе:
    переведено на другие формы обучения данной
    организации на программы того же уровня / 7.0"	16	0	0	0	16	3	0	0	0	3	33	0	9	69	111	3	0	0	13	16
Республика Крым	Государственные, муниципальные (без учета организаций в ведении ФСИН); Очная	"    в том числе:
    переведено с других форм обучения данной
    образовательной организации с программ того же уровня / 2.0"	22	0	0	0	22	0	0	0	0	0	26	0	15	15	56	2	0	9	10	21
Республика Крым	Государственные, муниципальные (без учета организаций в ведении ФСИН); Очная	    восстановлены из числа ранее отчисленных / 4.0	17	0	3	0	20	0	0	0	0	0	20	0	8	37	65	6	0	1	16	23
Республика Крым	Государственные, муниципальные (без учета организаций в ведении ФСИН); Очная	    выбыло по другим причинам / 16.0	78	0	0	5	83	2	0	0	4	6	40	0	3	36	79	12	0	1	6	19
Республика Крым	Государственные, муниципальные (без учета организаций в ведении ФСИН); Очная	"    добровольно прекратили образовательные отношения
    (бросили учебу) / 10.0"	260	0	26	12	298	17	0	0	2	19	272	0	108	231	611	156	0	33	113	302
Республика Крым	Государственные, муниципальные (без учета организаций в ведении ФСИН); Очная	"    отчислено:
         по неуспеваемости / 11.0"	81	0	7	0	88	3	0	0	1	4	38	0	17	38	93	15	0	5	27	47
Республика Крым	Государственные, муниципальные (без учета организаций в ведении ФСИН); Очная	"    переведено в другие образовательные организации
    на программы того же уровня / 8.0"	127	0	5	2	134	2	0	0	0	2	91	0	27	117	235	7	0	1	11	19
Республика Крым	Государственные, муниципальные (без учета организаций в ведении ФСИН); Очная	"    переведено из других образовательных организаций 
    с программ того же уровня / 3.0"	74	0	5	7	86	0	0	0	1	1	90	0	4	59	153	10	0	1	12	23
Республика Крым	Государственные, муниципальные (без учета организаций в ведении ФСИН); Очная	    по болезни / 9.0	1	0	0	0	1	0	0	0	0	0	2	0	0	0	2	0	0	0	0	0
Республика Крым	Государственные, муниципальные (без учета организаций в ведении ФСИН); Очная	    прибыло по другим причинам / 5.0	27	0	7	0	34	3	0	0	0	3	22	0	1	32	55	12	0	1	8	21
Республика Крым	Государственные, муниципальные (без учета организаций в ведении ФСИН); Очная	Выбыло студентов - всего (сумма стр. 07-11, 13-15) / 6.0	578	0	38	20	636	27	0	0	7	34	482	0	164	528	1174	193	0	40	178	411
Республика Крым	Государственные, муниципальные (без учета организаций в ведении ФСИН); Очная	Прибыло студентов - всего (сумма стр. 02-05) / 1.0	140	0	15	7	162	3	0	0	1	4	158	0	28	143	329	30	0	12	46	88
Республика Крым	Государственные, муниципальные (без учета организаций в ведении ФСИН); Очная	"Численность студентов на начало прошлого учебного года
(на 1 октября) / 17.0"	9106	0	249	287	9642	570	0	0	97	667	9490	0	2624	5753	17867	2178	0	583	1971	4732
Республика Крым	Очно-заочная; Государственные, муниципальные (без учета организаций в ведении ФСИН)	            из стр. 11 - не прошли итоговую аттестацию / 12.0	0	0	0	0	0	0	0	0	0	0	0	0	0	0	0	0	0	0	0	0
Республика Крым	Очно-заочная; Государственные, муниципальные (без учета организаций в ведении ФСИН)	"            из стр. 11 – лица с ограниченными возможностями здоровья,
            инвалиды, дети-инвалиды / 13.0"	0	0	0	0	0	0	0	0	0	0	0	0	0	0	0	0	0	0	0	0
Республика Крым	Очно-заочная; Государственные, муниципальные (без учета организаций в ведении ФСИН)	         отчислено в виде меры дисциплинарного взыскания / 14.0	0	0	0	0	0	0	0	0	0	0	0	0	0	0	0	0	0	0	0	0
Республика Крым	Очно-заочная; Государственные, муниципальные (без учета организаций в ведении ФСИН)	         отчислено из-за просрочки оплаты обучения / 15.0	0	0	0	0	0	0	0	0	0	0	0	0	0	7	7	0	0	0	0	0
Республика Крым	Очно-заочная; Государственные, муниципальные (без учета организаций в ведении ФСИН)	"    в том числе:
    переведено на другие формы обучения данной
    организации на программы того же уровня / 7.0"	0	0	0	0	0	0	0	0	0	0	0	0	0	5	5	0	0	0	0	0
Республика Крым	Очно-заочная; Государственные, муниципальные (без учета организаций в ведении ФСИН)	"    в том числе:
    переведено с других форм обучения данной
    образовательной организации с программ того же уровня / 2.0"	0	0	0	0	0	0	0	0	0	0	0	0	0	0	0	0	0	0	1	1
Республика Крым	Очно-заочная; Государственные, муниципальные (без учета организаций в ведении ФСИН)	    восстановлены из числа ранее отчисленных / 4.0	0	0	0	0	0	0	0	0	0	0	0	0	0	1	1	0	0	0	0	0
Республика Крым	Очно-заочная; Государственные, муниципальные (без учета организаций в ведении ФСИН)	    выбыло по другим причинам / 16.0	0	0	0	0	0	0	0	0	0	0	0	0	0	0	0	0	0	0	1	1
Республика Крым	Очно-заочная; Государственные, муниципальные (без учета организаций в ведении ФСИН)	"    добровольно прекратили образовательные отношения
    (бросили учебу) / 10.0"	0	0	0	1	1	0	0	0	0	0	0	0	0	35	35	0	0	0	11	11
Республика Крым	Очно-заочная; Государственные, муниципальные (без учета организаций в ведении ФСИН)	"    отчислено:
         по неуспеваемости / 11.0"	0	0	0	0	0	0	0	0	0	0	0	0	0	0	0	0	0	0	2	2
Республика Крым	Очно-заочная; Государственные, муниципальные (без учета организаций в ведении ФСИН)	"    переведено в другие образовательные организации
    на программы того же уровня / 8.0"	0	0	0	0	0	0	0	0	0	0	0	0	0	0	0	0	0	0	3	3
Республика Крым	Очно-заочная; Государственные, муниципальные (без учета организаций в ведении ФСИН)	"    переведено из других образовательных организаций 
    с программ того же уровня / 3.0"	0	0	0	0	0	0	0	0	0	0	0	0	0	0	0	0	0	0	0	0
Республика Крым	Очно-заочная; Государственные, муниципальные (без учета организаций в ведении ФСИН)	    по болезни / 9.0	0	0	0	0	0	0	0	0	0	0	0	0	0	0	0	0	0	0	0	0
Республика Крым	Очно-заочная; Государственные, муниципальные (без учета организаций в ведении ФСИН)	    прибыло по другим причинам / 5.0	0	0	0	0	0	0	0	0	0	0	0	0	0	0	0	0	0	0	0	0
Республика Крым	Очно-заочная; Государственные, муниципальные (без учета организаций в ведении ФСИН)	Выбыло студентов - всего (сумма стр. 07-11, 13-15) / 6.0	0	0	0	1	1	0	0	0	0	0	0	0	0	47	47	0	0	0	17	17
Республика Крым	Очно-заочная; Государственные, муниципальные (без учета организаций в ведении ФСИН)	Прибыло студентов - всего (сумма стр. 02-05) / 1.0	0	0	0	0	0	0	0	0	0	0	0	0	0	1	1	0	0	0	1	1
Республика Крым	Очно-заочная; Государственные, муниципальные (без учета организаций в ведении ФСИН)	"Численность студентов на начало прошлого учебного года
(на 1 октября) / 17.0"	0	0	0	51	51	0	0	0	0	0	0	0	0	312	312	0	0	0	119	119
Республика Крым	Частные; Заочная	            из стр. 11 - не прошли итоговую аттестацию / 12.0	0	0	0	0	0	0	0	0	0	0	0	0	0	0	0	0	0	0	0	0
Республика Крым	Частные; Заочная	"            из стр. 11 – лица с ограниченными возможностями здоровья,
            инвалиды, дети-инвалиды / 13.0"	0	0	0	0	0	0	0	0	0	0	0	0	0	0	0	0	0	0	0	0
Республика Крым	Частные; Заочная	         отчислено в виде меры дисциплинарного взыскания / 14.0	0	0	0	0	0	0	0	0	0	0	0	0	0	0	0	0	0	0	0	0
Республика Крым	Частные; Заочная	         отчислено из-за просрочки оплаты обучения / 15.0	0	0	0	0	0	0	0	0	0	0	0	0	0	0	0	0	0	0	1	1
Республика Крым	Частные; Заочная	"    в том числе:
    переведено на другие формы обучения данной
    организации на программы того же уровня / 7.0"	0	0	0	0	0	0	0	0	0	0	0	0	0	0	0	0	0	0	4	4
Республика Крым	Частные; Заочная	"    в том числе:
    переведено с других форм обучения данной
    образовательной организации с программ того же уровня / 2.0"	0	0	0	0	0	0	0	0	0	0	0	0	0	20	20	0	0	0	13	13
Республика Крым	Частные; Заочная	    восстановлены из числа ранее отчисленных / 4.0	0	0	0	0	0	0	0	0	0	0	0	0	0	0	0	0	0	0	3	3
Республика Крым	Частные; Заочная	    выбыло по другим причинам / 16.0	0	0	0	0	0	0	0	0	0	0	0	0	0	0	0	0	0	0	0	0
Республика Крым	Частные; Заочная	"    добровольно прекратили образовательные отношения
    (бросили учебу) / 10.0"	0	0	0	0	0	0	0	0	0	0	0	0	0	0	0	0	0	0	2	2
Республика Крым	Частные; Заочная	"    отчислено:
         по неуспеваемости / 11.0"	0	0	0	0	0	0	0	0	0	0	0	0	0	0	0	0	0	0	1	1
Республика Крым	Частные; Заочная	"    переведено в другие образовательные организации
    на программы того же уровня / 8.0"	0	0	0	0	0	0	0	0	0	0	0	0	0	0	0	0	0	0	0	0
Республика Крым	Частные; Заочная	"    переведено из других образовательных организаций 
    с программ того же уровня / 3.0"	0	0	0	0	0	0	0	0	0	0	0	0	0	5	5	0	0	0	3	3
Республика Крым	Частные; Заочная	    по болезни / 9.0	0	0	0	0	0	0	0	0	0	0	0	0	0	0	0	0	0	0	0	0
Республика Крым	Частные; Заочная	    прибыло по другим причинам / 5.0	0	0	0	0	0	0	0	0	0	0	0	0	0	0	0	0	0	0	3	3
Республика Крым	Частные; Заочная	Выбыло студентов - всего (сумма стр. 07-11, 13-15) / 6.0	0	0	0	0	0	0	0	0	0	0	0	0	0	0	0	0	0	0	8	8
Республика Крым	Частные; Заочная	Прибыло студентов - всего (сумма стр. 02-05) / 1.0	0	0	0	0	0	0	0	0	0	0	0	0	0	25	25	0	0	0	22	22
Республика Крым	Частные; Заочная	"Численность студентов на начало прошлого учебного года
(на 1 октября) / 17.0"	0	0	0	0	0	0	0	0	0	0	0	0	0	108	108	0	0	0	117	117
Республика Крым	Частные; Очная	            из стр. 11 - не прошли итоговую аттестацию / 12.0	0	0	0	0	0	0	0	0	0	0	0	0	0	30	30	0	0	0	0	0
Республика Крым	Частные; Очная	"            из стр. 11 – лица с ограниченными возможностями здоровья,
            инвалиды, дети-инвалиды / 13.0"	0	0	0	0	0	0	0	0	0	0	0	0	0	1	1	0	0	0	0	0
Республика Крым	Частные; Очная	         отчислено в виде меры дисциплинарного взыскания / 14.0	0	0	0	0	0	0	0	0	0	0	0	0	0	0	0	0	0	0	0	0
Республика Крым	Частные; Очная	         отчислено из-за просрочки оплаты обучения / 15.0	0	0	0	0	0	0	0	0	0	0	0	0	0	15	15	0	0	0	1	1
Республика Крым	Частные; Очная	"    в том числе:
    переведено на другие формы обучения данной
    организации на программы того же уровня / 7.0"	0	0	0	0	0	0	0	0	0	0	0	0	0	150	150	0	0	0	21	21
Республика Крым	Частные; Очная	"    в том числе:
    переведено с других форм обучения данной
    образовательной организации с программ того же уровня / 2.0"	0	0	0	0	0	0	0	0	0	0	0	0	0	99	99	0	0	0	30	30
Республика Крым	Частные; Очная	    восстановлены из числа ранее отчисленных / 4.0	0	0	0	0	0	0	0	0	0	0	0	0	0	82	82	0	0	0	32	32
Республика Крым	Частные; Очная	    выбыло по другим причинам / 16.0	0	0	0	0	0	0	0	0	0	0	0	0	0	32	32	0	0	0	11	11
Республика Крым	Частные; Очная	"    добровольно прекратили образовательные отношения
    (бросили учебу) / 10.0"	0	0	0	0	0	0	0	0	0	0	0	0	0	30	30	0	0	0	16	16
Республика Крым	Частные; Очная	"    отчислено:
         по неуспеваемости / 11.0"	0	0	0	0	0	0	0	0	0	0	0	0	0	140	140	0	0	0	60	60
Республика Крым	Частные; Очная	"    переведено в другие образовательные организации
    на программы того же уровня / 8.0"	0	0	0	0	0	0	0	0	0	0	0	0	0	27	27	0	0	0	9	9
Республика Крым	Частные; Очная	"    переведено из других образовательных организаций 
    с программ того же уровня / 3.0"	0	0	0	0	0	0	0	0	0	0	0	0	0	112	112	0	0	0	9	9
Республика Крым	Частные; Очная	    по болезни / 9.0	0	0	0	0	0	0	0	0	0	0	0	0	0	3	3	0	0	0	1	1
Республика Крым	Частные; Очная	    прибыло по другим причинам / 5.0	0	0	0	0	0	0	0	0	0	0	0	0	0	20	20	0	0	0	44	44
Республика Крым	Частные; Очная	Выбыло студентов - всего (сумма стр. 07-11, 13-15) / 6.0	0	0	0	0	0	0	0	0	0	0	0	0	0	397	397	0	0	0	119	119
Республика Крым	Частные; Очная	Прибыло студентов - всего (сумма стр. 02-05) / 1.0	0	0	0	0	0	0	0	0	0	0	0	0	0	313	313	0	0	0	115	115
Республика Крым	Частные; Очная	"Численность студентов на начало прошлого учебного года
(на 1 октября) / 17.0"	0	0	0	0	0	0	0	0	0	0	0	0	0	3661	3661	0	0	0	1266	1266
Республика Крым	Частные; Очно-заочная	            из стр. 11 - не прошли итоговую аттестацию / 12.0	0	0	0	0	0	0	0	0	0	0	0	0	0	0	0	0	0	0	0	0
Республика Крым	Частные; Очно-заочная	"            из стр. 11 – лица с ограниченными возможностями здоровья,
            инвалиды, дети-инвалиды / 13.0"	0	0	0	0	0	0	0	0	0	0	0	0	0	0	0	0	0	0	0	0
Республика Крым	Частные; Очно-заочная	         отчислено в виде меры дисциплинарного взыскания / 14.0	0	0	0	0	0	0	0	0	0	0	0	0	0	0	0	0	0	0	0	0
Республика Крым	Частные; Очно-заочная	         отчислено из-за просрочки оплаты обучения / 15.0	0	0	0	0	0	0	0	0	0	0	0	0	0	0	0	0	0	0	0	0
Республика Крым	Частные; Очно-заочная	"    в том числе:
    переведено на другие формы обучения данной
    организации на программы того же уровня / 7.0"	0	0	0	0	0	0	0	0	0	0	0	0	0	0	0	0	0	0	0	0
Республика Крым	Частные; Очно-заочная	"    в том числе:
    переведено с других форм обучения данной
    образовательной организации с программ того же уровня / 2.0"	0	0	0	0	0	0	0	0	0	0	0	0	0	0	0	0	0	0	0	0
Республика Крым	Частные; Очно-заочная	    восстановлены из числа ранее отчисленных / 4.0	0	0	0	0	0	0	0	0	0	0	0	0	0	0	0	0	0	0	0	0
Республика Крым	Частные; Очно-заочная	    выбыло по другим причинам / 16.0	0	0	0	0	0	0	0	0	0	0	0	0	0	0	0	0	0	0	0	0
Республика Крым	Частные; Очно-заочная	"    добровольно прекратили образовательные отношения
    (бросили учебу) / 10.0"	0	0	0	0	0	0	0	0	0	0	0	0	0	0	0	0	0	0	40	40
Республика Крым	Частные; Очно-заочная	"    отчислено:
         по неуспеваемости / 11.0"	0	0	0	0	0	0	0	0	0	0	0	0	0	0	0	0	0	0	0	0
Республика Крым	Частные; Очно-заочная	"    переведено в другие образовательные организации
    на программы того же уровня / 8.0"	0	0	0	0	0	0	0	0	0	0	0	0	0	0	0	0	0	0	0	0
Республика Крым	Частные; Очно-заочная	"    переведено из других образовательных организаций 
    с программ того же уровня / 3.0"	0	0	0	0	0	0	0	0	0	0	0	0	0	0	0	0	0	0	2	2
Республика Крым	Частные; Очно-заочная	    по болезни / 9.0	0	0	0	0	0	0	0	0	0	0	0	0	0	0	0	0	0	0	0	0
Республика Крым	Частные; Очно-заочная	    прибыло по другим причинам / 5.0	0	0	0	0	0	0	0	0	0	0	0	0	0	0	0	0	0	0	25	25
Республика Крым	Частные; Очно-заочная	Выбыло студентов - всего (сумма стр. 07-11, 13-15) / 6.0	0	0	0	0	0	0	0	0	0	0	0	0	0	0	0	0	0	0	40	40
Республика Крым	Частные; Очно-заочная	Прибыло студентов - всего (сумма стр. 02-05) / 1.0	0	0	0	0	0	0	0	0	0	0	0	0	0	0	0	0	0	0	27	27
Республика Крым	Частные; Очно-заочная	"Численность студентов на начало прошлого учебного года
(на 1 октября) / 17.0"	0	0	0	0	0	0	0	0	0	0	0	0	0	0	0	0	0	0	432	432
Республика Марий Эл	Государственные, муниципальные (без учета организаций в ведении ФСИН); Заочная	            из стр. 11 - не прошли итоговую аттестацию / 12.0	0	0	0	0	0	0	0	0	0	0	0	0	0	0	0	0	0	0	0	0
Республика Марий Эл	Государственные, муниципальные (без учета организаций в ведении ФСИН); Заочная	"            из стр. 11 – лица с ограниченными возможностями здоровья,
            инвалиды, дети-инвалиды / 13.0"	0	0	0	0	0	0	0	0	0	0	0	0	0	0	0	0	0	0	0	0
Республика Марий Эл	Государственные, муниципальные (без учета организаций в ведении ФСИН); Заочная	         отчислено в виде меры дисциплинарного взыскания / 14.0	0	0	0	0	0	0	0	0	0	0	0	0	0	0	0	0	0	0	0	0
Республика Марий Эл	Государственные, муниципальные (без учета организаций в ведении ФСИН); Заочная	         отчислено из-за просрочки оплаты обучения / 15.0	0	0	0	0	0	0	0	0	0	0	0	0	0	0	0	0	0	0	0	0
Республика Марий Эл	Государственные, муниципальные (без учета организаций в ведении ФСИН); Заочная	"    в том числе:
    переведено на другие формы обучения данной
    организации на программы того же уровня / 7.0"	0	0	0	0	0	0	0	0	0	0	0	0	0	0	0	0	0	0	0	0
Республика Марий Эл	Государственные, муниципальные (без учета организаций в ведении ФСИН); Заочная	"    в том числе:
    переведено с других форм обучения данной
    образовательной организации с программ того же уровня / 2.0"	0	0	0	0	0	0	0	0	0	0	14	0	0	14	28	21	0	0	17	38
Республика Марий Эл	Государственные, муниципальные (без учета организаций в ведении ФСИН); Заочная	    восстановлены из числа ранее отчисленных / 4.0	0	0	0	0	0	0	0	0	0	0	0	0	0	1	1	17	0	0	13	30
Республика Марий Эл	Государственные, муниципальные (без учета организаций в ведении ФСИН); Заочная	    выбыло по другим причинам / 16.0	0	0	0	0	0	0	0	0	0	0	0	0	0	0	0	1	0	0	0	1
Республика Марий Эл	Государственные, муниципальные (без учета организаций в ведении ФСИН); Заочная	"    добровольно прекратили образовательные отношения
    (бросили учебу) / 10.0"	0	0	0	0	0	0	0	0	0	0	3	0	0	14	17	77	0	0	36	113
Республика Марий Эл	Государственные, муниципальные (без учета организаций в ведении ФСИН); Заочная	"    отчислено:
         по неуспеваемости / 11.0"	0	0	0	0	0	0	0	0	0	0	0	0	0	11	11	71	0	0	25	96
Республика Марий Эл	Государственные, муниципальные (без учета организаций в ведении ФСИН); Заочная	"    переведено в другие образовательные организации
    на программы того же уровня / 8.0"	0	0	0	0	0	0	0	0	0	0	3	0	0	0	3	7	0	0	0	7
Республика Марий Эл	Государственные, муниципальные (без учета организаций в ведении ФСИН); Заочная	"    переведено из других образовательных организаций 
    с программ того же уровня / 3.0"	0	0	0	0	0	0	0	0	0	0	0	0	0	1	1	9	0	0	4	13
Республика Марий Эл	Государственные, муниципальные (без учета организаций в ведении ФСИН); Заочная	    по болезни / 9.0	0	0	0	0	0	0	0	0	0	0	0	0	0	0	0	0	0	0	4	4
Республика Марий Эл	Государственные, муниципальные (без учета организаций в ведении ФСИН); Заочная	    прибыло по другим причинам / 5.0	0	0	0	0	0	0	0	0	0	0	0	0	0	0	0	3	0	0	1	4
Республика Марий Эл	Государственные, муниципальные (без учета организаций в ведении ФСИН); Заочная	Выбыло студентов - всего (сумма стр. 07-11, 13-15) / 6.0	0	0	0	0	0	0	0	0	0	0	6	0	0	25	31	156	0	0	65	221
Республика Марий Эл	Государственные, муниципальные (без учета организаций в ведении ФСИН); Заочная	Прибыло студентов - всего (сумма стр. 02-05) / 1.0	0	0	0	0	0	0	0	0	0	0	14	0	0	16	30	50	0	0	35	85
Республика Марий Эл	Государственные, муниципальные (без учета организаций в ведении ФСИН); Заочная	"Численность студентов на начало прошлого учебного года
(на 1 октября) / 17.0"	0	0	0	0	0	0	0	0	0	0	48	0	0	113	161	973	0	0	293	1266
Республика Марий Эл	Государственные, муниципальные (без учета организаций в ведении ФСИН); Очная	            из стр. 11 - не прошли итоговую аттестацию / 12.0	3	0	0	0	3	0	0	0	0	0	2	0	0	0	2	0	0	0	0	0
Республика Марий Эл	Государственные, муниципальные (без учета организаций в ведении ФСИН); Очная	"            из стр. 11 – лица с ограниченными возможностями здоровья,
            инвалиды, дети-инвалиды / 13.0"	0	0	0	0	0	0	0	0	0	0	0	0	0	0	0	0	0	0	0	0
Республика Марий Эл	Государственные, муниципальные (без учета организаций в ведении ФСИН); Очная	         отчислено в виде меры дисциплинарного взыскания / 14.0	4	0	0	0	4	0	0	0	0	0	8	0	0	1	9	0	0	0	0	0
Республика Марий Эл	Государственные, муниципальные (без учета организаций в ведении ФСИН); Очная	         отчислено из-за просрочки оплаты обучения / 15.0	0	0	0	0	0	0	0	0	0	0	0	0	0	1	1	0	0	0	0	0
Республика Марий Эл	Государственные, муниципальные (без учета организаций в ведении ФСИН); Очная	"    в том числе:
    переведено на другие формы обучения данной
    организации на программы того же уровня / 7.0"	11	0	0	0	11	0	0	0	0	0	93	0	0	26	119	12	0	0	5	17
Республика Марий Эл	Государственные, муниципальные (без учета организаций в ведении ФСИН); Очная	"    в том числе:
    переведено с других форм обучения данной
    образовательной организации с программ того же уровня / 2.0"	30	0	0	0	30	0	0	0	0	0	33	0	11	1	45	38	0	0	4	42
Республика Марий Эл	Государственные, муниципальные (без учета организаций в ведении ФСИН); Очная	    восстановлены из числа ранее отчисленных / 4.0	24	0	0	0	24	0	0	0	0	0	33	0	17	17	67	1	0	0	0	1
Республика Марий Эл	Государственные, муниципальные (без учета организаций в ведении ФСИН); Очная	    выбыло по другим причинам / 16.0	18	0	0	0	18	0	0	0	0	0	42	0	0	2	44	0	0	0	0	0
Республика Марий Эл	Государственные, муниципальные (без учета организаций в ведении ФСИН); Очная	"    добровольно прекратили образовательные отношения
    (бросили учебу) / 10.0"	190	0	0	5	195	6	0	0	0	6	527	0	186	112	825	56	0	14	17	87
Республика Марий Эл	Государственные, муниципальные (без учета организаций в ведении ФСИН); Очная	"    отчислено:
         по неуспеваемости / 11.0"	93	0	0	0	93	0	0	0	0	0	254	0	47	30	331	0	0	4	2	6
Республика Марий Эл	Государственные, муниципальные (без учета организаций в ведении ФСИН); Очная	"    переведено в другие образовательные организации
    на программы того же уровня / 8.0"	18	0	0	0	18	0	0	0	0	0	90	0	55	20	165	1	0	3	7	11
Республика Марий Эл	Государственные, муниципальные (без учета организаций в ведении ФСИН); Очная	"    переведено из других образовательных организаций 
    с программ того же уровня / 3.0"	43	0	0	0	43	0	0	0	0	0	61	0	25	15	101	2	0	0	0	2
Республика Марий Эл	Государственные, муниципальные (без учета организаций в ведении ФСИН); Очная	    по болезни / 9.0	3	0	0	0	3	1	0	0	0	1	3	0	0	0	3	0	0	0	0	0
Республика Марий Эл	Государственные, муниципальные (без учета организаций в ведении ФСИН); Очная	    прибыло по другим причинам / 5.0	31	0	0	0	31	0	0	0	0	0	19	0	29	4	52	0	0	0	3	3
Республика Марий Эл	Государственные, муниципальные (без учета организаций в ведении ФСИН); Очная	Выбыло студентов - всего (сумма стр. 07-11, 13-15) / 6.0	337	0	0	5	342	7	0	0	0	7	1017	0	288	192	1497	69	0	21	31	121
Республика Марий Эл	Государственные, муниципальные (без учета организаций в ведении ФСИН); Очная	Прибыло студентов - всего (сумма стр. 02-05) / 1.0	128	0	0	0	128	0	0	0	0	0	146	0	82	37	265	41	0	0	7	48
Республика Марий Эл	Государственные, муниципальные (без учета организаций в ведении ФСИН); Очная	"Численность студентов на начало прошлого учебного года
(на 1 октября) / 17.0"	1761	0	0	26	1787	20	0	0	0	20	7254	0	2998	1160	11412	680	0	149	198	1027
Республика Марий Эл	Очно-заочная; Государственные, муниципальные (без учета организаций в ведении ФСИН)	            из стр. 11 - не прошли итоговую аттестацию / 12.0	0	0	0	0	0	0	0	0	0	0	0	0	0	0	0	0	0	0	0	0
Республика Марий Эл	Очно-заочная; Государственные, муниципальные (без учета организаций в ведении ФСИН)	"            из стр. 11 – лица с ограниченными возможностями здоровья,
            инвалиды, дети-инвалиды / 13.0"	0	0	0	0	0	0	0	0	0	0	0	0	0	0	0	0	0	0	0	0
Республика Марий Эл	Очно-заочная; Государственные, муниципальные (без учета организаций в ведении ФСИН)	         отчислено в виде меры дисциплинарного взыскания / 14.0	0	0	0	0	0	0	0	0	0	0	0	0	0	0	0	0	0	0	0	0
Республика Марий Эл	Очно-заочная; Государственные, муниципальные (без учета организаций в ведении ФСИН)	         отчислено из-за просрочки оплаты обучения / 15.0	0	0	0	0	0	0	0	0	0	0	0	0	0	0	0	0	0	0	0	0
Республика Марий Эл	Очно-заочная; Государственные, муниципальные (без учета организаций в ведении ФСИН)	"    в том числе:
    переведено на другие формы обучения данной
    организации на программы того же уровня / 7.0"	0	0	0	0	0	0	0	0	0	0	0	0	0	0	0	0	0	0	0	0
Республика Марий Эл	Очно-заочная; Государственные, муниципальные (без учета организаций в ведении ФСИН)	"    в том числе:
    переведено с других форм обучения данной
    образовательной организации с программ того же уровня / 2.0"	0	0	0	0	0	0	0	0	0	0	0	0	0	0	0	0	0	0	0	0
Республика Марий Эл	Очно-заочная; Государственные, муниципальные (без учета организаций в ведении ФСИН)	    восстановлены из числа ранее отчисленных / 4.0	0	0	0	0	0	0	0	0	0	0	0	0	0	0	0	0	0	0	0	0
Республика Марий Эл	Очно-заочная; Государственные, муниципальные (без учета организаций в ведении ФСИН)	    выбыло по другим причинам / 16.0	0	0	0	0	0	0	0	0	0	0	0	0	0	0	0	0	0	0	0	0
Республика Марий Эл	Очно-заочная; Государственные, муниципальные (без учета организаций в ведении ФСИН)	"    добровольно прекратили образовательные отношения
    (бросили учебу) / 10.0"	0	0	0	0	0	0	0	0	0	0	0	0	0	0	0	0	0	0	0	0
Республика Марий Эл	Очно-заочная; Государственные, муниципальные (без учета организаций в ведении ФСИН)	"    отчислено:
         по неуспеваемости / 11.0"	0	0	0	0	0	0	0	0	0	0	0	0	0	0	0	0	0	0	0	0
Республика Марий Эл	Очно-заочная; Государственные, муниципальные (без учета организаций в ведении ФСИН)	"    переведено в другие образовательные организации
    на программы того же уровня / 8.0"	0	0	0	0	0	0	0	0	0	0	0	0	0	0	0	0	0	0	0	0
Республика Марий Эл	Очно-заочная; Государственные, муниципальные (без учета организаций в ведении ФСИН)	"    переведено из других образовательных организаций 
    с программ того же уровня / 3.0"	0	0	0	0	0	0	0	0	0	0	0	0	0	0	0	0	0	0	0	0
Республика Марий Эл	Очно-заочная; Государственные, муниципальные (без учета организаций в ведении ФСИН)	    по болезни / 9.0	0	0	0	0	0	0	0	0	0	0	0	0	0	0	0	0	0	0	0	0
Республика Марий Эл	Очно-заочная; Государственные, муниципальные (без учета организаций в ведении ФСИН)	    прибыло по другим причинам / 5.0	0	0	0	0	0	0	0	0	0	0	0	0	0	0	0	0	0	0	0	0
Республика Марий Эл	Очно-заочная; Государственные, муниципальные (без учета организаций в ведении ФСИН)	Выбыло студентов - всего (сумма стр. 07-11, 13-15) / 6.0	0	0	0	0	0	0	0	0	0	0	0	0	0	0	0	0	0	0	0	0
Республика Марий Эл	Очно-заочная; Государственные, муниципальные (без учета организаций в ведении ФСИН)	Прибыло студентов - всего (сумма стр. 02-05) / 1.0	0	0	0	0	0	0	0	0	0	0	0	0	0	0	0	0	0	0	0	0
Республика Марий Эл	Очно-заочная; Государственные, муниципальные (без учета организаций в ведении ФСИН)	"Численность студентов на начало прошлого учебного года
(на 1 октября) / 17.0"	0	0	0	0	0	0	0	0	0	0	0	0	0	0	0	0	0	0	0	0
Республика Марий Эл	Частные; Заочная	            из стр. 11 - не прошли итоговую аттестацию / 12.0	0	0	0	0	0	0	0	0	0	0	0	0	0	0	0	0	0	0	0	0
Республика Марий Эл	Частные; Заочная	"            из стр. 11 – лица с ограниченными возможностями здоровья,
            инвалиды, дети-инвалиды / 13.0"	0	0	0	0	0	0	0	0	0	0	0	0	0	0	0	0	0	0	0	0
Республика Марий Эл	Частные; Заочная	         отчислено в виде меры дисциплинарного взыскания / 14.0	0	0	0	0	0	0	0	0	0	0	0	0	0	0	0	0	0	0	0	0
Республика Марий Эл	Частные; Заочная	         отчислено из-за просрочки оплаты обучения / 15.0	0	0	0	0	0	0	0	0	0	0	0	0	0	0	0	0	0	0	0	0
Республика Марий Эл	Частные; Заочная	"    в том числе:
    переведено на другие формы обучения данной
    организации на программы того же уровня / 7.0"	0	0	0	0	0	0	0	0	0	0	0	0	0	0	0	0	0	0	0	0
Республика Марий Эл	Частные; Заочная	"    в том числе:
    переведено с других форм обучения данной
    образовательной организации с программ того же уровня / 2.0"	0	0	0	0	0	0	0	0	0	0	0	0	0	0	0	0	0	0	0	0
Республика Марий Эл	Частные; Заочная	    восстановлены из числа ранее отчисленных / 4.0	0	0	0	0	0	0	0	0	0	0	0	0	0	0	0	0	0	0	0	0
Республика Марий Эл	Частные; Заочная	    выбыло по другим причинам / 16.0	0	0	0	0	0	0	0	0	0	0	0	0	0	0	0	0	0	0	0	0
Республика Марий Эл	Частные; Заочная	"    добровольно прекратили образовательные отношения
    (бросили учебу) / 10.0"	0	0	0	0	0	0	0	0	0	0	0	0	0	0	0	0	0	0	4	4
Республика Марий Эл	Частные; Заочная	"    отчислено:
         по неуспеваемости / 11.0"	0	0	0	0	0	0	0	0	0	0	0	0	0	0	0	0	0	0	0	0
Республика Марий Эл	Частные; Заочная	"    переведено в другие образовательные организации
    на программы того же уровня / 8.0"	0	0	0	0	0	0	0	0	0	0	0	0	0	0	0	0	0	0	0	0
Республика Марий Эл	Частные; Заочная	"    переведено из других образовательных организаций 
    с программ того же уровня / 3.0"	0	0	0	0	0	0	0	0	0	0	0	0	0	0	0	0	0	0	0	0
Республика Марий Эл	Частные; Заочная	    по болезни / 9.0	0	0	0	0	0	0	0	0	0	0	0	0	0	0	0	0	0	0	0	0
Республика Марий Эл	Частные; Заочная	    прибыло по другим причинам / 5.0	0	0	0	0	0	0	0	0	0	0	0	0	0	0	0	0	0	0	20	20
Республика Марий Эл	Частные; Заочная	Выбыло студентов - всего (сумма стр. 07-11, 13-15) / 6.0	0	0	0	0	0	0	0	0	0	0	0	0	0	0	0	0	0	0	4	4
Республика Марий Эл	Частные; Заочная	Прибыло студентов - всего (сумма стр. 02-05) / 1.0	0	0	0	0	0	0	0	0	0	0	0	0	0	0	0	0	0	0	20	20
Республика Марий Эл	Частные; Заочная	"Численность студентов на начало прошлого учебного года
(на 1 октября) / 17.0"	0	0	0	0	0	0	0	0	0	0	0	0	0	0	0	0	0	0	32	32
Республика Марий Эл	Частные; Очная	            из стр. 11 - не прошли итоговую аттестацию / 12.0	0	0	0	0	0	0	0	0	0	0	0	0	0	0	0	0	0	0	0	0
Республика Марий Эл	Частные; Очная	"            из стр. 11 – лица с ограниченными возможностями здоровья,
            инвалиды, дети-инвалиды / 13.0"	0	0	0	0	0	0	0	0	0	0	0	0	0	0	0	0	0	0	0	0
Республика Марий Эл	Частные; Очная	         отчислено в виде меры дисциплинарного взыскания / 14.0	0	0	0	0	0	0	0	0	0	0	0	0	0	0	0	0	0	0	0	0
Республика Марий Эл	Частные; Очная	         отчислено из-за просрочки оплаты обучения / 15.0	0	0	0	0	0	0	0	0	0	0	0	0	0	36	36	0	0	0	4	4
Республика Марий Эл	Частные; Очная	"    в том числе:
    переведено на другие формы обучения данной
    организации на программы того же уровня / 7.0"	0	0	0	0	0	0	0	0	0	0	0	0	0	0	0	0	0	0	0	0
Республика Марий Эл	Частные; Очная	"    в том числе:
    переведено с других форм обучения данной
    образовательной организации с программ того же уровня / 2.0"	0	0	0	0	0	0	0	0	0	0	0	0	0	0	0	0	0	0	0	0
Республика Марий Эл	Частные; Очная	    восстановлены из числа ранее отчисленных / 4.0	0	0	0	0	0	0	0	0	0	0	0	0	0	10	10	0	0	0	4	4
Республика Марий Эл	Частные; Очная	    выбыло по другим причинам / 16.0	0	0	0	0	0	0	0	0	0	0	0	0	0	3	3	0	0	0	0	0
Республика Марий Эл	Частные; Очная	"    добровольно прекратили образовательные отношения
    (бросили учебу) / 10.0"	0	0	0	0	0	0	0	0	0	0	0	0	0	53	53	0	0	0	1	1
Республика Марий Эл	Частные; Очная	"    отчислено:
         по неуспеваемости / 11.0"	0	0	0	0	0	0	0	0	0	0	0	0	0	7	7	0	0	0	7	7
Республика Марий Эл	Частные; Очная	"    переведено в другие образовательные организации
    на программы того же уровня / 8.0"	0	0	0	0	0	0	0	0	0	0	0	0	0	52	52	0	0	0	3	3
Республика Марий Эл	Частные; Очная	"    переведено из других образовательных организаций 
    с программ того же уровня / 3.0"	0	0	0	0	0	0	0	0	0	0	0	0	0	22	22	0	0	0	1	1
Республика Марий Эл	Частные; Очная	    по болезни / 9.0	0	0	0	0	0	0	0	0	0	0	0	0	0	0	0	0	0	0	0	0
Республика Марий Эл	Частные; Очная	    прибыло по другим причинам / 5.0	0	0	0	0	0	0	0	0	0	0	0	0	0	20	20	0	0	0	6	6
Республика Марий Эл	Частные; Очная	Выбыло студентов - всего (сумма стр. 07-11, 13-15) / 6.0	0	0	0	0	0	0	0	0	0	0	0	0	0	151	151	0	0	0	15	15
Республика Марий Эл	Частные; Очная	Прибыло студентов - всего (сумма стр. 02-05) / 1.0	0	0	0	0	0	0	0	0	0	0	0	0	0	52	52	0	0	0	11	11
Республика Марий Эл	Частные; Очная	"Численность студентов на начало прошлого учебного года
(на 1 октября) / 17.0"	0	0	0	0	0	0	0	0	0	0	0	0	0	1409	1409	0	0	0	214	214
Республика Марий Эл	Частные; Очно-заочная	            из стр. 11 - не прошли итоговую аттестацию / 12.0	0	0	0	0	0	0	0	0	0	0	0	0	0	0	0	0	0	0	0	0
Республика Марий Эл	Частные; Очно-заочная	"            из стр. 11 – лица с ограниченными возможностями здоровья,
            инвалиды, дети-инвалиды / 13.0"	0	0	0	0	0	0	0	0	0	0	0	0	0	0	0	0	0	0	0	0
Республика Марий Эл	Частные; Очно-заочная	         отчислено в виде меры дисциплинарного взыскания / 14.0	0	0	0	0	0	0	0	0	0	0	0	0	0	0	0	0	0	0	0	0
Республика Марий Эл	Частные; Очно-заочная	         отчислено из-за просрочки оплаты обучения / 15.0	0	0	0	0	0	0	0	0	0	0	0	0	0	0	0	0	0	0	4	4
Республика Марий Эл	Частные; Очно-заочная	"    в том числе:
    переведено на другие формы обучения данной
    организации на программы того же уровня / 7.0"	0	0	0	0	0	0	0	0	0	0	0	0	0	0	0	0	0	0	0	0
Республика Марий Эл	Частные; Очно-заочная	"    в том числе:
    переведено с других форм обучения данной
    образовательной организации с программ того же уровня / 2.0"	0	0	0	0	0	0	0	0	0	0	0	0	0	0	0	0	0	0	0	0
Республика Марий Эл	Частные; Очно-заочная	    восстановлены из числа ранее отчисленных / 4.0	0	0	0	0	0	0	0	0	0	0	0	0	0	0	0	0	0	0	0	0
Республика Марий Эл	Частные; Очно-заочная	    выбыло по другим причинам / 16.0	0	0	0	0	0	0	0	0	0	0	0	0	0	0	0	0	0	0	0	0
Республика Марий Эл	Частные; Очно-заочная	"    добровольно прекратили образовательные отношения
    (бросили учебу) / 10.0"	0	0	0	0	0	0	0	0	0	0	0	0	0	0	0	0	0	0	0	0
Республика Марий Эл	Частные; Очно-заочная	"    отчислено:
         по неуспеваемости / 11.0"	0	0	0	0	0	0	0	0	0	0	0	0	0	0	0	0	0	0	6	6
Республика Марий Эл	Частные; Очно-заочная	"    переведено в другие образовательные организации
    на программы того же уровня / 8.0"	0	0	0	0	0	0	0	0	0	0	0	0	0	0	0	0	0	0	0	0
Республика Марий Эл	Частные; Очно-заочная	"    переведено из других образовательных организаций 
    с программ того же уровня / 3.0"	0	0	0	0	0	0	0	0	0	0	0	0	0	0	0	0	0	0	0	0
Республика Марий Эл	Частные; Очно-заочная	    по болезни / 9.0	0	0	0	0	0	0	0	0	0	0	0	0	0	0	0	0	0	0	0	0
Республика Марий Эл	Частные; Очно-заочная	    прибыло по другим причинам / 5.0	0	0	0	0	0	0	0	0	0	0	0	0	0	0	0	0	0	0	0	0
Республика Марий Эл	Частные; Очно-заочная	Выбыло студентов - всего (сумма стр. 07-11, 13-15) / 6.0	0	0	0	0	0	0	0	0	0	0	0	0	0	0	0	0	0	0	10	10
Республика Марий Эл	Частные; Очно-заочная	Прибыло студентов - всего (сумма стр. 02-05) / 1.0	0	0	0	0	0	0	0	0	0	0	0	0	0	0	0	0	0	0	0	0
Республика Марий Эл	Частные; Очно-заочная	"Численность студентов на начало прошлого учебного года
(на 1 октября) / 17.0"	0	0	0	0	0	0	0	0	0	0	0	0	0	0	0	0	0	0	120	120
Республика Мордовия	Государственные, муниципальные (без учета организаций в ведении ФСИН); Заочная	            из стр. 11 - не прошли итоговую аттестацию / 12.0	0	0	0	0	0	0	0	0	0	0	0	0	0	0	0	0	0	0	0	0
Республика Мордовия	Государственные, муниципальные (без учета организаций в ведении ФСИН); Заочная	"            из стр. 11 – лица с ограниченными возможностями здоровья,
            инвалиды, дети-инвалиды / 13.0"	0	0	0	0	0	0	0	0	0	0	0	0	0	0	0	0	0	0	0	0
Республика Мордовия	Государственные, муниципальные (без учета организаций в ведении ФСИН); Заочная	         отчислено в виде меры дисциплинарного взыскания / 14.0	0	0	0	0	0	0	0	0	0	0	0	0	0	0	0	0	0	0	0	0
Республика Мордовия	Государственные, муниципальные (без учета организаций в ведении ФСИН); Заочная	         отчислено из-за просрочки оплаты обучения / 15.0	0	0	0	0	0	0	0	0	0	0	0	0	0	0	0	0	0	0	2	2
Республика Мордовия	Государственные, муниципальные (без учета организаций в ведении ФСИН); Заочная	"    в том числе:
    переведено на другие формы обучения данной
    организации на программы того же уровня / 7.0"	0	0	0	0	0	0	0	0	0	0	0	0	0	0	0	0	0	0	0	0
Республика Мордовия	Государственные, муниципальные (без учета организаций в ведении ФСИН); Заочная	"    в том числе:
    переведено с других форм обучения данной
    образовательной организации с программ того же уровня / 2.0"	0	0	0	0	0	0	0	0	0	0	0	0	0	0	0	2	0	0	12	14
Республика Мордовия	Государственные, муниципальные (без учета организаций в ведении ФСИН); Заочная	    восстановлены из числа ранее отчисленных / 4.0	0	0	0	0	0	0	0	0	0	0	0	0	0	0	0	1	0	0	3	4
Республика Мордовия	Государственные, муниципальные (без учета организаций в ведении ФСИН); Заочная	    выбыло по другим причинам / 16.0	0	0	0	0	0	0	0	0	0	0	0	0	0	0	0	13	0	0	6	19
Республика Мордовия	Государственные, муниципальные (без учета организаций в ведении ФСИН); Заочная	"    добровольно прекратили образовательные отношения
    (бросили учебу) / 10.0"	0	0	0	0	0	0	0	0	0	0	0	0	0	0	0	22	0	0	26	48
Республика Мордовия	Государственные, муниципальные (без учета организаций в ведении ФСИН); Заочная	"    отчислено:
         по неуспеваемости / 11.0"	0	0	0	0	0	0	0	0	0	0	0	0	0	0	0	0	0	0	4	4
Республика Мордовия	Государственные, муниципальные (без учета организаций в ведении ФСИН); Заочная	"    переведено в другие образовательные организации
    на программы того же уровня / 8.0"	0	0	0	0	0	0	0	0	0	0	0	0	0	0	0	0	0	0	7	7
Республика Мордовия	Государственные, муниципальные (без учета организаций в ведении ФСИН); Заочная	"    переведено из других образовательных организаций 
    с программ того же уровня / 3.0"	0	0	0	0	0	0	0	0	0	0	0	0	0	0	0	1	0	0	3	4
Республика Мордовия	Государственные, муниципальные (без учета организаций в ведении ФСИН); Заочная	    по болезни / 9.0	0	0	0	0	0	0	0	0	0	0	0	0	0	0	0	0	0	0	0	0
Республика Мордовия	Государственные, муниципальные (без учета организаций в ведении ФСИН); Заочная	    прибыло по другим причинам / 5.0	0	0	0	0	0	0	0	0	0	0	0	0	0	0	0	2	0	0	13	15
Республика Мордовия	Государственные, муниципальные (без учета организаций в ведении ФСИН); Заочная	Выбыло студентов - всего (сумма стр. 07-11, 13-15) / 6.0	0	0	0	0	0	0	0	0	0	0	0	0	0	0	0	35	0	0	45	80
Республика Мордовия	Государственные, муниципальные (без учета организаций в ведении ФСИН); Заочная	Прибыло студентов - всего (сумма стр. 02-05) / 1.0	0	0	0	0	0	0	0	0	0	0	0	0	0	0	0	6	0	0	31	37
Республика Мордовия	Государственные, муниципальные (без учета организаций в ведении ФСИН); Заочная	"Численность студентов на начало прошлого учебного года
(на 1 октября) / 17.0"	0	0	0	0	0	0	0	0	0	0	0	0	0	0	0	389	0	0	429	818
Республика Мордовия	Государственные, муниципальные (без учета организаций в ведении ФСИН); Очная	            из стр. 11 - не прошли итоговую аттестацию / 12.0	2	0	0	0	2	0	0	0	0	0	8	0	0	1	9	0	0	0	0	0
Республика Мордовия	Государственные, муниципальные (без учета организаций в ведении ФСИН); Очная	"            из стр. 11 – лица с ограниченными возможностями здоровья,
            инвалиды, дети-инвалиды / 13.0"	0	0	0	0	0	0	0	0	0	0	0	0	1	0	1	0	0	0	0	0
Республика Мордовия	Государственные, муниципальные (без учета организаций в ведении ФСИН); Очная	         отчислено в виде меры дисциплинарного взыскания / 14.0	1	0	0	0	1	0	0	0	0	0	1	0	0	5	6	0	0	0	0	0
Республика Мордовия	Государственные, муниципальные (без учета организаций в ведении ФСИН); Очная	         отчислено из-за просрочки оплаты обучения / 15.0	0	0	0	0	0	0	0	0	0	0	0	0	0	16	16	0	0	0	2	2
Республика Мордовия	Государственные, муниципальные (без учета организаций в ведении ФСИН); Очная	"    в том числе:
    переведено на другие формы обучения данной
    организации на программы того же уровня / 7.0"	4	0	20	6	30	0	0	0	0	0	15	0	0	4	19	0	0	0	0	0
Республика Мордовия	Государственные, муниципальные (без учета организаций в ведении ФСИН); Очная	"    в том числе:
    переведено с других форм обучения данной
    образовательной организации с программ того же уровня / 2.0"	31	0	1	0	32	0	0	0	0	0	3	0	4	4	11	1	0	0	0	1
Республика Мордовия	Государственные, муниципальные (без учета организаций в ведении ФСИН); Очная	    восстановлены из числа ранее отчисленных / 4.0	4	0	0	0	4	0	0	0	0	0	18	0	0	16	34	1	0	0	0	1
Республика Мордовия	Государственные, муниципальные (без учета организаций в ведении ФСИН); Очная	    выбыло по другим причинам / 16.0	29	0	0	2	31	0	0	0	0	0	70	0	0	28	98	0	0	0	3	3
Республика Мордовия	Государственные, муниципальные (без учета организаций в ведении ФСИН); Очная	"    добровольно прекратили образовательные отношения
    (бросили учебу) / 10.0"	51	0	3	6	60	2	0	0	2	4	215	0	16	103	334	10	0	4	14	28
Республика Мордовия	Государственные, муниципальные (без учета организаций в ведении ФСИН); Очная	"    отчислено:
         по неуспеваемости / 11.0"	46	0	5	0	51	1	0	0	2	3	160	0	11	51	222	9	0	0	19	28
Республика Мордовия	Государственные, муниципальные (без учета организаций в ведении ФСИН); Очная	"    переведено в другие образовательные организации
    на программы того же уровня / 8.0"	20	0	2	0	22	3	0	0	0	3	109	1	9	73	192	2	0	0	7	9
Республика Мордовия	Государственные, муниципальные (без учета организаций в ведении ФСИН); Очная	"    переведено из других образовательных организаций 
    с программ того же уровня / 3.0"	4	0	4	3	11	0	0	0	0	0	49	0	4	45	98	1	0	0	0	1
Республика Мордовия	Государственные, муниципальные (без учета организаций в ведении ФСИН); Очная	    по болезни / 9.0	6	0	0	0	6	0	0	0	0	0	8	0	0	1	9	0	0	0	0	0
Республика Мордовия	Государственные, муниципальные (без учета организаций в ведении ФСИН); Очная	    прибыло по другим причинам / 5.0	12	0	2	1	15	0	0	0	2	2	50	0	6	51	107	8	0	0	19	27
Республика Мордовия	Государственные, муниципальные (без учета организаций в ведении ФСИН); Очная	Выбыло студентов - всего (сумма стр. 07-11, 13-15) / 6.0	157	0	30	14	201	6	0	0	4	10	578	1	36	281	896	21	0	4	45	70
Республика Мордовия	Государственные, муниципальные (без учета организаций в ведении ФСИН); Очная	Прибыло студентов - всего (сумма стр. 02-05) / 1.0	51	0	7	4	62	0	0	0	2	2	120	0	14	116	250	11	0	0	19	30
Республика Мордовия	Государственные, муниципальные (без учета организаций в ведении ФСИН); Очная	"Численность студентов на начало прошлого учебного года
(на 1 октября) / 17.0"	1310	0	296	79	1685	68	0	0	6	74	7892	0	1539	3282	12713	297	0	38	306	641
Республика Мордовия	Частные; Заочная	            из стр. 11 - не прошли итоговую аттестацию / 12.0	0	0	0	0	0	0	0	0	0	0	0	0	0	0	0	0	0	0	0	0
Республика Мордовия	Частные; Заочная	"            из стр. 11 – лица с ограниченными возможностями здоровья,
            инвалиды, дети-инвалиды / 13.0"	0	0	0	0	0	0	0	0	0	0	0	0	0	0	0	0	0	0	0	0
Республика Мордовия	Частные; Заочная	         отчислено в виде меры дисциплинарного взыскания / 14.0	0	0	0	0	0	0	0	0	0	0	0	0	0	0	0	0	0	0	0	0
Республика Мордовия	Частные; Заочная	         отчислено из-за просрочки оплаты обучения / 15.0	0	0	0	0	0	0	0	0	0	0	0	0	0	0	0	0	0	0	2	2
Республика Мордовия	Частные; Заочная	"    в том числе:
    переведено на другие формы обучения данной
    организации на программы того же уровня / 7.0"	0	0	0	0	0	0	0	0	0	0	0	0	0	0	0	0	0	0	0	0
Республика Мордовия	Частные; Заочная	"    в том числе:
    переведено с других форм обучения данной
    образовательной организации с программ того же уровня / 2.0"	0	0	0	0	0	0	0	0	0	0	0	0	0	0	0	0	0	0	0	0
Республика Мордовия	Частные; Заочная	    восстановлены из числа ранее отчисленных / 4.0	0	0	0	0	0	0	0	0	0	0	0	0	0	0	0	0	0	0	1	1
Республика Мордовия	Частные; Заочная	    выбыло по другим причинам / 16.0	0	0	0	0	0	0	0	0	0	0	0	0	0	0	0	0	0	0	1	1
Республика Мордовия	Частные; Заочная	"    добровольно прекратили образовательные отношения
    (бросили учебу) / 10.0"	0	0	0	0	0	0	0	0	0	0	0	0	0	0	0	0	0	0	2	2
Республика Мордовия	Частные; Заочная	"    отчислено:
         по неуспеваемости / 11.0"	0	0	0	0	0	0	0	0	0	0	0	0	0	0	0	0	0	0	2	2
Республика Мордовия	Частные; Заочная	"    переведено в другие образовательные организации
    на программы того же уровня / 8.0"	0	0	0	0	0	0	0	0	0	0	0	0	0	0	0	0	0	0	0	0
Республика Мордовия	Частные; Заочная	"    переведено из других образовательных организаций 
    с программ того же уровня / 3.0"	0	0	0	0	0	0	0	0	0	0	0	0	0	0	0	0	0	0	0	0
Республика Мордовия	Частные; Заочная	    по болезни / 9.0	0	0	0	0	0	0	0	0	0	0	0	0	0	0	0	0	0	0	0	0
Республика Мордовия	Частные; Заочная	    прибыло по другим причинам / 5.0	0	0	0	0	0	0	0	0	0	0	0	0	0	0	0	0	0	0	0	0
Республика Мордовия	Частные; Заочная	Выбыло студентов - всего (сумма стр. 07-11, 13-15) / 6.0	0	0	0	0	0	0	0	0	0	0	0	0	0	0	0	0	0	0	7	7
Республика Мордовия	Частные; Заочная	Прибыло студентов - всего (сумма стр. 02-05) / 1.0	0	0	0	0	0	0	0	0	0	0	0	0	0	0	0	0	0	0	1	1
Республика Мордовия	Частные; Заочная	"Численность студентов на начало прошлого учебного года
(на 1 октября) / 17.0"	0	0	0	0	0	0	0	0	0	0	0	0	0	0	0	0	0	0	42	42
Республика Мордовия	Частные; Очная	            из стр. 11 - не прошли итоговую аттестацию / 12.0	0	0	0	0	0	0	0	0	0	0	0	0	0	1	1	0	0	0	1	1
Республика Мордовия	Частные; Очная	"            из стр. 11 – лица с ограниченными возможностями здоровья,
            инвалиды, дети-инвалиды / 13.0"	0	0	0	0	0	0	0	0	0	0	0	0	0	0	0	0	0	0	0	0
Республика Мордовия	Частные; Очная	         отчислено в виде меры дисциплинарного взыскания / 14.0	0	0	0	0	0	0	0	0	0	0	0	0	0	0	0	0	0	0	0	0
Республика Мордовия	Частные; Очная	         отчислено из-за просрочки оплаты обучения / 15.0	0	0	0	0	0	0	0	0	0	0	0	0	0	9	9	0	0	0	4	4
Республика Мордовия	Частные; Очная	"    в том числе:
    переведено на другие формы обучения данной
    организации на программы того же уровня / 7.0"	0	0	0	0	0	0	0	0	0	0	0	0	0	0	0	0	0	0	0	0
Республика Мордовия	Частные; Очная	"    в том числе:
    переведено с других форм обучения данной
    образовательной организации с программ того же уровня / 2.0"	0	0	0	0	0	0	0	0	0	0	0	0	0	0	0	0	0	0	0	0
Республика Мордовия	Частные; Очная	    восстановлены из числа ранее отчисленных / 4.0	0	0	0	0	0	0	0	0	0	0	0	0	0	1	1	0	0	0	2	2
Республика Мордовия	Частные; Очная	    выбыло по другим причинам / 16.0	0	0	0	0	0	0	0	0	0	0	0	0	0	0	0	0	0	0	0	0
Республика Мордовия	Частные; Очная	"    добровольно прекратили образовательные отношения
    (бросили учебу) / 10.0"	0	0	0	0	0	0	0	0	0	0	0	0	0	22	22	0	0	0	6	6
Республика Мордовия	Частные; Очная	"    отчислено:
         по неуспеваемости / 11.0"	0	0	0	0	0	0	0	0	0	0	0	0	0	7	7	0	0	0	1	1
Республика Мордовия	Частные; Очная	"    переведено в другие образовательные организации
    на программы того же уровня / 8.0"	0	0	0	0	0	0	0	0	0	0	0	0	0	2	2	0	0	0	0	0
Республика Мордовия	Частные; Очная	"    переведено из других образовательных организаций 
    с программ того же уровня / 3.0"	0	0	0	0	0	0	0	0	0	0	0	0	0	38	38	0	0	0	5	5
Республика Мордовия	Частные; Очная	    по болезни / 9.0	0	0	0	0	0	0	0	0	0	0	0	0	0	0	0	0	0	0	0	0
Республика Мордовия	Частные; Очная	    прибыло по другим причинам / 5.0	0	0	0	0	0	0	0	0	0	0	0	0	0	0	0	0	0	0	0	0
Республика Мордовия	Частные; Очная	Выбыло студентов - всего (сумма стр. 07-11, 13-15) / 6.0	0	0	0	0	0	0	0	0	0	0	0	0	0	40	40	0	0	0	11	11
Республика Мордовия	Частные; Очная	Прибыло студентов - всего (сумма стр. 02-05) / 1.0	0	0	0	0	0	0	0	0	0	0	0	0	0	39	39	0	0	0	7	7
Республика Мордовия	Частные; Очная	"Численность студентов на начало прошлого учебного года
(на 1 октября) / 17.0"	0	0	0	0	0	0	0	0	0	0	0	0	0	842	842	0	0	0	146	146
Республика Саха (Якутия)	Государственные, муниципальные (без учета организаций в ведении ФСИН); Заочная	            из стр. 11 - не прошли итоговую аттестацию / 12.0	0	0	0	0	0	0	0	0	0	0	0	0	0	0	0	0	0	12	0	12
Республика Саха (Якутия)	Государственные, муниципальные (без учета организаций в ведении ФСИН); Заочная	"            из стр. 11 – лица с ограниченными возможностями здоровья,
            инвалиды, дети-инвалиды / 13.0"	0	0	0	0	0	0	0	0	0	0	0	0	0	0	0	0	0	0	0	0
Республика Саха (Якутия)	Государственные, муниципальные (без учета организаций в ведении ФСИН); Заочная	         отчислено в виде меры дисциплинарного взыскания / 14.0	0	0	0	0	0	0	0	0	0	0	0	0	0	0	0	0	0	0	0	0
Республика Саха (Якутия)	Государственные, муниципальные (без учета организаций в ведении ФСИН); Заочная	         отчислено из-за просрочки оплаты обучения / 15.0	0	0	0	0	0	0	0	0	0	0	0	0	0	0	0	0	0	0	0	0
Республика Саха (Якутия)	Государственные, муниципальные (без учета организаций в ведении ФСИН); Заочная	"    в том числе:
    переведено на другие формы обучения данной
    организации на программы того же уровня / 7.0"	0	0	0	0	0	0	0	0	0	0	0	0	0	0	0	2	0	2	30	34
Республика Саха (Якутия)	Государственные, муниципальные (без учета организаций в ведении ФСИН); Заочная	"    в том числе:
    переведено с других форм обучения данной
    образовательной организации с программ того же уровня / 2.0"	0	0	0	0	0	0	0	0	0	0	0	0	0	17	17	3	0	0	32	35
Республика Саха (Якутия)	Государственные, муниципальные (без учета организаций в ведении ФСИН); Заочная	    восстановлены из числа ранее отчисленных / 4.0	0	0	0	0	0	0	0	0	0	0	0	0	0	0	0	0	0	4	50	54
Республика Саха (Якутия)	Государственные, муниципальные (без учета организаций в ведении ФСИН); Заочная	    выбыло по другим причинам / 16.0	0	0	0	0	0	0	0	0	0	0	0	0	0	0	0	0	0	0	92	92
Республика Саха (Якутия)	Государственные, муниципальные (без учета организаций в ведении ФСИН); Заочная	"    добровольно прекратили образовательные отношения
    (бросили учебу) / 10.0"	0	0	0	0	0	0	0	0	0	0	0	0	0	3	3	2	0	8	134	144
Республика Саха (Якутия)	Государственные, муниципальные (без учета организаций в ведении ФСИН); Заочная	"    отчислено:
         по неуспеваемости / 11.0"	0	0	0	0	0	0	0	0	0	0	0	0	0	1	1	0	0	33	31	64
Республика Саха (Якутия)	Государственные, муниципальные (без учета организаций в ведении ФСИН); Заочная	"    переведено в другие образовательные организации
    на программы того же уровня / 8.0"	0	0	0	0	0	0	0	0	0	0	0	0	0	0	0	0	0	0	2	2
Республика Саха (Якутия)	Государственные, муниципальные (без учета организаций в ведении ФСИН); Заочная	"    переведено из других образовательных организаций 
    с программ того же уровня / 3.0"	0	0	0	0	0	0	0	0	0	0	0	0	0	0	0	0	0	0	5	5
Республика Саха (Якутия)	Государственные, муниципальные (без учета организаций в ведении ФСИН); Заочная	    по болезни / 9.0	0	0	0	0	0	0	0	0	0	0	0	0	0	0	0	0	0	0	1	1
Республика Саха (Якутия)	Государственные, муниципальные (без учета организаций в ведении ФСИН); Заочная	    прибыло по другим причинам / 5.0	0	0	0	0	0	0	0	0	0	0	0	0	0	0	0	0	0	6	119	125
Республика Саха (Якутия)	Государственные, муниципальные (без учета организаций в ведении ФСИН); Заочная	Выбыло студентов - всего (сумма стр. 07-11, 13-15) / 6.0	0	0	0	0	0	0	0	0	0	0	0	0	0	4	4	4	0	43	290	337
Республика Саха (Якутия)	Государственные, муниципальные (без учета организаций в ведении ФСИН); Заочная	Прибыло студентов - всего (сумма стр. 02-05) / 1.0	0	0	0	0	0	0	0	0	0	0	0	0	0	17	17	3	0	10	206	219
Республика Саха (Якутия)	Государственные, муниципальные (без учета организаций в ведении ФСИН); Заочная	"Численность студентов на начало прошлого учебного года
(на 1 октября) / 17.0"	0	0	0	0	0	0	0	0	0	0	0	0	0	41	41	293	0	194	1572	2059
Республика Саха (Якутия)	Государственные, муниципальные (без учета организаций в ведении ФСИН); Очная	            из стр. 11 - не прошли итоговую аттестацию / 12.0	0	0	0	1	1	4	0	0	2	6	4	0	0	0	4	0	0	0	2	2
Республика Саха (Якутия)	Государственные, муниципальные (без учета организаций в ведении ФСИН); Очная	"            из стр. 11 – лица с ограниченными возможностями здоровья,
            инвалиды, дети-инвалиды / 13.0"	0	0	0	0	0	0	0	0	0	0	1	0	0	1	2	4	0	6	1	11
Республика Саха (Якутия)	Государственные, муниципальные (без учета организаций в ведении ФСИН); Очная	         отчислено в виде меры дисциплинарного взыскания / 14.0	7	0	0	0	7	5	0	0	0	5	12	0	0	2	14	1	0	3	2	6
Республика Саха (Якутия)	Государственные, муниципальные (без учета организаций в ведении ФСИН); Очная	         отчислено из-за просрочки оплаты обучения / 15.0	0	0	0	0	0	0	0	0	1	1	0	0	0	1	1	0	0	0	41	41
Республика Саха (Якутия)	Государственные, муниципальные (без учета организаций в ведении ФСИН); Очная	"    в том числе:
    переведено на другие формы обучения данной
    организации на программы того же уровня / 7.0"	53	0	0	20	73	4	0	0	9	13	151	0	1	34	186	59	0	1	131	191
Республика Саха (Якутия)	Государственные, муниципальные (без учета организаций в ведении ФСИН); Очная	"    в том числе:
    переведено с других форм обучения данной
    образовательной организации с программ того же уровня / 2.0"	68	0	34	4	106	5	0	0	2	7	43	0	0	5	48	143	0	2	9	154
Республика Саха (Якутия)	Государственные, муниципальные (без учета организаций в ведении ФСИН); Очная	    восстановлены из числа ранее отчисленных / 4.0	60	0	0	1	61	6	0	0	0	6	37	0	10	20	67	36	0	13	23	72
Республика Саха (Якутия)	Государственные, муниципальные (без учета организаций в ведении ФСИН); Очная	    выбыло по другим причинам / 16.0	154	0	0	8	162	27	0	0	1	28	180	0	14	40	234	129	0	10	68	207
Республика Саха (Якутия)	Государственные, муниципальные (без учета организаций в ведении ФСИН); Очная	"    добровольно прекратили образовательные отношения
    (бросили учебу) / 10.0"	124	0	0	17	141	64	0	0	11	75	326	0	32	86	444	447	0	113	342	902
Республика Саха (Якутия)	Государственные, муниципальные (без учета организаций в ведении ФСИН); Очная	"    отчислено:
         по неуспеваемости / 11.0"	126	0	0	12	138	29	0	0	4	33	120	0	18	30	168	103	0	40	75	218
Республика Саха (Якутия)	Государственные, муниципальные (без учета организаций в ведении ФСИН); Очная	"    переведено в другие образовательные организации
    на программы того же уровня / 8.0"	63	0	0	2	65	7	0	0	0	7	112	0	31	22	165	52	0	9	10	71
Республика Саха (Якутия)	Государственные, муниципальные (без учета организаций в ведении ФСИН); Очная	"    переведено из других образовательных организаций 
    с программ того же уровня / 3.0"	32	0	0	3	35	12	0	0	1	13	70	0	6	26	102	15	0	3	21	39
Республика Саха (Якутия)	Государственные, муниципальные (без учета организаций в ведении ФСИН); Очная	    по болезни / 9.0	13	0	0	0	13	0	0	0	0	0	10	0	0	5	15	5	0	1	0	6
Республика Саха (Якутия)	Государственные, муниципальные (без учета организаций в ведении ФСИН); Очная	    прибыло по другим причинам / 5.0	86	0	0	30	116	46	0	0	3	49	73	0	8	17	98	36	0	41	22	99
Республика Саха (Якутия)	Государственные, муниципальные (без учета организаций в ведении ФСИН); Очная	Выбыло студентов - всего (сумма стр. 07-11, 13-15) / 6.0	540	0	0	59	599	136	0	0	26	162	911	0	96	220	1227	796	0	177	669	1642
Республика Саха (Якутия)	Государственные, муниципальные (без учета организаций в ведении ФСИН); Очная	Прибыло студентов - всего (сумма стр. 02-05) / 1.0	246	0	34	38	318	69	0	0	6	75	223	0	24	68	315	230	0	59	75	364
Республика Саха (Якутия)	Государственные, муниципальные (без учета организаций в ведении ФСИН); Очная	"Численность студентов на начало прошлого учебного года
(на 1 октября) / 17.0"	3919	0	34	291	4244	823	0	0	80	903	5898	0	618	1928	8444	6075	0	1445	2222	9742
Республика Саха (Якутия)	Очно-заочная; Государственные, муниципальные (без учета организаций в ведении ФСИН)	            из стр. 11 - не прошли итоговую аттестацию / 12.0	0	0	0	0	0	0	0	0	0	0	0	0	0	0	0	0	0	0	0	0
Республика Саха (Якутия)	Очно-заочная; Государственные, муниципальные (без учета организаций в ведении ФСИН)	"            из стр. 11 – лица с ограниченными возможностями здоровья,
            инвалиды, дети-инвалиды / 13.0"	0	0	0	0	0	0	0	0	0	0	0	0	0	0	0	0	0	0	0	0
Республика Саха (Якутия)	Очно-заочная; Государственные, муниципальные (без учета организаций в ведении ФСИН)	         отчислено в виде меры дисциплинарного взыскания / 14.0	0	0	0	0	0	0	0	0	0	0	0	0	0	0	0	0	0	0	0	0
Республика Саха (Якутия)	Очно-заочная; Государственные, муниципальные (без учета организаций в ведении ФСИН)	         отчислено из-за просрочки оплаты обучения / 15.0	0	0	0	0	0	0	0	0	0	0	0	0	0	0	0	0	0	0	3	3
Республика Саха (Якутия)	Очно-заочная; Государственные, муниципальные (без учета организаций в ведении ФСИН)	"    в том числе:
    переведено на другие формы обучения данной
    организации на программы того же уровня / 7.0"	0	0	0	0	0	0	0	0	0	0	0	0	0	0	0	8	0	0	0	8
Республика Саха (Якутия)	Очно-заочная; Государственные, муниципальные (без учета организаций в ведении ФСИН)	"    в том числе:
    переведено с других форм обучения данной
    образовательной организации с программ того же уровня / 2.0"	0	0	0	0	0	0	0	0	0	0	0	0	0	0	0	2	0	0	0	2
Республика Саха (Якутия)	Очно-заочная; Государственные, муниципальные (без учета организаций в ведении ФСИН)	    восстановлены из числа ранее отчисленных / 4.0	0	0	0	0	0	0	0	0	0	0	0	0	0	0	0	0	0	0	0	0
Республика Саха (Якутия)	Очно-заочная; Государственные, муниципальные (без учета организаций в ведении ФСИН)	    выбыло по другим причинам / 16.0	0	0	0	0	0	0	0	0	0	0	0	0	0	0	0	0	0	0	0	0
Республика Саха (Якутия)	Очно-заочная; Государственные, муниципальные (без учета организаций в ведении ФСИН)	"    добровольно прекратили образовательные отношения
    (бросили учебу) / 10.0"	0	0	0	0	0	0	0	0	0	0	0	0	0	0	0	3	0	0	3	6
Республика Саха (Якутия)	Очно-заочная; Государственные, муниципальные (без учета организаций в ведении ФСИН)	"    отчислено:
         по неуспеваемости / 11.0"	0	0	0	0	0	0	0	0	0	0	0	0	0	0	0	10	0	0	0	10
Республика Саха (Якутия)	Очно-заочная; Государственные, муниципальные (без учета организаций в ведении ФСИН)	"    переведено в другие образовательные организации
    на программы того же уровня / 8.0"	0	0	0	0	0	0	0	0	0	0	0	0	0	0	0	0	0	0	0	0
Республика Саха (Якутия)	Очно-заочная; Государственные, муниципальные (без учета организаций в ведении ФСИН)	"    переведено из других образовательных организаций 
    с программ того же уровня / 3.0"	0	0	0	0	0	0	0	0	0	0	0	0	0	0	0	1	0	0	0	1
Республика Саха (Якутия)	Очно-заочная; Государственные, муниципальные (без учета организаций в ведении ФСИН)	    по болезни / 9.0	0	0	0	0	0	0	0	0	0	0	0	0	0	0	0	0	0	0	0	0
Республика Саха (Якутия)	Очно-заочная; Государственные, муниципальные (без учета организаций в ведении ФСИН)	    прибыло по другим причинам / 5.0	0	0	0	0	0	0	0	0	0	0	0	0	0	0	0	0	0	0	0	0
Республика Саха (Якутия)	Очно-заочная; Государственные, муниципальные (без учета организаций в ведении ФСИН)	Выбыло студентов - всего (сумма стр. 07-11, 13-15) / 6.0	0	0	0	0	0	0	0	0	0	0	0	0	0	0	0	21	0	0	6	27
Республика Саха (Якутия)	Очно-заочная; Государственные, муниципальные (без учета организаций в ведении ФСИН)	Прибыло студентов - всего (сумма стр. 02-05) / 1.0	0	0	0	0	0	0	0	0	0	0	0	0	0	0	0	3	0	0	0	3
Республика Саха (Якутия)	Очно-заочная; Государственные, муниципальные (без учета организаций в ведении ФСИН)	"Численность студентов на начало прошлого учебного года
(на 1 октября) / 17.0"	0	0	0	0	0	0	0	0	0	0	0	0	0	0	0	40	0	0	62	102
Республика Саха (Якутия)	Частные; Заочная	            из стр. 11 - не прошли итоговую аттестацию / 12.0	0	0	0	0	0	0	0	0	0	0	0	0	0	0	0	0	0	0	1	1
Республика Саха (Якутия)	Частные; Заочная	"            из стр. 11 – лица с ограниченными возможностями здоровья,
            инвалиды, дети-инвалиды / 13.0"	0	0	0	0	0	0	0	0	0	0	0	0	0	0	0	0	0	0	0	0
Республика Саха (Якутия)	Частные; Заочная	         отчислено в виде меры дисциплинарного взыскания / 14.0	0	0	0	0	0	0	0	0	0	0	0	0	0	0	0	0	0	0	0	0
Республика Саха (Якутия)	Частные; Заочная	         отчислено из-за просрочки оплаты обучения / 15.0	0	0	0	0	0	0	0	0	0	0	0	0	0	3	3	0	0	0	7	7
Республика Саха (Якутия)	Частные; Заочная	"    в том числе:
    переведено на другие формы обучения данной
    организации на программы того же уровня / 7.0"	0	0	0	0	0	0	0	0	0	0	0	0	0	6	6	0	0	0	8	8
Республика Саха (Якутия)	Частные; Заочная	"    в том числе:
    переведено с других форм обучения данной
    образовательной организации с программ того же уровня / 2.0"	0	0	0	0	0	0	0	0	0	0	0	0	0	23	23	0	0	0	7	7
Республика Саха (Якутия)	Частные; Заочная	    восстановлены из числа ранее отчисленных / 4.0	0	0	0	0	0	0	0	0	0	0	0	0	0	12	12	0	0	0	6	6
Республика Саха (Якутия)	Частные; Заочная	    выбыло по другим причинам / 16.0	0	0	0	0	0	0	0	0	0	0	0	0	0	1	1	0	0	0	19	19
Республика Саха (Якутия)	Частные; Заочная	"    добровольно прекратили образовательные отношения
    (бросили учебу) / 10.0"	0	0	0	0	0	0	0	0	0	0	0	0	0	15	15	0	0	0	33	33
Республика Саха (Якутия)	Частные; Заочная	"    отчислено:
         по неуспеваемости / 11.0"	0	0	0	0	0	0	0	0	0	0	0	0	0	3	3	0	0	0	23	23
Республика Саха (Якутия)	Частные; Заочная	"    переведено в другие образовательные организации
    на программы того же уровня / 8.0"	0	0	0	0	0	0	0	0	0	0	0	0	0	0	0	0	0	0	0	0
Республика Саха (Якутия)	Частные; Заочная	"    переведено из других образовательных организаций 
    с программ того же уровня / 3.0"	0	0	0	0	0	0	0	0	0	0	0	0	0	2	2	0	0	0	0	0
Республика Саха (Якутия)	Частные; Заочная	    по болезни / 9.0	0	0	0	0	0	0	0	0	0	0	0	0	0	0	0	0	0	0	0	0
Республика Саха (Якутия)	Частные; Заочная	    прибыло по другим причинам / 5.0	0	0	0	0	0	0	0	0	0	0	0	0	0	0	0	0	0	0	0	0
Республика Саха (Якутия)	Частные; Заочная	Выбыло студентов - всего (сумма стр. 07-11, 13-15) / 6.0	0	0	0	0	0	0	0	0	0	0	0	0	0	28	28	0	0	0	90	90
Республика Саха (Якутия)	Частные; Заочная	Прибыло студентов - всего (сумма стр. 02-05) / 1.0	0	0	0	0	0	0	0	0	0	0	0	0	0	37	37	0	0	0	13	13
Республика Саха (Якутия)	Частные; Заочная	"Численность студентов на начало прошлого учебного года
(на 1 октября) / 17.0"	0	0	0	0	0	0	0	0	0	0	0	0	0	80	80	0	0	0	297	297
Республика Саха (Якутия)	Частные; Очная	            из стр. 11 - не прошли итоговую аттестацию / 12.0	0	0	0	0	0	0	0	0	0	0	0	0	0	0	0	0	0	0	0	0
Республика Саха (Якутия)	Частные; Очная	"            из стр. 11 – лица с ограниченными возможностями здоровья,
            инвалиды, дети-инвалиды / 13.0"	0	0	0	0	0	0	0	0	0	0	0	0	0	0	0	0	0	0	0	0
Республика Саха (Якутия)	Частные; Очная	         отчислено в виде меры дисциплинарного взыскания / 14.0	0	0	0	0	0	0	0	0	0	0	0	0	0	1	1	0	0	0	1	1
Республика Саха (Якутия)	Частные; Очная	         отчислено из-за просрочки оплаты обучения / 15.0	0	0	0	0	0	0	0	0	0	0	0	0	0	34	34	0	0	0	37	37
Республика Саха (Якутия)	Частные; Очная	"    в том числе:
    переведено на другие формы обучения данной
    организации на программы того же уровня / 7.0"	0	0	0	0	0	0	0	0	0	0	0	0	0	36	36	0	0	0	10	10
Республика Саха (Якутия)	Частные; Очная	"    в том числе:
    переведено с других форм обучения данной
    образовательной организации с программ того же уровня / 2.0"	0	0	0	0	0	0	0	0	0	0	0	0	0	6	6	0	0	0	1	1
Республика Саха (Якутия)	Частные; Очная	    восстановлены из числа ранее отчисленных / 4.0	0	0	0	0	0	0	0	0	0	0	0	0	0	14	14	0	0	0	6	6
Республика Саха (Якутия)	Частные; Очная	    выбыло по другим причинам / 16.0	0	0	0	0	0	0	0	0	0	0	0	0	0	50	50	4	0	0	28	32
Республика Саха (Якутия)	Частные; Очная	"    добровольно прекратили образовательные отношения
    (бросили учебу) / 10.0"	0	0	0	0	0	0	0	0	0	0	3	0	0	43	46	12	0	0	46	58
Республика Саха (Якутия)	Частные; Очная	"    отчислено:
         по неуспеваемости / 11.0"	0	0	0	0	0	0	0	0	0	0	0	0	0	34	34	0	0	0	17	17
Республика Саха (Якутия)	Частные; Очная	"    переведено в другие образовательные организации
    на программы того же уровня / 8.0"	0	0	0	0	0	0	0	0	0	0	0	0	0	34	34	0	0	0	7	7
Республика Саха (Якутия)	Частные; Очная	"    переведено из других образовательных организаций 
    с программ того же уровня / 3.0"	0	0	0	0	0	0	0	0	0	0	0	0	0	8	8	0	0	0	3	3
Республика Саха (Якутия)	Частные; Очная	    по болезни / 9.0	0	0	0	0	0	0	0	0	0	0	0	0	0	5	5	0	0	0	4	4
Республика Саха (Якутия)	Частные; Очная	    прибыло по другим причинам / 5.0	0	0	0	0	0	0	0	0	0	0	3	0	0	0	3	14	0	0	0	14
Республика Саха (Якутия)	Частные; Очная	Выбыло студентов - всего (сумма стр. 07-11, 13-15) / 6.0	0	0	0	0	0	0	0	0	0	0	3	0	0	237	240	16	0	0	150	166
Республика Саха (Якутия)	Частные; Очная	Прибыло студентов - всего (сумма стр. 02-05) / 1.0	0	0	0	0	0	0	0	0	0	0	3	0	0	28	31	14	0	0	10	24
Республика Саха (Якутия)	Частные; Очная	"Численность студентов на начало прошлого учебного года
(на 1 октября) / 17.0"	0	0	0	0	0	0	0	0	0	0	35	0	0	1335	1370	47	0	0	607	654
Республика Саха (Якутия)	Частные; Очно-заочная	            из стр. 11 - не прошли итоговую аттестацию / 12.0	0	0	0	0	0	0	0	0	0	0	0	0	0	0	0	0	0	0	0	0
Республика Саха (Якутия)	Частные; Очно-заочная	"            из стр. 11 – лица с ограниченными возможностями здоровья,
            инвалиды, дети-инвалиды / 13.0"	0	0	0	0	0	0	0	0	0	0	0	0	0	0	0	0	0	0	0	0
Республика Саха (Якутия)	Частные; Очно-заочная	         отчислено в виде меры дисциплинарного взыскания / 14.0	0	0	0	0	0	0	0	0	0	0	0	0	0	0	0	0	0	0	0	0
Республика Саха (Якутия)	Частные; Очно-заочная	         отчислено из-за просрочки оплаты обучения / 15.0	0	0	0	0	0	0	0	0	0	0	0	0	0	5	5	0	0	0	22	22
Республика Саха (Якутия)	Частные; Очно-заочная	"    в том числе:
    переведено на другие формы обучения данной
    организации на программы того же уровня / 7.0"	0	0	0	0	0	0	0	0	0	0	0	0	0	0	0	0	0	0	2	2
Республика Саха (Якутия)	Частные; Очно-заочная	"    в том числе:
    переведено с других форм обучения данной
    образовательной организации с программ того же уровня / 2.0"	0	0	0	0	0	0	0	0	0	0	0	0	0	0	0	0	0	0	18	18
Республика Саха (Якутия)	Частные; Очно-заочная	    восстановлены из числа ранее отчисленных / 4.0	0	0	0	0	0	0	0	0	0	0	0	0	0	2	2	0	0	0	0	0
Республика Саха (Якутия)	Частные; Очно-заочная	    выбыло по другим причинам / 16.0	0	0	0	0	0	0	0	0	0	0	0	0	0	0	0	0	0	0	0	0
Республика Саха (Якутия)	Частные; Очно-заочная	"    добровольно прекратили образовательные отношения
    (бросили учебу) / 10.0"	0	0	0	0	0	0	0	0	0	0	0	0	0	6	6	0	0	0	24	24
Республика Саха (Якутия)	Частные; Очно-заочная	"    отчислено:
         по неуспеваемости / 11.0"	0	0	0	0	0	0	0	0	0	0	0	0	0	0	0	0	0	0	0	0
Республика Саха (Якутия)	Частные; Очно-заочная	"    переведено в другие образовательные организации
    на программы того же уровня / 8.0"	0	0	0	0	0	0	0	0	0	0	0	0	0	1	1	0	0	0	0	0
Республика Саха (Якутия)	Частные; Очно-заочная	"    переведено из других образовательных организаций 
    с программ того же уровня / 3.0"	0	0	0	0	0	0	0	0	0	0	0	0	0	0	0	0	0	0	0	0
Республика Саха (Якутия)	Частные; Очно-заочная	    по болезни / 9.0	0	0	0	0	0	0	0	0	0	0	0	0	0	0	0	0	0	0	0	0
Республика Саха (Якутия)	Частные; Очно-заочная	    прибыло по другим причинам / 5.0	0	0	0	0	0	0	0	0	0	0	0	0	0	0	0	0	0	0	0	0
Республика Саха (Якутия)	Частные; Очно-заочная	Выбыло студентов - всего (сумма стр. 07-11, 13-15) / 6.0	0	0	0	0	0	0	0	0	0	0	0	0	0	12	12	0	0	0	48	48
Республика Саха (Якутия)	Частные; Очно-заочная	Прибыло студентов - всего (сумма стр. 02-05) / 1.0	0	0	0	0	0	0	0	0	0	0	0	0	0	2	2	0	0	0	18	18
Республика Саха (Якутия)	Частные; Очно-заочная	"Численность студентов на начало прошлого учебного года
(на 1 октября) / 17.0"	0	0	0	0	0	0	0	0	0	0	0	0	0	17	17	0	0	0	13	13
Республика Северная Осетия - Алания	Государственные, муниципальные (без учета организаций в ведении ФСИН); Заочная	            из стр. 11 - не прошли итоговую аттестацию / 12.0	0	0	0	0	0	0	0	0	0	0	0	0	0	0	0	0	0	2	7	9
Республика Северная Осетия - Алания	Государственные, муниципальные (без учета организаций в ведении ФСИН); Заочная	"            из стр. 11 – лица с ограниченными возможностями здоровья,
            инвалиды, дети-инвалиды / 13.0"	0	0	0	0	0	0	0	0	0	0	0	0	0	0	0	0	0	0	0	0
Республика Северная Осетия - Алания	Государственные, муниципальные (без учета организаций в ведении ФСИН); Заочная	         отчислено в виде меры дисциплинарного взыскания / 14.0	0	0	0	0	0	0	0	0	0	0	0	0	0	0	0	0	0	0	0	0
Республика Северная Осетия - Алания	Государственные, муниципальные (без учета организаций в ведении ФСИН); Заочная	         отчислено из-за просрочки оплаты обучения / 15.0	0	0	0	0	0	0	0	0	0	0	0	0	0	0	0	0	0	0	0	0
Республика Северная Осетия - Алания	Государственные, муниципальные (без учета организаций в ведении ФСИН); Заочная	"    в том числе:
    переведено на другие формы обучения данной
    организации на программы того же уровня / 7.0"	0	0	0	0	0	0	0	0	0	0	0	0	0	1	1	0	0	1	8	9
Республика Северная Осетия - Алания	Государственные, муниципальные (без учета организаций в ведении ФСИН); Заочная	"    в том числе:
    переведено с других форм обучения данной
    образовательной организации с программ того же уровня / 2.0"	0	0	0	0	0	0	0	0	0	0	0	0	0	19	19	0	0	6	64	70
Республика Северная Осетия - Алания	Государственные, муниципальные (без учета организаций в ведении ФСИН); Заочная	    восстановлены из числа ранее отчисленных / 4.0	0	0	0	0	0	0	0	0	0	0	0	0	0	14	14	0	0	0	24	24
Республика Северная Осетия - Алания	Государственные, муниципальные (без учета организаций в ведении ФСИН); Заочная	    выбыло по другим причинам / 16.0	0	0	0	0	0	0	0	0	0	0	0	0	0	4	4	1	0	0	9	10
Республика Северная Осетия - Алания	Государственные, муниципальные (без учета организаций в ведении ФСИН); Заочная	"    добровольно прекратили образовательные отношения
    (бросили учебу) / 10.0"	0	0	0	0	0	0	0	0	0	0	0	0	0	7	7	2	0	3	19	24
Республика Северная Осетия - Алания	Государственные, муниципальные (без учета организаций в ведении ФСИН); Заочная	"    отчислено:
         по неуспеваемости / 11.0"	0	0	0	0	0	0	0	0	0	0	0	0	0	4	4	0	0	13	13	26
Республика Северная Осетия - Алания	Государственные, муниципальные (без учета организаций в ведении ФСИН); Заочная	"    переведено в другие образовательные организации
    на программы того же уровня / 8.0"	0	0	0	0	0	0	0	0	0	0	0	0	0	3	3	0	0	1	2	3
Республика Северная Осетия - Алания	Государственные, муниципальные (без учета организаций в ведении ФСИН); Заочная	"    переведено из других образовательных организаций 
    с программ того же уровня / 3.0"	0	0	0	0	0	0	0	0	0	0	0	0	0	7	7	0	0	0	9	9
Республика Северная Осетия - Алания	Государственные, муниципальные (без учета организаций в ведении ФСИН); Заочная	    по болезни / 9.0	0	0	0	0	0	0	0	0	0	0	0	0	0	1	1	0	0	0	0	0
Республика Северная Осетия - Алания	Государственные, муниципальные (без учета организаций в ведении ФСИН); Заочная	    прибыло по другим причинам / 5.0	0	0	0	0	0	0	0	0	0	0	0	0	0	4	4	0	0	0	21	21
Республика Северная Осетия - Алания	Государственные, муниципальные (без учета организаций в ведении ФСИН); Заочная	Выбыло студентов - всего (сумма стр. 07-11, 13-15) / 6.0	0	0	0	0	0	0	0	0	0	0	0	0	0	20	20	3	0	18	51	72
Республика Северная Осетия - Алания	Государственные, муниципальные (без учета организаций в ведении ФСИН); Заочная	Прибыло студентов - всего (сумма стр. 02-05) / 1.0	0	0	0	0	0	0	0	0	0	0	0	0	0	44	44	0	0	6	118	124
Республика Северная Осетия - Алания	Государственные, муниципальные (без учета организаций в ведении ФСИН); Заочная	"Численность студентов на начало прошлого учебного года
(на 1 октября) / 17.0"	0	0	0	0	0	0	0	0	0	0	0	0	0	240	240	127	0	168	376	671
Республика Северная Осетия - Алания	Государственные, муниципальные (без учета организаций в ведении ФСИН); Очная	            из стр. 11 - не прошли итоговую аттестацию / 12.0	1	0	0	0	1	0	0	0	0	0	6	0	1	3	10	0	0	1	2	3
Республика Северная Осетия - Алания	Государственные, муниципальные (без учета организаций в ведении ФСИН); Очная	"            из стр. 11 – лица с ограниченными возможностями здоровья,
            инвалиды, дети-инвалиды / 13.0"	0	0	0	0	0	0	0	0	0	0	0	0	0	0	0	0	0	0	0	0
Республика Северная Осетия - Алания	Государственные, муниципальные (без учета организаций в ведении ФСИН); Очная	         отчислено в виде меры дисциплинарного взыскания / 14.0	1	0	0	0	1	0	0	0	0	0	7	0	0	0	7	0	0	0	0	0
Республика Северная Осетия - Алания	Государственные, муниципальные (без учета организаций в ведении ФСИН); Очная	         отчислено из-за просрочки оплаты обучения / 15.0	0	0	0	0	0	0	0	0	0	0	0	0	0	7	7	0	0	0	0	0
Республика Северная Осетия - Алания	Государственные, муниципальные (без учета организаций в ведении ФСИН); Очная	"    в том числе:
    переведено на другие формы обучения данной
    организации на программы того же уровня / 7.0"	4	0	0	1	5	0	0	0	0	0	9	0	29	67	105	0	0	0	25	25
Республика Северная Осетия - Алания	Государственные, муниципальные (без учета организаций в ведении ФСИН); Очная	"    в том числе:
    переведено с других форм обучения данной
    образовательной организации с программ того же уровня / 2.0"	37	0	0	0	37	0	0	0	0	0	32	0	0	6	38	2	0	2	1	5
Республика Северная Осетия - Алания	Государственные, муниципальные (без учета организаций в ведении ФСИН); Очная	    восстановлены из числа ранее отчисленных / 4.0	13	0	3	0	16	2	0	0	0	2	32	7	1	40	80	2	19	0	4	25
Республика Северная Осетия - Алания	Государственные, муниципальные (без учета организаций в ведении ФСИН); Очная	    выбыло по другим причинам / 16.0	204	0	0	2	206	2	0	0	0	2	91	0	6	232	329	0	3	3	0	6
Республика Северная Осетия - Алания	Государственные, муниципальные (без учета организаций в ведении ФСИН); Очная	"    добровольно прекратили образовательные отношения
    (бросили учебу) / 10.0"	78	0	0	18	96	17	0	0	0	17	112	23	45	136	316	4	25	1	20	50
Республика Северная Осетия - Алания	Государственные, муниципальные (без учета организаций в ведении ФСИН); Очная	"    отчислено:
         по неуспеваемости / 11.0"	52	0	0	0	52	0	0	0	0	0	107	4	18	63	192	0	3	4	8	15
Республика Северная Осетия - Алания	Государственные, муниципальные (без учета организаций в ведении ФСИН); Очная	"    переведено в другие образовательные организации
    на программы того же уровня / 8.0"	22	0	0	2	24	3	0	0	0	3	49	2	7	181	239	5	1	0	10	16
Республика Северная Осетия - Алания	Государственные, муниципальные (без учета организаций в ведении ФСИН); Очная	"    переведено из других образовательных организаций 
    с программ того же уровня / 3.0"	21	0	0	0	21	2	0	0	0	2	33	0	1	59	93	0	2	0	1	3
Республика Северная Осетия - Алания	Государственные, муниципальные (без учета организаций в ведении ФСИН); Очная	    по болезни / 9.0	5	0	0	0	5	1	0	0	0	1	7	6	0	2	15	3	1	0	0	4
Республика Северная Осетия - Алания	Государственные, муниципальные (без учета организаций в ведении ФСИН); Очная	    прибыло по другим причинам / 5.0	168	0	0	8	176	2	0	0	0	2	5	0	2	267	274	0	0	0	2	2
Республика Северная Осетия - Алания	Государственные, муниципальные (без учета организаций в ведении ФСИН); Очная	Выбыло студентов - всего (сумма стр. 07-11, 13-15) / 6.0	366	0	0	23	389	23	0	0	0	23	382	35	105	688	1210	12	33	8	63	116
Республика Северная Осетия - Алания	Государственные, муниципальные (без учета организаций в ведении ФСИН); Очная	Прибыло студентов - всего (сумма стр. 02-05) / 1.0	239	0	3	8	250	6	0	0	0	6	102	7	4	372	485	4	21	2	8	35
Республика Северная Осетия - Алания	Государственные, муниципальные (без учета организаций в ведении ФСИН); Очная	"Численность студентов на начало прошлого учебного года
(на 1 октября) / 17.0"	2891	0	0	209	3100	187	0	0	44	231	4246	984	1258	3635	10123	108	648	83	304	1143
Республика Северная Осетия - Алания	Очно-заочная; Государственные, муниципальные (без учета организаций в ведении ФСИН)	            из стр. 11 - не прошли итоговую аттестацию / 12.0	0	0	0	0	0	0	0	0	0	0	0	0	0	0	0	0	0	0	0	0
Республика Северная Осетия - Алания	Очно-заочная; Государственные, муниципальные (без учета организаций в ведении ФСИН)	"            из стр. 11 – лица с ограниченными возможностями здоровья,
            инвалиды, дети-инвалиды / 13.0"	0	0	0	0	0	0	0	0	0	0	0	0	0	0	0	0	0	0	0	0
Республика Северная Осетия - Алания	Очно-заочная; Государственные, муниципальные (без учета организаций в ведении ФСИН)	         отчислено в виде меры дисциплинарного взыскания / 14.0	0	0	0	0	0	0	0	0	0	0	0	0	0	0	0	0	0	0	0	0
Республика Северная Осетия - Алания	Очно-заочная; Государственные, муниципальные (без учета организаций в ведении ФСИН)	         отчислено из-за просрочки оплаты обучения / 15.0	0	0	0	0	0	0	0	0	0	0	0	0	0	0	0	0	0	0	0	0
Республика Северная Осетия - Алания	Очно-заочная; Государственные, муниципальные (без учета организаций в ведении ФСИН)	"    в том числе:
    переведено на другие формы обучения данной
    организации на программы того же уровня / 7.0"	0	0	0	0	0	0	0	0	0	0	0	0	0	0	0	0	0	0	0	0
Республика Северная Осетия - Алания	Очно-заочная; Государственные, муниципальные (без учета организаций в ведении ФСИН)	"    в том числе:
    переведено с других форм обучения данной
    образовательной организации с программ того же уровня / 2.0"	0	0	0	0	0	0	0	0	0	0	0	0	0	0	0	0	0	0	0	0
Республика Северная Осетия - Алания	Очно-заочная; Государственные, муниципальные (без учета организаций в ведении ФСИН)	    восстановлены из числа ранее отчисленных / 4.0	0	0	0	0	0	0	0	0	0	0	1	0	0	0	1	0	0	0	0	0
Республика Северная Осетия - Алания	Очно-заочная; Государственные, муниципальные (без учета организаций в ведении ФСИН)	    выбыло по другим причинам / 16.0	0	0	0	0	0	0	0	0	0	0	0	0	0	0	0	0	0	0	0	0
Республика Северная Осетия - Алания	Очно-заочная; Государственные, муниципальные (без учета организаций в ведении ФСИН)	"    добровольно прекратили образовательные отношения
    (бросили учебу) / 10.0"	0	0	0	0	0	0	0	0	0	0	0	0	0	0	0	0	0	0	0	0
Республика Северная Осетия - Алания	Очно-заочная; Государственные, муниципальные (без учета организаций в ведении ФСИН)	"    отчислено:
         по неуспеваемости / 11.0"	0	0	0	0	0	0	0	0	0	0	0	0	0	2	2	0	0	0	0	0
Республика Северная Осетия - Алания	Очно-заочная; Государственные, муниципальные (без учета организаций в ведении ФСИН)	"    переведено в другие образовательные организации
    на программы того же уровня / 8.0"	0	0	0	0	0	0	0	0	0	0	0	0	0	0	0	0	0	0	0	0
Республика Северная Осетия - Алания	Очно-заочная; Государственные, муниципальные (без учета организаций в ведении ФСИН)	"    переведено из других образовательных организаций 
    с программ того же уровня / 3.0"	0	0	0	0	0	0	0	0	0	0	0	0	0	0	0	0	0	0	0	0
Республика Северная Осетия - Алания	Очно-заочная; Государственные, муниципальные (без учета организаций в ведении ФСИН)	    по болезни / 9.0	0	0	0	0	0	0	0	0	0	0	0	0	0	0	0	0	0	0	0	0
Республика Северная Осетия - Алания	Очно-заочная; Государственные, муниципальные (без учета организаций в ведении ФСИН)	    прибыло по другим причинам / 5.0	0	0	0	0	0	0	0	0	0	0	0	0	0	0	0	0	0	0	0	0
Республика Северная Осетия - Алания	Очно-заочная; Государственные, муниципальные (без учета организаций в ведении ФСИН)	Выбыло студентов - всего (сумма стр. 07-11, 13-15) / 6.0	0	0	0	0	0	0	0	0	0	0	0	0	0	2	2	0	0	0	0	0
Республика Северная Осетия - Алания	Очно-заочная; Государственные, муниципальные (без учета организаций в ведении ФСИН)	Прибыло студентов - всего (сумма стр. 02-05) / 1.0	0	0	0	0	0	0	0	0	0	0	1	0	0	0	1	0	0	0	0	0
Республика Северная Осетия - Алания	Очно-заочная; Государственные, муниципальные (без учета организаций в ведении ФСИН)	"Численность студентов на начало прошлого учебного года
(на 1 октября) / 17.0"	0	0	0	0	0	0	0	0	0	0	0	0	0	95	95	0	0	0	0	0
Республика Северная Осетия - Алания	Частные; Заочная	            из стр. 11 - не прошли итоговую аттестацию / 12.0	0	0	0	0	0	0	0	0	0	0	0	0	0	0	0	0	0	0	0	0
Республика Северная Осетия - Алания	Частные; Заочная	"            из стр. 11 – лица с ограниченными возможностями здоровья,
            инвалиды, дети-инвалиды / 13.0"	0	0	0	0	0	0	0	0	0	0	0	0	0	0	0	0	0	0	0	0
Республика Северная Осетия - Алания	Частные; Заочная	         отчислено в виде меры дисциплинарного взыскания / 14.0	0	0	0	0	0	0	0	0	0	0	0	0	0	0	0	0	0	0	0	0
Республика Северная Осетия - Алания	Частные; Заочная	         отчислено из-за просрочки оплаты обучения / 15.0	0	0	0	0	0	0	0	0	0	0	0	0	0	1	1	0	0	0	3	3
Республика Северная Осетия - Алания	Частные; Заочная	"    в том числе:
    переведено на другие формы обучения данной
    организации на программы того же уровня / 7.0"	0	0	0	0	0	0	0	0	0	0	0	0	0	0	0	0	0	0	0	0
Республика Северная Осетия - Алания	Частные; Заочная	"    в том числе:
    переведено с других форм обучения данной
    образовательной организации с программ того же уровня / 2.0"	0	0	0	0	0	0	0	0	0	0	0	0	0	0	0	0	0	0	0	0
Республика Северная Осетия - Алания	Частные; Заочная	    восстановлены из числа ранее отчисленных / 4.0	0	0	0	0	0	0	0	0	0	0	0	0	0	0	0	0	0	0	0	0
Республика Северная Осетия - Алания	Частные; Заочная	    выбыло по другим причинам / 16.0	0	0	0	0	0	0	0	0	0	0	0	0	0	9	9	0	0	0	7	7
Республика Северная Осетия - Алания	Частные; Заочная	"    добровольно прекратили образовательные отношения
    (бросили учебу) / 10.0"	0	0	0	0	0	0	0	0	0	0	0	0	0	0	0	0	0	0	0	0
Республика Северная Осетия - Алания	Частные; Заочная	"    отчислено:
         по неуспеваемости / 11.0"	0	0	0	0	0	0	0	0	0	0	0	0	0	43	43	0	0	0	9	9
Республика Северная Осетия - Алания	Частные; Заочная	"    переведено в другие образовательные организации
    на программы того же уровня / 8.0"	0	0	0	0	0	0	0	0	0	0	0	0	0	10	10	0	0	0	1	1
Республика Северная Осетия - Алания	Частные; Заочная	"    переведено из других образовательных организаций 
    с программ того же уровня / 3.0"	0	0	0	0	0	0	0	0	0	0	0	0	0	4	4	0	0	0	1	1
Республика Северная Осетия - Алания	Частные; Заочная	    по болезни / 9.0	0	0	0	0	0	0	0	0	0	0	0	0	0	0	0	0	0	0	0	0
Республика Северная Осетия - Алания	Частные; Заочная	    прибыло по другим причинам / 5.0	0	0	0	0	0	0	0	0	0	0	0	0	0	15	15	0	0	0	5	5
Республика Северная Осетия - Алания	Частные; Заочная	Выбыло студентов - всего (сумма стр. 07-11, 13-15) / 6.0	0	0	0	0	0	0	0	0	0	0	0	0	0	63	63	0	0	0	20	20
Республика Северная Осетия - Алания	Частные; Заочная	Прибыло студентов - всего (сумма стр. 02-05) / 1.0	0	0	0	0	0	0	0	0	0	0	0	0	0	19	19	0	0	0	6	6
Республика Северная Осетия - Алания	Частные; Заочная	"Численность студентов на начало прошлого учебного года
(на 1 октября) / 17.0"	0	0	0	0	0	0	0	0	0	0	0	0	0	498	498	0	0	0	137	137
Республика Северная Осетия - Алания	Частные; Очная	            из стр. 11 - не прошли итоговую аттестацию / 12.0	0	0	0	0	0	0	0	0	0	0	0	0	0	0	0	0	0	0	0	0
Республика Северная Осетия - Алания	Частные; Очная	"            из стр. 11 – лица с ограниченными возможностями здоровья,
            инвалиды, дети-инвалиды / 13.0"	0	0	0	0	0	0	0	0	0	0	0	0	0	0	0	0	0	0	0	0
Республика Северная Осетия - Алания	Частные; Очная	         отчислено в виде меры дисциплинарного взыскания / 14.0	0	0	0	0	0	0	0	0	0	0	0	0	0	0	0	0	0	0	0	0
Республика Северная Осетия - Алания	Частные; Очная	         отчислено из-за просрочки оплаты обучения / 15.0	0	0	0	0	0	0	0	0	0	0	0	0	0	41	41	0	0	0	16	16
Республика Северная Осетия - Алания	Частные; Очная	"    в том числе:
    переведено на другие формы обучения данной
    организации на программы того же уровня / 7.0"	0	0	0	0	0	0	0	0	0	0	0	0	0	0	0	0	0	0	0	0
Республика Северная Осетия - Алания	Частные; Очная	"    в том числе:
    переведено с других форм обучения данной
    образовательной организации с программ того же уровня / 2.0"	0	0	0	0	0	0	0	0	0	0	0	0	0	0	0	0	0	0	0	0
Республика Северная Осетия - Алания	Частные; Очная	    восстановлены из числа ранее отчисленных / 4.0	0	0	0	0	0	0	0	0	0	0	0	0	0	4	4	0	0	0	4	4
Республика Северная Осетия - Алания	Частные; Очная	    выбыло по другим причинам / 16.0	0	0	0	0	0	0	0	0	0	0	0	0	0	168	168	0	0	0	26	26
Республика Северная Осетия - Алания	Частные; Очная	"    добровольно прекратили образовательные отношения
    (бросили учебу) / 10.0"	0	0	0	0	0	0	0	0	2	2	0	0	0	30	30	0	0	0	1	1
Республика Северная Осетия - Алания	Частные; Очная	"    отчислено:
         по неуспеваемости / 11.0"	0	0	0	0	0	0	0	0	3	3	0	0	0	23	23	0	0	0	7	7
Республика Северная Осетия - Алания	Частные; Очная	"    переведено в другие образовательные организации
    на программы того же уровня / 8.0"	0	0	0	0	0	0	0	0	0	0	0	0	0	11	11	0	0	0	1	1
Республика Северная Осетия - Алания	Частные; Очная	"    переведено из других образовательных организаций 
    с программ того же уровня / 3.0"	0	0	0	0	0	0	0	0	0	0	0	0	0	122	122	0	0	0	1	1
Республика Северная Осетия - Алания	Частные; Очная	    по болезни / 9.0	0	0	0	0	0	0	0	0	0	0	0	0	0	0	0	0	0	0	0	0
Республика Северная Осетия - Алания	Частные; Очная	    прибыло по другим причинам / 5.0	0	0	0	0	0	0	0	0	0	0	0	0	0	134	134	0	0	0	15	15
Республика Северная Осетия - Алания	Частные; Очная	Выбыло студентов - всего (сумма стр. 07-11, 13-15) / 6.0	0	0	0	0	0	0	0	0	5	5	0	0	0	273	273	0	0	0	51	51
Республика Северная Осетия - Алания	Частные; Очная	Прибыло студентов - всего (сумма стр. 02-05) / 1.0	0	0	0	0	0	0	0	0	0	0	0	0	0	260	260	0	0	0	20	20
Республика Северная Осетия - Алания	Частные; Очная	"Численность студентов на начало прошлого учебного года
(на 1 октября) / 17.0"	0	0	0	0	0	0	0	0	74	74	0	0	0	1672	1672	0	0	0	301	301
Республика Татарстан	Государственные, муниципальные (без учета организаций в ведении ФСИН); Заочная	            из стр. 11 - не прошли итоговую аттестацию / 12.0	0	0	0	0	0	0	0	0	0	0	0	0	0	1	1	18	0	0	5	23
Республика Татарстан	Государственные, муниципальные (без учета организаций в ведении ФСИН); Заочная	"            из стр. 11 – лица с ограниченными возможностями здоровья,
            инвалиды, дети-инвалиды / 13.0"	0	0	0	0	0	0	0	0	0	0	0	0	0	0	0	0	0	0	0	0
Республика Татарстан	Государственные, муниципальные (без учета организаций в ведении ФСИН); Заочная	         отчислено в виде меры дисциплинарного взыскания / 14.0	0	0	0	0	0	0	0	0	0	0	0	0	0	0	0	0	0	0	1	1
Республика Татарстан	Государственные, муниципальные (без учета организаций в ведении ФСИН); Заочная	         отчислено из-за просрочки оплаты обучения / 15.0	0	0	0	0	0	0	0	0	0	0	0	0	0	31	31	0	0	0	7	7
Республика Татарстан	Государственные, муниципальные (без учета организаций в ведении ФСИН); Заочная	"    в том числе:
    переведено на другие формы обучения данной
    организации на программы того же уровня / 7.0"	0	0	0	0	0	0	0	0	0	0	0	0	0	0	0	0	0	0	3	3
Республика Татарстан	Государственные, муниципальные (без учета организаций в ведении ФСИН); Заочная	"    в том числе:
    переведено с других форм обучения данной
    образовательной организации с программ того же уровня / 2.0"	0	0	0	0	0	0	0	0	0	0	2	0	0	54	56	7	0	3	47	57
Республика Татарстан	Государственные, муниципальные (без учета организаций в ведении ФСИН); Заочная	    восстановлены из числа ранее отчисленных / 4.0	0	0	0	0	0	0	0	0	0	0	7	0	0	14	21	1	1	2	49	53
Республика Татарстан	Государственные, муниципальные (без учета организаций в ведении ФСИН); Заочная	    выбыло по другим причинам / 16.0	0	0	0	0	0	0	0	0	0	0	0	0	0	18	18	12	0	26	20	58
Республика Татарстан	Государственные, муниципальные (без учета организаций в ведении ФСИН); Заочная	"    добровольно прекратили образовательные отношения
    (бросили учебу) / 10.0"	0	0	0	0	0	0	0	0	0	0	0	0	0	6	6	147	0	3	45	195
Республика Татарстан	Государственные, муниципальные (без учета организаций в ведении ФСИН); Заочная	"    отчислено:
         по неуспеваемости / 11.0"	0	0	0	0	0	0	0	0	0	0	1	0	0	38	39	76	0	1	67	144
Республика Татарстан	Государственные, муниципальные (без учета организаций в ведении ФСИН); Заочная	"    переведено в другие образовательные организации
    на программы того же уровня / 8.0"	0	0	0	0	0	0	0	0	0	0	0	0	0	0	0	0	0	0	0	0
Республика Татарстан	Государственные, муниципальные (без учета организаций в ведении ФСИН); Заочная	"    переведено из других образовательных организаций 
    с программ того же уровня / 3.0"	0	0	0	0	0	0	0	0	0	0	5	0	0	14	19	2	0	0	10	12
Республика Татарстан	Государственные, муниципальные (без учета организаций в ведении ФСИН); Заочная	    по болезни / 9.0	0	0	0	0	0	0	0	0	0	0	0	0	0	0	0	0	0	0	0	0
Республика Татарстан	Государственные, муниципальные (без учета организаций в ведении ФСИН); Заочная	    прибыло по другим причинам / 5.0	0	0	0	0	0	0	0	0	0	0	0	0	0	19	19	13	0	0	55	68
Республика Татарстан	Государственные, муниципальные (без учета организаций в ведении ФСИН); Заочная	Выбыло студентов - всего (сумма стр. 07-11, 13-15) / 6.0	0	0	0	0	0	0	0	0	0	0	1	0	0	93	94	235	0	30	143	408
Республика Татарстан	Государственные, муниципальные (без учета организаций в ведении ФСИН); Заочная	Прибыло студентов - всего (сумма стр. 02-05) / 1.0	0	0	0	0	0	0	0	0	0	0	14	0	0	101	115	23	1	5	161	190
Республика Татарстан	Государственные, муниципальные (без учета организаций в ведении ФСИН); Заочная	"Численность студентов на начало прошлого учебного года
(на 1 октября) / 17.0"	0	0	0	0	0	0	0	0	0	0	67	0	12	292	371	1485	0	152	1279	2916
Республика Татарстан	Государственные, муниципальные (без учета организаций в ведении ФСИН); Очная	            из стр. 11 - не прошли итоговую аттестацию / 12.0	43	0	0	0	43	0	0	0	0	0	38	0	6	7	51	0	0	0	0	0
Республика Татарстан	Государственные, муниципальные (без учета организаций в ведении ФСИН); Очная	"            из стр. 11 – лица с ограниченными возможностями здоровья,
            инвалиды, дети-инвалиды / 13.0"	3	0	0	0	3	0	0	0	0	0	5	0	0	0	5	0	0	0	0	0
Республика Татарстан	Государственные, муниципальные (без учета организаций в ведении ФСИН); Очная	         отчислено в виде меры дисциплинарного взыскания / 14.0	16	0	0	0	16	0	0	0	0	0	14	0	0	5	19	0	0	0	0	0
Республика Татарстан	Государственные, муниципальные (без учета организаций в ведении ФСИН); Очная	         отчислено из-за просрочки оплаты обучения / 15.0	0	0	0	4	4	0	0	0	3	3	0	0	0	33	33	0	0	0	7	7
Республика Татарстан	Государственные, муниципальные (без учета организаций в ведении ФСИН); Очная	"    в том числе:
    переведено на другие формы обучения данной
    организации на программы того же уровня / 7.0"	7	0	0	18	25	0	0	0	0	0	78	0	4	187	269	8	0	1	24	33
Республика Татарстан	Государственные, муниципальные (без учета организаций в ведении ФСИН); Очная	"    в том числе:
    переведено с других форм обучения данной
    образовательной организации с программ того же уровня / 2.0"	39	0	0	7	46	0	0	0	0	0	94	0	43	37	174	19	2	1	6	28
Республика Татарстан	Государственные, муниципальные (без учета организаций в ведении ФСИН); Очная	    восстановлены из числа ранее отчисленных / 4.0	54	0	0	4	58	0	0	0	1	1	86	4	12	131	233	0	0	1	20	21
Республика Татарстан	Государственные, муниципальные (без учета организаций в ведении ФСИН); Очная	    выбыло по другим причинам / 16.0	103	0	0	7	110	0	0	0	1	1	195	0	18	144	357	13	0	2	21	36
Республика Татарстан	Государственные, муниципальные (без учета организаций в ведении ФСИН); Очная	"    добровольно прекратили образовательные отношения
    (бросили учебу) / 10.0"	326	2	0	42	370	11	0	0	14	25	834	17	103	794	1748	116	0	22	103	241
Республика Татарстан	Государственные, муниципальные (без учета организаций в ведении ФСИН); Очная	"    отчислено:
         по неуспеваемости / 11.0"	192	2	0	14	208	8	0	0	7	15	420	3	40	274	737	15	0	43	81	139
Республика Татарстан	Государственные, муниципальные (без учета организаций в ведении ФСИН); Очная	"    переведено в другие образовательные организации
    на программы того же уровня / 8.0"	130	1	0	7	138	0	0	0	1	1	808	7	55	558	1428	6	0	0	15	21
Республика Татарстан	Государственные, муниципальные (без учета организаций в ведении ФСИН); Очная	"    переведено из других образовательных организаций 
    с программ того же уровня / 3.0"	105	0	0	8	113	0	0	0	0	0	412	2	18	263	695	8	0	0	11	19
Республика Татарстан	Государственные, муниципальные (без учета организаций в ведении ФСИН); Очная	    по болезни / 9.0	5	0	0	0	5	0	0	0	0	0	16	0	0	10	26	3	0	0	3	6
Республика Татарстан	Государственные, муниципальные (без учета организаций в ведении ФСИН); Очная	    прибыло по другим причинам / 5.0	53	0	0	10	63	2	0	0	0	2	150	0	8	54	212	10	0	5	4	19
Республика Татарстан	Государственные, муниципальные (без учета организаций в ведении ФСИН); Очная	Выбыло студентов - всего (сумма стр. 07-11, 13-15) / 6.0	779	5	0	92	876	19	0	0	26	45	2365	27	220	2005	4617	161	0	68	254	483
Республика Татарстан	Государственные, муниципальные (без учета организаций в ведении ФСИН); Очная	Прибыло студентов - всего (сумма стр. 02-05) / 1.0	251	0	0	29	280	2	0	0	1	3	742	6	81	485	1314	37	2	7	41	87
Республика Татарстан	Государственные, муниципальные (без учета организаций в ведении ФСИН); Очная	"Численность студентов на начало прошлого учебного года
(на 1 октября) / 17.0"	9425	52	116	522	10115	163	0	0	242	405	39012	461	4381	16324	60178	2130	0	343	1458	3931
Республика Татарстан	Очно-заочная; Государственные, муниципальные (без учета организаций в ведении ФСИН)	            из стр. 11 - не прошли итоговую аттестацию / 12.0	0	0	0	0	0	0	0	0	0	0	0	0	0	0	0	3	0	0	0	3
Республика Татарстан	Очно-заочная; Государственные, муниципальные (без учета организаций в ведении ФСИН)	"            из стр. 11 – лица с ограниченными возможностями здоровья,
            инвалиды, дети-инвалиды / 13.0"	0	0	0	0	0	0	0	0	0	0	0	0	0	0	0	0	0	0	0	0
Республика Татарстан	Очно-заочная; Государственные, муниципальные (без учета организаций в ведении ФСИН)	         отчислено в виде меры дисциплинарного взыскания / 14.0	0	0	0	0	0	0	0	0	0	0	0	0	0	0	0	0	0	0	0	0
Республика Татарстан	Очно-заочная; Государственные, муниципальные (без учета организаций в ведении ФСИН)	         отчислено из-за просрочки оплаты обучения / 15.0	0	0	0	0	0	0	0	0	0	0	0	0	0	0	0	0	0	0	0	0
Республика Татарстан	Очно-заочная; Государственные, муниципальные (без учета организаций в ведении ФСИН)	"    в том числе:
    переведено на другие формы обучения данной
    организации на программы того же уровня / 7.0"	0	0	0	0	0	0	0	0	0	0	0	0	0	6	6	0	0	0	1	1
Республика Татарстан	Очно-заочная; Государственные, муниципальные (без учета организаций в ведении ФСИН)	"    в том числе:
    переведено с других форм обучения данной
    образовательной организации с программ того же уровня / 2.0"	0	0	0	0	0	0	0	0	0	0	0	0	0	0	0	0	0	0	2	2
Республика Татарстан	Очно-заочная; Государственные, муниципальные (без учета организаций в ведении ФСИН)	    восстановлены из числа ранее отчисленных / 4.0	0	0	0	0	0	0	0	0	0	0	0	0	0	0	0	0	0	0	10	10
Республика Татарстан	Очно-заочная; Государственные, муниципальные (без учета организаций в ведении ФСИН)	    выбыло по другим причинам / 16.0	0	0	0	0	0	0	0	0	0	0	0	0	0	0	0	0	0	0	5	5
Республика Татарстан	Очно-заочная; Государственные, муниципальные (без учета организаций в ведении ФСИН)	"    добровольно прекратили образовательные отношения
    (бросили учебу) / 10.0"	0	0	0	0	0	0	0	0	0	0	0	0	0	1	1	0	0	0	63	63
Республика Татарстан	Очно-заочная; Государственные, муниципальные (без учета организаций в ведении ФСИН)	"    отчислено:
         по неуспеваемости / 11.0"	0	0	0	0	0	0	0	0	0	0	0	0	0	1	1	3	0	0	13	16
Республика Татарстан	Очно-заочная; Государственные, муниципальные (без учета организаций в ведении ФСИН)	"    переведено в другие образовательные организации
    на программы того же уровня / 8.0"	0	0	0	0	0	0	0	0	0	0	0	0	0	0	0	0	0	0	2	2
Республика Татарстан	Очно-заочная; Государственные, муниципальные (без учета организаций в ведении ФСИН)	"    переведено из других образовательных организаций 
    с программ того же уровня / 3.0"	0	0	0	0	0	0	0	0	0	0	0	0	0	1	1	0	0	0	3	3
Республика Татарстан	Очно-заочная; Государственные, муниципальные (без учета организаций в ведении ФСИН)	    по болезни / 9.0	0	0	0	0	0	0	0	0	0	0	0	0	0	0	0	0	0	0	1	1
Республика Татарстан	Очно-заочная; Государственные, муниципальные (без учета организаций в ведении ФСИН)	    прибыло по другим причинам / 5.0	0	0	0	0	0	0	0	0	0	0	0	0	0	0	0	0	0	0	6	6
Республика Татарстан	Очно-заочная; Государственные, муниципальные (без учета организаций в ведении ФСИН)	Выбыло студентов - всего (сумма стр. 07-11, 13-15) / 6.0	0	0	0	0	0	0	0	0	0	0	0	0	0	8	8	3	0	0	85	88
Республика Татарстан	Очно-заочная; Государственные, муниципальные (без учета организаций в ведении ФСИН)	Прибыло студентов - всего (сумма стр. 02-05) / 1.0	0	0	0	0	0	0	0	0	0	0	0	0	0	1	1	0	0	0	21	21
Республика Татарстан	Очно-заочная; Государственные, муниципальные (без учета организаций в ведении ФСИН)	"Численность студентов на начало прошлого учебного года
(на 1 октября) / 17.0"	0	0	0	0	0	15	0	0	0	15	15	0	0	21	36	13	0	0	786	799
Республика Татарстан	Частные; Заочная	            из стр. 11 - не прошли итоговую аттестацию / 12.0	0	0	0	0	0	0	0	0	0	0	0	0	0	15	15	0	0	0	18	18
Республика Татарстан	Частные; Заочная	"            из стр. 11 – лица с ограниченными возможностями здоровья,
            инвалиды, дети-инвалиды / 13.0"	0	0	0	0	0	0	0	0	0	0	0	0	0	0	0	0	0	0	0	0
Республика Татарстан	Частные; Заочная	         отчислено в виде меры дисциплинарного взыскания / 14.0	0	0	0	0	0	0	0	0	0	0	0	0	0	0	0	0	0	0	0	0
Республика Татарстан	Частные; Заочная	         отчислено из-за просрочки оплаты обучения / 15.0	0	0	0	0	0	0	0	0	0	0	0	0	0	76	76	0	0	0	25	25
Республика Татарстан	Частные; Заочная	"    в том числе:
    переведено на другие формы обучения данной
    организации на программы того же уровня / 7.0"	0	0	0	0	0	0	0	0	0	0	0	0	0	48	48	0	0	0	5	5
Республика Татарстан	Частные; Заочная	"    в том числе:
    переведено с других форм обучения данной
    образовательной организации с программ того же уровня / 2.0"	0	0	0	0	0	0	0	0	0	0	0	0	0	153	153	0	0	0	13	13
Республика Татарстан	Частные; Заочная	    восстановлены из числа ранее отчисленных / 4.0	0	0	0	0	0	0	0	0	0	0	0	0	0	89	89	0	0	0	19	19
Республика Татарстан	Частные; Заочная	    выбыло по другим причинам / 16.0	0	0	0	0	0	0	0	0	0	0	0	0	0	32	32	0	0	0	14	14
Республика Татарстан	Частные; Заочная	"    добровольно прекратили образовательные отношения
    (бросили учебу) / 10.0"	0	0	0	0	0	0	0	0	0	0	0	0	0	117	117	0	0	0	26	26
Республика Татарстан	Частные; Заочная	"    отчислено:
         по неуспеваемости / 11.0"	0	0	0	0	0	0	0	0	0	0	0	0	0	99	99	0	0	0	84	84
Республика Татарстан	Частные; Заочная	"    переведено в другие образовательные организации
    на программы того же уровня / 8.0"	0	0	0	0	0	0	0	0	0	0	0	0	0	35	35	0	0	0	9	9
Республика Татарстан	Частные; Заочная	"    переведено из других образовательных организаций 
    с программ того же уровня / 3.0"	0	0	0	0	0	0	0	0	0	0	0	0	0	149	149	0	0	0	37	37
Республика Татарстан	Частные; Заочная	    по болезни / 9.0	0	0	0	0	0	0	0	0	0	0	0	0	0	0	0	0	0	0	0	0
Республика Татарстан	Частные; Заочная	    прибыло по другим причинам / 5.0	0	0	0	0	0	0	0	0	0	0	0	0	0	40	40	0	0	0	20	20
Республика Татарстан	Частные; Заочная	Выбыло студентов - всего (сумма стр. 07-11, 13-15) / 6.0	0	0	0	0	0	0	0	0	0	0	0	0	0	407	407	0	0	0	163	163
Республика Татарстан	Частные; Заочная	Прибыло студентов - всего (сумма стр. 02-05) / 1.0	0	0	0	0	0	0	0	0	0	0	0	0	0	431	431	0	0	0	89	89
Республика Татарстан	Частные; Заочная	"Численность студентов на начало прошлого учебного года
(на 1 октября) / 17.0"	0	0	0	0	0	0	0	0	0	0	0	0	0	1436	1436	0	0	0	635	635
Республика Татарстан	Частные; Очная	            из стр. 11 - не прошли итоговую аттестацию / 12.0	0	0	0	1	1	0	0	0	0	0	0	0	0	42	42	0	0	0	12	12
Республика Татарстан	Частные; Очная	"            из стр. 11 – лица с ограниченными возможностями здоровья,
            инвалиды, дети-инвалиды / 13.0"	0	0	0	0	0	0	0	0	0	0	0	0	0	1	1	0	0	0	0	0
Республика Татарстан	Частные; Очная	         отчислено в виде меры дисциплинарного взыскания / 14.0	0	0	0	0	0	0	0	0	0	0	0	0	0	0	0	0	0	0	0	0
Республика Татарстан	Частные; Очная	         отчислено из-за просрочки оплаты обучения / 15.0	0	0	0	0	0	0	0	0	0	0	0	0	0	54	54	0	0	0	14	14
Республика Татарстан	Частные; Очная	"    в том числе:
    переведено на другие формы обучения данной
    организации на программы того же уровня / 7.0"	0	0	0	0	0	0	0	0	0	0	0	17	0	136	153	0	0	0	2	2
Республика Татарстан	Частные; Очная	"    в том числе:
    переведено с других форм обучения данной
    образовательной организации с программ того же уровня / 2.0"	0	0	0	0	0	0	0	0	0	0	0	1	0	188	189	0	0	0	15	15
Республика Татарстан	Частные; Очная	    восстановлены из числа ранее отчисленных / 4.0	0	0	0	0	0	0	0	0	0	0	0	19	0	74	93	0	0	0	21	21
Республика Татарстан	Частные; Очная	    выбыло по другим причинам / 16.0	0	0	0	7	7	0	0	0	0	0	0	78	0	71	149	0	0	0	101	101
Республика Татарстан	Частные; Очная	"    добровольно прекратили образовательные отношения
    (бросили учебу) / 10.0"	0	0	0	2	2	0	0	0	0	0	0	75	1	272	348	0	0	0	73	73
Республика Татарстан	Частные; Очная	"    отчислено:
         по неуспеваемости / 11.0"	0	0	0	4	4	0	0	0	0	0	0	5	0	240	245	0	0	0	55	55
Республика Татарстан	Частные; Очная	"    переведено в другие образовательные организации
    на программы того же уровня / 8.0"	0	0	0	0	0	0	0	0	0	0	0	39	0	307	346	0	0	0	49	49
Республика Татарстан	Частные; Очная	"    переведено из других образовательных организаций 
    с программ того же уровня / 3.0"	0	0	0	0	0	0	0	0	0	0	0	21	0	406	427	0	0	0	58	58
Республика Татарстан	Частные; Очная	    по болезни / 9.0	0	0	0	0	0	0	0	0	0	0	0	0	0	4	4	0	0	0	0	0
Республика Татарстан	Частные; Очная	    прибыло по другим причинам / 5.0	0	0	0	0	0	0	0	0	0	0	0	0	0	114	114	0	0	0	50	50
Республика Татарстан	Частные; Очная	Выбыло студентов - всего (сумма стр. 07-11, 13-15) / 6.0	0	0	0	13	13	0	0	0	0	0	0	214	1	1084	1299	0	0	0	294	294
Республика Татарстан	Частные; Очная	Прибыло студентов - всего (сумма стр. 02-05) / 1.0	0	0	0	0	0	0	0	0	0	0	0	41	0	782	823	0	0	0	144	144
Республика Татарстан	Частные; Очная	"Численность студентов на начало прошлого учебного года
(на 1 октября) / 17.0"	0	0	0	36	36	0	0	0	0	0	0	1144	90	7999	9233	0	69	0	1436	1505
Республика Татарстан	Частные; Очно-заочная	            из стр. 11 - не прошли итоговую аттестацию / 12.0	0	0	0	0	0	0	0	0	0	0	0	0	0	0	0	0	0	0	0	0
Республика Татарстан	Частные; Очно-заочная	"            из стр. 11 – лица с ограниченными возможностями здоровья,
            инвалиды, дети-инвалиды / 13.0"	0	0	0	0	0	0	0	0	0	0	0	0	0	0	0	0	0	0	0	0
Республика Татарстан	Частные; Очно-заочная	         отчислено в виде меры дисциплинарного взыскания / 14.0	0	0	0	0	0	0	0	0	0	0	0	0	0	0	0	0	0	0	0	0
Республика Татарстан	Частные; Очно-заочная	         отчислено из-за просрочки оплаты обучения / 15.0	0	0	0	0	0	0	0	0	0	0	0	0	0	0	0	0	0	0	0	0
Республика Татарстан	Частные; Очно-заочная	"    в том числе:
    переведено на другие формы обучения данной
    организации на программы того же уровня / 7.0"	0	0	0	0	0	0	0	0	0	0	0	0	0	0	0	0	0	0	0	0
Республика Татарстан	Частные; Очно-заочная	"    в том числе:
    переведено с других форм обучения данной
    образовательной организации с программ того же уровня / 2.0"	0	0	0	0	0	0	0	0	0	0	0	0	0	3	3	0	0	0	5	5
Республика Татарстан	Частные; Очно-заочная	    восстановлены из числа ранее отчисленных / 4.0	0	0	0	0	0	0	0	0	0	0	0	0	0	1	1	0	0	0	0	0
Республика Татарстан	Частные; Очно-заочная	    выбыло по другим причинам / 16.0	0	0	0	0	0	0	0	0	0	0	0	0	0	3	3	0	0	0	0	0
Республика Татарстан	Частные; Очно-заочная	"    добровольно прекратили образовательные отношения
    (бросили учебу) / 10.0"	0	0	0	0	0	0	0	0	0	0	0	0	0	0	0	0	0	0	1	1
Республика Татарстан	Частные; Очно-заочная	"    отчислено:
         по неуспеваемости / 11.0"	0	0	0	0	0	0	0	0	0	0	0	0	0	2	2	0	0	0	1	1
Республика Татарстан	Частные; Очно-заочная	"    переведено в другие образовательные организации
    на программы того же уровня / 8.0"	0	0	0	0	0	0	0	0	0	0	0	0	0	6	6	0	0	0	0	0
Республика Татарстан	Частные; Очно-заочная	"    переведено из других образовательных организаций 
    с программ того же уровня / 3.0"	0	0	0	0	0	0	0	0	0	0	0	0	0	2	2	0	0	0	1	1
Республика Татарстан	Частные; Очно-заочная	    по болезни / 9.0	0	0	0	0	0	0	0	0	0	0	0	0	0	0	0	0	0	0	0	0
Республика Татарстан	Частные; Очно-заочная	    прибыло по другим причинам / 5.0	0	0	0	0	0	0	0	0	0	0	0	0	0	0	0	0	0	0	17	17
Республика Татарстан	Частные; Очно-заочная	Выбыло студентов - всего (сумма стр. 07-11, 13-15) / 6.0	0	0	0	0	0	0	0	0	0	0	0	0	0	11	11	0	0	0	2	2
Республика Татарстан	Частные; Очно-заочная	Прибыло студентов - всего (сумма стр. 02-05) / 1.0	0	0	0	0	0	0	0	0	0	0	0	0	0	6	6	0	0	0	23	23
Республика Татарстан	Частные; Очно-заочная	"Численность студентов на начало прошлого учебного года
(на 1 октября) / 17.0"	0	0	0	0	0	0	0	0	0	0	0	0	0	47	47	0	0	0	21	21
Республика Тыва	Государственные, муниципальные (без учета организаций в ведении ФСИН); Заочная	            из стр. 11 - не прошли итоговую аттестацию / 12.0	0	0	0	0	0	0	0	0	0	0	0	0	0	0	0	0	0	0	0	0
Республика Тыва	Государственные, муниципальные (без учета организаций в ведении ФСИН); Заочная	"            из стр. 11 – лица с ограниченными возможностями здоровья,
            инвалиды, дети-инвалиды / 13.0"	0	0	0	0	0	0	0	0	0	0	0	0	0	0	0	0	0	0	0	0
Республика Тыва	Государственные, муниципальные (без учета организаций в ведении ФСИН); Заочная	         отчислено в виде меры дисциплинарного взыскания / 14.0	0	0	0	0	0	0	0	0	0	0	0	0	0	0	0	0	0	0	0	0
Республика Тыва	Государственные, муниципальные (без учета организаций в ведении ФСИН); Заочная	         отчислено из-за просрочки оплаты обучения / 15.0	0	0	0	0	0	0	0	0	0	0	0	0	0	0	0	0	0	0	38	38
Республика Тыва	Государственные, муниципальные (без учета организаций в ведении ФСИН); Заочная	"    в том числе:
    переведено на другие формы обучения данной
    организации на программы того же уровня / 7.0"	0	0	0	0	0	0	0	0	0	0	0	0	0	0	0	0	0	0	0	0
Республика Тыва	Государственные, муниципальные (без учета организаций в ведении ФСИН); Заочная	"    в том числе:
    переведено с других форм обучения данной
    образовательной организации с программ того же уровня / 2.0"	0	0	0	0	0	0	0	0	0	0	6	0	0	1	7	1	0	0	3	4
Республика Тыва	Государственные, муниципальные (без учета организаций в ведении ФСИН); Заочная	    восстановлены из числа ранее отчисленных / 4.0	0	0	0	0	0	0	0	0	0	0	6	0	0	4	10	30	0	0	38	68
Республика Тыва	Государственные, муниципальные (без учета организаций в ведении ФСИН); Заочная	    выбыло по другим причинам / 16.0	0	0	0	0	0	0	0	0	0	0	0	0	0	0	0	15	0	0	0	15
Республика Тыва	Государственные, муниципальные (без учета организаций в ведении ФСИН); Заочная	"    добровольно прекратили образовательные отношения
    (бросили учебу) / 10.0"	0	0	0	0	0	0	0	0	0	0	1	0	0	2	3	16	0	5	2	23
Республика Тыва	Государственные, муниципальные (без учета организаций в ведении ФСИН); Заочная	"    отчислено:
         по неуспеваемости / 11.0"	0	0	0	0	0	0	0	0	0	0	8	0	0	2	10	27	0	0	2	29
Республика Тыва	Государственные, муниципальные (без учета организаций в ведении ФСИН); Заочная	"    переведено в другие образовательные организации
    на программы того же уровня / 8.0"	0	0	0	0	0	0	0	0	0	0	0	0	0	0	0	0	0	0	0	0
Республика Тыва	Государственные, муниципальные (без учета организаций в ведении ФСИН); Заочная	"    переведено из других образовательных организаций 
    с программ того же уровня / 3.0"	0	0	0	0	0	0	0	0	0	0	5	0	0	0	5	0	0	0	0	0
Республика Тыва	Государственные, муниципальные (без учета организаций в ведении ФСИН); Заочная	    по болезни / 9.0	0	0	0	0	0	0	0	0	0	0	0	0	0	0	0	5	0	0	1	6
Республика Тыва	Государственные, муниципальные (без учета организаций в ведении ФСИН); Заочная	    прибыло по другим причинам / 5.0	0	0	0	0	0	0	0	0	0	0	3	0	0	7	10	4	0	0	33	37
Республика Тыва	Государственные, муниципальные (без учета организаций в ведении ФСИН); Заочная	Выбыло студентов - всего (сумма стр. 07-11, 13-15) / 6.0	0	0	0	0	0	0	0	0	0	0	9	0	0	4	13	63	0	5	43	111
Республика Тыва	Государственные, муниципальные (без учета организаций в ведении ФСИН); Заочная	Прибыло студентов - всего (сумма стр. 02-05) / 1.0	0	0	0	0	0	0	0	0	0	0	20	0	0	12	32	35	0	0	74	109
Республика Тыва	Государственные, муниципальные (без учета организаций в ведении ФСИН); Заочная	"Численность студентов на начало прошлого учебного года
(на 1 октября) / 17.0"	0	0	0	0	0	0	0	0	0	0	101	0	0	47	148	310	0	125	273	708
Республика Тыва	Государственные, муниципальные (без учета организаций в ведении ФСИН); Очная	            из стр. 11 - не прошли итоговую аттестацию / 12.0	21	0	0	0	21	0	10	0	8	18	14	0	0	0	14	2	0	0	2	4
Республика Тыва	Государственные, муниципальные (без учета организаций в ведении ФСИН); Очная	"            из стр. 11 – лица с ограниченными возможностями здоровья,
            инвалиды, дети-инвалиды / 13.0"	0	0	0	0	0	0	0	0	0	0	4	0	0	0	4	0	0	0	0	0
Республика Тыва	Государственные, муниципальные (без учета организаций в ведении ФСИН); Очная	         отчислено в виде меры дисциплинарного взыскания / 14.0	2	0	0	0	2	1	0	0	0	1	1	0	0	0	1	2	0	2	0	4
Республика Тыва	Государственные, муниципальные (без учета организаций в ведении ФСИН); Очная	         отчислено из-за просрочки оплаты обучения / 15.0	0	0	0	1	1	0	0	0	5	5	0	0	0	15	15	0	0	0	3	3
Республика Тыва	Государственные, муниципальные (без учета организаций в ведении ФСИН); Очная	"    в том числе:
    переведено на другие формы обучения данной
    организации на программы того же уровня / 7.0"	7	0	0	41	48	0	0	0	2	2	27	0	0	22	49	11	0	0	12	23
Республика Тыва	Государственные, муниципальные (без учета организаций в ведении ФСИН); Очная	"    в том числе:
    переведено с других форм обучения данной
    образовательной организации с программ того же уровня / 2.0"	28	0	0	0	28	0	0	0	0	0	24	0	0	0	24	5	0	0	4	9
Республика Тыва	Государственные, муниципальные (без учета организаций в ведении ФСИН); Очная	    восстановлены из числа ранее отчисленных / 4.0	24	0	0	3	27	2	0	0	0	2	53	0	0	20	73	1	0	2	8	11
Республика Тыва	Государственные, муниципальные (без учета организаций в ведении ФСИН); Очная	    выбыло по другим причинам / 16.0	163	0	0	17	180	14	3	0	1	18	122	0	0	38	160	17	0	0	5	22
Республика Тыва	Государственные, муниципальные (без учета организаций в ведении ФСИН); Очная	"    добровольно прекратили образовательные отношения
    (бросили учебу) / 10.0"	40	0	0	3	43	16	5	0	4	25	74	0	0	31	105	28	0	47	8	83
Республика Тыва	Государственные, муниципальные (без учета организаций в ведении ФСИН); Очная	"    отчислено:
         по неуспеваемости / 11.0"	56	0	0	1	57	16	10	0	13	39	71	0	0	24	95	12	0	16	18	46
Республика Тыва	Государственные, муниципальные (без учета организаций в ведении ФСИН); Очная	"    переведено в другие образовательные организации
    на программы того же уровня / 8.0"	55	0	0	0	55	4	1	0	0	5	123	0	0	32	155	8	0	0	1	9
Республика Тыва	Государственные, муниципальные (без учета организаций в ведении ФСИН); Очная	"    переведено из других образовательных организаций 
    с программ того же уровня / 3.0"	36	0	0	1	37	2	0	0	0	2	56	0	0	26	82	3	0	0	8	11
Республика Тыва	Государственные, муниципальные (без учета организаций в ведении ФСИН); Очная	    по болезни / 9.0	16	0	0	0	16	2	0	0	0	2	27	0	0	11	38	1	0	0	0	1
Республика Тыва	Государственные, муниципальные (без учета организаций в ведении ФСИН); Очная	    прибыло по другим причинам / 5.0	83	0	0	22	105	3	0	0	0	3	80	0	0	70	150	6	0	0	7	13
Республика Тыва	Государственные, муниципальные (без учета организаций в ведении ФСИН); Очная	Выбыло студентов - всего (сумма стр. 07-11, 13-15) / 6.0	339	0	0	63	402	53	19	0	25	97	445	0	0	173	618	79	0	65	47	191
Республика Тыва	Государственные, муниципальные (без учета организаций в ведении ФСИН); Очная	Прибыло студентов - всего (сумма стр. 02-05) / 1.0	171	0	0	26	197	7	0	0	0	7	213	0	0	116	329	15	0	2	27	44
Республика Тыва	Государственные, муниципальные (без учета организаций в ведении ФСИН); Очная	"Численность студентов на начало прошлого учебного года
(на 1 октября) / 17.0"	1995	0	0	185	2180	468	0	0	104	572	3190	0	0	894	4084	732	0	526	230	1488
Республика Тыва	Очно-заочная; Государственные, муниципальные (без учета организаций в ведении ФСИН)	            из стр. 11 - не прошли итоговую аттестацию / 12.0	0	0	0	0	0	0	0	0	0	0	0	0	0	0	0	0	0	0	0	0
Республика Тыва	Очно-заочная; Государственные, муниципальные (без учета организаций в ведении ФСИН)	"            из стр. 11 – лица с ограниченными возможностями здоровья,
            инвалиды, дети-инвалиды / 13.0"	0	0	0	0	0	0	0	0	0	0	0	0	0	0	0	0	0	0	0	0
Республика Тыва	Очно-заочная; Государственные, муниципальные (без учета организаций в ведении ФСИН)	         отчислено в виде меры дисциплинарного взыскания / 14.0	0	0	0	0	0	0	0	0	0	0	0	0	0	0	0	0	0	0	0	0
Республика Тыва	Очно-заочная; Государственные, муниципальные (без учета организаций в ведении ФСИН)	         отчислено из-за просрочки оплаты обучения / 15.0	0	0	0	0	0	0	0	0	0	0	0	0	0	0	0	0	0	0	0	0
Республика Тыва	Очно-заочная; Государственные, муниципальные (без учета организаций в ведении ФСИН)	"    в том числе:
    переведено на другие формы обучения данной
    организации на программы того же уровня / 7.0"	0	0	0	0	0	0	0	0	0	0	0	0	0	0	0	0	0	0	1	1
Республика Тыва	Очно-заочная; Государственные, муниципальные (без учета организаций в ведении ФСИН)	"    в том числе:
    переведено с других форм обучения данной
    образовательной организации с программ того же уровня / 2.0"	0	0	0	0	0	0	0	0	0	0	0	0	0	0	0	0	0	0	1	1
Республика Тыва	Очно-заочная; Государственные, муниципальные (без учета организаций в ведении ФСИН)	    восстановлены из числа ранее отчисленных / 4.0	0	0	0	0	0	0	0	0	0	0	0	0	0	0	0	0	0	0	2	2
Республика Тыва	Очно-заочная; Государственные, муниципальные (без учета организаций в ведении ФСИН)	    выбыло по другим причинам / 16.0	0	0	0	0	0	0	0	0	0	0	0	0	0	0	0	0	0	0	24	24
Республика Тыва	Очно-заочная; Государственные, муниципальные (без учета организаций в ведении ФСИН)	"    добровольно прекратили образовательные отношения
    (бросили учебу) / 10.0"	0	0	0	0	0	0	0	0	0	0	0	0	0	0	0	0	0	0	6	6
Республика Тыва	Очно-заочная; Государственные, муниципальные (без учета организаций в ведении ФСИН)	"    отчислено:
         по неуспеваемости / 11.0"	0	0	0	0	0	0	0	0	0	0	0	0	0	0	0	0	0	0	4	4
Республика Тыва	Очно-заочная; Государственные, муниципальные (без учета организаций в ведении ФСИН)	"    переведено в другие образовательные организации
    на программы того же уровня / 8.0"	0	0	0	0	0	0	0	0	0	0	0	0	0	0	0	0	0	0	1	1
Республика Тыва	Очно-заочная; Государственные, муниципальные (без учета организаций в ведении ФСИН)	"    переведено из других образовательных организаций 
    с программ того же уровня / 3.0"	0	0	0	0	0	0	0	0	0	0	0	0	0	0	0	0	0	0	3	3
Республика Тыва	Очно-заочная; Государственные, муниципальные (без учета организаций в ведении ФСИН)	    по болезни / 9.0	0	0	0	0	0	0	0	0	0	0	0	0	0	0	0	0	0	0	0	0
Республика Тыва	Очно-заочная; Государственные, муниципальные (без учета организаций в ведении ФСИН)	    прибыло по другим причинам / 5.0	0	0	0	0	0	0	0	0	0	0	0	0	0	0	0	0	0	0	6	6
Республика Тыва	Очно-заочная; Государственные, муниципальные (без учета организаций в ведении ФСИН)	Выбыло студентов - всего (сумма стр. 07-11, 13-15) / 6.0	0	0	0	0	0	0	0	0	0	0	0	0	0	0	0	0	0	0	36	36
Республика Тыва	Очно-заочная; Государственные, муниципальные (без учета организаций в ведении ФСИН)	Прибыло студентов - всего (сумма стр. 02-05) / 1.0	0	0	0	0	0	0	0	0	0	0	0	0	0	0	0	0	0	0	12	12
Республика Тыва	Очно-заочная; Государственные, муниципальные (без учета организаций в ведении ФСИН)	"Численность студентов на начало прошлого учебного года
(на 1 октября) / 17.0"	0	0	0	0	0	0	0	0	0	0	0	0	0	0	0	0	0	0	347	347
Республика Тыва	Частные; Заочная	            из стр. 11 - не прошли итоговую аттестацию / 12.0	0	0	0	0	0	0	0	0	0	0	0	0	0	0	0	0	0	0	0	0
Республика Тыва	Частные; Заочная	"            из стр. 11 – лица с ограниченными возможностями здоровья,
            инвалиды, дети-инвалиды / 13.0"	0	0	0	0	0	0	0	0	0	0	0	0	0	0	0	0	0	0	0	0
Республика Тыва	Частные; Заочная	         отчислено в виде меры дисциплинарного взыскания / 14.0	0	0	0	0	0	0	0	0	0	0	0	0	0	0	0	0	0	0	0	0
Республика Тыва	Частные; Заочная	         отчислено из-за просрочки оплаты обучения / 15.0	0	0	0	0	0	0	0	0	0	0	0	0	0	0	0	0	0	0	0	0
Республика Тыва	Частные; Заочная	"    в том числе:
    переведено на другие формы обучения данной
    организации на программы того же уровня / 7.0"	0	0	0	0	0	0	0	0	0	0	0	0	0	0	0	0	0	0	0	0
Республика Тыва	Частные; Заочная	"    в том числе:
    переведено с других форм обучения данной
    образовательной организации с программ того же уровня / 2.0"	0	0	0	0	0	0	0	0	0	0	0	0	0	4	4	0	0	0	17	17
Республика Тыва	Частные; Заочная	    восстановлены из числа ранее отчисленных / 4.0	0	0	0	0	0	0	0	0	0	0	0	0	0	0	0	0	0	0	4	4
Республика Тыва	Частные; Заочная	    выбыло по другим причинам / 16.0	0	0	0	0	0	0	0	0	0	0	0	0	0	2	2	0	0	0	8	8
Республика Тыва	Частные; Заочная	"    добровольно прекратили образовательные отношения
    (бросили учебу) / 10.0"	0	0	0	0	0	0	0	0	0	0	0	0	0	0	0	0	0	0	4	4
Республика Тыва	Частные; Заочная	"    отчислено:
         по неуспеваемости / 11.0"	0	0	0	0	0	0	0	0	0	0	0	0	0	0	0	0	0	0	0	0
Республика Тыва	Частные; Заочная	"    переведено в другие образовательные организации
    на программы того же уровня / 8.0"	0	0	0	0	0	0	0	0	0	0	0	0	0	0	0	0	0	0	0	0
Республика Тыва	Частные; Заочная	"    переведено из других образовательных организаций 
    с программ того же уровня / 3.0"	0	0	0	0	0	0	0	0	0	0	0	0	0	0	0	0	0	0	3	3
Республика Тыва	Частные; Заочная	    по болезни / 9.0	0	0	0	0	0	0	0	0	0	0	0	0	0	0	0	0	0	0	0	0
Республика Тыва	Частные; Заочная	    прибыло по другим причинам / 5.0	0	0	0	0	0	0	0	0	0	0	0	0	0	0	0	0	0	0	0	0
Республика Тыва	Частные; Заочная	Выбыло студентов - всего (сумма стр. 07-11, 13-15) / 6.0	0	0	0	0	0	0	0	0	0	0	0	0	0	2	2	0	0	0	12	12
Республика Тыва	Частные; Заочная	Прибыло студентов - всего (сумма стр. 02-05) / 1.0	0	0	0	0	0	0	0	0	0	0	0	0	0	4	4	0	0	0	24	24
Республика Тыва	Частные; Заочная	"Численность студентов на начало прошлого учебного года
(на 1 октября) / 17.0"	0	0	0	0	0	0	0	0	0	0	0	0	0	67	67	0	0	0	71	71
Республика Тыва	Частные; Очная	            из стр. 11 - не прошли итоговую аттестацию / 12.0	0	0	0	0	0	0	0	0	0	0	0	0	0	0	0	0	0	0	0	0
Республика Тыва	Частные; Очная	"            из стр. 11 – лица с ограниченными возможностями здоровья,
            инвалиды, дети-инвалиды / 13.0"	0	0	0	0	0	0	0	0	0	0	0	0	0	0	0	0	0	0	0	0
Республика Тыва	Частные; Очная	         отчислено в виде меры дисциплинарного взыскания / 14.0	0	0	0	0	0	0	0	0	0	0	0	0	0	0	0	0	0	0	0	0
Республика Тыва	Частные; Очная	         отчислено из-за просрочки оплаты обучения / 15.0	0	0	0	0	0	0	0	0	0	0	0	0	0	0	0	0	0	0	0	0
Республика Тыва	Частные; Очная	"    в том числе:
    переведено на другие формы обучения данной
    организации на программы того же уровня / 7.0"	0	0	0	0	0	0	0	0	0	0	0	0	0	28	28	0	0	0	3	3
Республика Тыва	Частные; Очная	"    в том числе:
    переведено с других форм обучения данной
    образовательной организации с программ того же уровня / 2.0"	0	0	0	0	0	0	0	0	0	0	0	0	0	10	10	0	0	0	0	0
Республика Тыва	Частные; Очная	    восстановлены из числа ранее отчисленных / 4.0	0	0	0	0	0	0	0	0	0	0	0	0	0	9	9	0	0	0	2	2
Республика Тыва	Частные; Очная	    выбыло по другим причинам / 16.0	0	0	0	0	0	0	0	0	0	0	0	0	0	21	21	0	0	0	17	17
Республика Тыва	Частные; Очная	"    добровольно прекратили образовательные отношения
    (бросили учебу) / 10.0"	0	0	0	0	0	0	0	0	0	0	0	0	0	6	6	0	0	0	4	4
Республика Тыва	Частные; Очная	"    отчислено:
         по неуспеваемости / 11.0"	0	0	0	0	0	0	0	0	0	0	0	0	0	0	0	0	0	0	0	0
Республика Тыва	Частные; Очная	"    переведено в другие образовательные организации
    на программы того же уровня / 8.0"	0	0	0	0	0	0	0	0	0	0	0	0	0	9	9	0	0	0	0	0
Республика Тыва	Частные; Очная	"    переведено из других образовательных организаций 
    с программ того же уровня / 3.0"	0	0	0	0	0	0	0	0	0	0	0	0	0	8	8	0	0	0	1	1
Республика Тыва	Частные; Очная	    по болезни / 9.0	0	0	0	0	0	0	0	0	0	0	0	0	0	3	3	0	0	0	1	1
Республика Тыва	Частные; Очная	    прибыло по другим причинам / 5.0	0	0	0	0	0	0	0	0	0	0	0	0	0	0	0	0	0	0	0	0
Республика Тыва	Частные; Очная	Выбыло студентов - всего (сумма стр. 07-11, 13-15) / 6.0	0	0	0	0	0	0	0	0	0	0	0	0	0	67	67	0	0	0	25	25
Республика Тыва	Частные; Очная	Прибыло студентов - всего (сумма стр. 02-05) / 1.0	0	0	0	0	0	0	0	0	0	0	0	0	0	27	27	0	0	0	3	3
Республика Тыва	Частные; Очная	"Численность студентов на начало прошлого учебного года
(на 1 октября) / 17.0"	0	0	0	0	0	0	0	0	0	0	0	0	0	693	693	0	0	0	220	220
Республика Хакасия	Государственные, муниципальные (без учета организаций в ведении ФСИН); Заочная	            из стр. 11 - не прошли итоговую аттестацию / 12.0	0	0	0	0	0	0	0	0	0	0	0	0	0	0	0	0	0	0	1	1
Республика Хакасия	Государственные, муниципальные (без учета организаций в ведении ФСИН); Заочная	"            из стр. 11 – лица с ограниченными возможностями здоровья,
            инвалиды, дети-инвалиды / 13.0"	0	0	0	0	0	0	0	0	0	0	0	0	0	0	0	0	0	0	0	0
Республика Хакасия	Государственные, муниципальные (без учета организаций в ведении ФСИН); Заочная	         отчислено в виде меры дисциплинарного взыскания / 14.0	0	0	0	0	0	0	0	0	0	0	0	0	0	0	0	0	0	0	0	0
Республика Хакасия	Государственные, муниципальные (без учета организаций в ведении ФСИН); Заочная	         отчислено из-за просрочки оплаты обучения / 15.0	0	0	0	0	0	0	0	0	0	0	0	0	0	0	0	0	0	0	15	15
Республика Хакасия	Государственные, муниципальные (без учета организаций в ведении ФСИН); Заочная	"    в том числе:
    переведено на другие формы обучения данной
    организации на программы того же уровня / 7.0"	0	0	0	0	0	0	0	0	0	0	0	0	0	0	0	0	0	0	0	0
Республика Хакасия	Государственные, муниципальные (без учета организаций в ведении ФСИН); Заочная	"    в том числе:
    переведено с других форм обучения данной
    образовательной организации с программ того же уровня / 2.0"	0	0	0	0	0	0	0	0	0	0	0	0	0	0	0	0	0	0	17	17
Республика Хакасия	Государственные, муниципальные (без учета организаций в ведении ФСИН); Заочная	    восстановлены из числа ранее отчисленных / 4.0	0	0	0	0	0	0	0	0	0	0	0	0	0	0	0	2	0	0	30	32
Республика Хакасия	Государственные, муниципальные (без учета организаций в ведении ФСИН); Заочная	    выбыло по другим причинам / 16.0	0	0	0	0	0	0	0	0	0	0	0	0	0	0	0	7	0	0	14	21
Республика Хакасия	Государственные, муниципальные (без учета организаций в ведении ФСИН); Заочная	"    добровольно прекратили образовательные отношения
    (бросили учебу) / 10.0"	0	0	0	0	0	0	0	0	0	0	0	0	0	5	5	16	0	0	45	61
Республика Хакасия	Государственные, муниципальные (без учета организаций в ведении ФСИН); Заочная	"    отчислено:
         по неуспеваемости / 11.0"	0	0	0	0	0	0	0	0	0	0	0	0	0	0	0	0	0	0	1	1
Республика Хакасия	Государственные, муниципальные (без учета организаций в ведении ФСИН); Заочная	"    переведено в другие образовательные организации
    на программы того же уровня / 8.0"	0	0	0	0	0	0	0	0	0	0	0	0	0	0	0	0	0	0	2	2
Республика Хакасия	Государственные, муниципальные (без учета организаций в ведении ФСИН); Заочная	"    переведено из других образовательных организаций 
    с программ того же уровня / 3.0"	0	0	0	0	0	0	0	0	0	0	0	0	0	0	0	0	0	0	3	3
Республика Хакасия	Государственные, муниципальные (без учета организаций в ведении ФСИН); Заочная	    по болезни / 9.0	0	0	0	0	0	0	0	0	0	0	0	0	0	0	0	1	0	0	0	1
Республика Хакасия	Государственные, муниципальные (без учета организаций в ведении ФСИН); Заочная	    прибыло по другим причинам / 5.0	0	0	0	0	0	0	0	0	0	0	0	0	0	0	0	1	0	0	17	18
Республика Хакасия	Государственные, муниципальные (без учета организаций в ведении ФСИН); Заочная	Выбыло студентов - всего (сумма стр. 07-11, 13-15) / 6.0	0	0	0	0	0	0	0	0	0	0	0	0	0	5	5	24	0	0	77	101
Республика Хакасия	Государственные, муниципальные (без учета организаций в ведении ФСИН); Заочная	Прибыло студентов - всего (сумма стр. 02-05) / 1.0	0	0	0	0	0	0	0	0	0	0	0	0	0	0	0	3	0	0	67	70
Республика Хакасия	Государственные, муниципальные (без учета организаций в ведении ФСИН); Заочная	"Численность студентов на начало прошлого учебного года
(на 1 октября) / 17.0"	0	0	0	0	0	0	0	0	0	0	0	0	0	74	74	375	0	0	413	788
Республика Хакасия	Государственные, муниципальные (без учета организаций в ведении ФСИН); Очная	            из стр. 11 - не прошли итоговую аттестацию / 12.0	7	0	0	0	7	0	0	0	0	0	2	0	1	6	9	0	0	0	0	0
Республика Хакасия	Государственные, муниципальные (без учета организаций в ведении ФСИН); Очная	"            из стр. 11 – лица с ограниченными возможностями здоровья,
            инвалиды, дети-инвалиды / 13.0"	0	0	0	0	0	0	0	0	0	0	0	0	0	0	0	0	0	0	0	0
Республика Хакасия	Государственные, муниципальные (без учета организаций в ведении ФСИН); Очная	         отчислено в виде меры дисциплинарного взыскания / 14.0	0	0	0	0	0	0	0	0	0	0	0	0	0	0	0	0	0	0	0	0
Республика Хакасия	Государственные, муниципальные (без учета организаций в ведении ФСИН); Очная	         отчислено из-за просрочки оплаты обучения / 15.0	0	0	0	6	6	0	0	0	2	2	0	0	0	11	11	0	0	0	1	1
Республика Хакасия	Государственные, муниципальные (без учета организаций в ведении ФСИН); Очная	"    в том числе:
    переведено на другие формы обучения данной
    организации на программы того же уровня / 7.0"	2	0	0	0	2	0	0	0	0	0	5	0	0	20	25	0	0	0	1	1
Республика Хакасия	Государственные, муниципальные (без учета организаций в ведении ФСИН); Очная	"    в том числе:
    переведено с других форм обучения данной
    образовательной организации с программ того же уровня / 2.0"	4	0	1	3	8	0	0	0	0	0	10	0	0	0	10	0	0	0	1	1
Республика Хакасия	Государственные, муниципальные (без учета организаций в ведении ФСИН); Очная	    восстановлены из числа ранее отчисленных / 4.0	5	0	0	2	7	0	0	0	0	0	8	0	1	12	21	1	0	0	0	1
Республика Хакасия	Государственные, муниципальные (без учета организаций в ведении ФСИН); Очная	    выбыло по другим причинам / 16.0	78	0	4	2	84	0	0	0	0	0	114	0	0	71	185	0	0	1	21	22
Республика Хакасия	Государственные, муниципальные (без учета организаций в ведении ФСИН); Очная	"    добровольно прекратили образовательные отношения
    (бросили учебу) / 10.0"	158	0	1	42	201	25	0	0	2	27	139	0	50	129	318	47	0	20	33	100
Республика Хакасия	Государственные, муниципальные (без учета организаций в ведении ФСИН); Очная	"    отчислено:
         по неуспеваемости / 11.0"	27	0	0	0	27	1	0	0	1	2	20	0	15	24	59	1	0	5	11	17
Республика Хакасия	Государственные, муниципальные (без учета организаций в ведении ФСИН); Очная	"    переведено в другие образовательные организации
    на программы того же уровня / 8.0"	33	0	0	0	33	0	0	0	0	0	42	0	15	39	96	4	0	2	3	9
Республика Хакасия	Государственные, муниципальные (без учета организаций в ведении ФСИН); Очная	"    переведено из других образовательных организаций 
    с программ того же уровня / 3.0"	4	0	0	1	5	0	0	0	0	0	9	0	4	27	40	0	0	0	3	3
Республика Хакасия	Государственные, муниципальные (без учета организаций в ведении ФСИН); Очная	    по болезни / 9.0	0	0	0	0	0	0	0	0	0	0	3	0	0	0	3	2	0	0	0	2
Республика Хакасия	Государственные, муниципальные (без учета организаций в ведении ФСИН); Очная	    прибыло по другим причинам / 5.0	13	0	4	3	20	1	0	0	0	1	55	0	41	19	115	3	0	21	0	24
Республика Хакасия	Государственные, муниципальные (без учета организаций в ведении ФСИН); Очная	Выбыло студентов - всего (сумма стр. 07-11, 13-15) / 6.0	298	0	5	50	353	26	0	0	5	31	323	0	80	294	697	54	0	28	70	152
Республика Хакасия	Государственные, муниципальные (без учета организаций в ведении ФСИН); Очная	Прибыло студентов - всего (сумма стр. 02-05) / 1.0	26	0	5	9	40	1	0	0	0	1	82	0	46	58	186	4	0	21	4	29
Республика Хакасия	Государственные, муниципальные (без учета организаций в ведении ФСИН); Очная	"Численность студентов на начало прошлого учебного года
(на 1 октября) / 17.0"	2950	0	60	324	3334	69	0	0	4	73	3677	0	1138	2809	7624	313	0	381	489	1183
Республика Хакасия	Очно-заочная; Государственные, муниципальные (без учета организаций в ведении ФСИН)	            из стр. 11 - не прошли итоговую аттестацию / 12.0	0	0	0	0	0	0	0	0	0	0	0	0	0	0	0	0	0	0	0	0
Республика Хакасия	Очно-заочная; Государственные, муниципальные (без учета организаций в ведении ФСИН)	"            из стр. 11 – лица с ограниченными возможностями здоровья,
            инвалиды, дети-инвалиды / 13.0"	0	0	0	0	0	0	0	0	0	0	0	0	0	0	0	0	0	0	0	0
Республика Хакасия	Очно-заочная; Государственные, муниципальные (без учета организаций в ведении ФСИН)	         отчислено в виде меры дисциплинарного взыскания / 14.0	0	0	0	0	0	0	0	0	0	0	0	0	0	0	0	0	0	0	0	0
Республика Хакасия	Очно-заочная; Государственные, муниципальные (без учета организаций в ведении ФСИН)	         отчислено из-за просрочки оплаты обучения / 15.0	0	0	0	0	0	0	0	0	0	0	0	0	0	0	0	0	0	0	0	0
Республика Хакасия	Очно-заочная; Государственные, муниципальные (без учета организаций в ведении ФСИН)	"    в том числе:
    переведено на другие формы обучения данной
    организации на программы того же уровня / 7.0"	0	0	0	0	0	0	0	0	0	0	0	0	0	0	0	0	0	0	0	0
Республика Хакасия	Очно-заочная; Государственные, муниципальные (без учета организаций в ведении ФСИН)	"    в том числе:
    переведено с других форм обучения данной
    образовательной организации с программ того же уровня / 2.0"	0	0	0	0	0	0	0	0	0	0	0	0	0	0	0	0	0	0	0	0
Республика Хакасия	Очно-заочная; Государственные, муниципальные (без учета организаций в ведении ФСИН)	    восстановлены из числа ранее отчисленных / 4.0	0	0	0	0	0	0	0	0	0	0	0	0	0	0	0	0	0	0	0	0
Республика Хакасия	Очно-заочная; Государственные, муниципальные (без учета организаций в ведении ФСИН)	    выбыло по другим причинам / 16.0	0	0	0	0	0	0	0	0	0	0	0	0	0	0	0	0	0	0	0	0
Республика Хакасия	Очно-заочная; Государственные, муниципальные (без учета организаций в ведении ФСИН)	"    добровольно прекратили образовательные отношения
    (бросили учебу) / 10.0"	0	0	0	0	0	0	0	0	0	0	0	0	0	0	0	0	0	0	0	0
Республика Хакасия	Очно-заочная; Государственные, муниципальные (без учета организаций в ведении ФСИН)	"    отчислено:
         по неуспеваемости / 11.0"	0	0	0	0	0	0	0	0	0	0	0	0	0	0	0	0	0	0	0	0
Республика Хакасия	Очно-заочная; Государственные, муниципальные (без учета организаций в ведении ФСИН)	"    переведено в другие образовательные организации
    на программы того же уровня / 8.0"	0	0	0	0	0	0	0	0	0	0	0	0	0	0	0	0	0	0	0	0
Республика Хакасия	Очно-заочная; Государственные, муниципальные (без учета организаций в ведении ФСИН)	"    переведено из других образовательных организаций 
    с программ того же уровня / 3.0"	0	0	0	0	0	0	0	0	0	0	0	0	0	0	0	0	0	0	0	0
Республика Хакасия	Очно-заочная; Государственные, муниципальные (без учета организаций в ведении ФСИН)	    по болезни / 9.0	0	0	0	0	0	0	0	0	0	0	0	0	0	0	0	0	0	0	0	0
Республика Хакасия	Очно-заочная; Государственные, муниципальные (без учета организаций в ведении ФСИН)	    прибыло по другим причинам / 5.0	0	0	0	0	0	0	0	0	0	0	0	0	0	0	0	0	0	0	0	0
Республика Хакасия	Очно-заочная; Государственные, муниципальные (без учета организаций в ведении ФСИН)	Выбыло студентов - всего (сумма стр. 07-11, 13-15) / 6.0	0	0	0	0	0	0	0	0	0	0	0	0	0	0	0	0	0	0	0	0
Республика Хакасия	Очно-заочная; Государственные, муниципальные (без учета организаций в ведении ФСИН)	Прибыло студентов - всего (сумма стр. 02-05) / 1.0	0	0	0	0	0	0	0	0	0	0	0	0	0	0	0	0	0	0	0	0
Республика Хакасия	Очно-заочная; Государственные, муниципальные (без учета организаций в ведении ФСИН)	"Численность студентов на начало прошлого учебного года
(на 1 октября) / 17.0"	0	0	0	0	0	0	0	0	0	0	0	0	0	0	0	0	0	0	0	0
Республика Хакасия	Частные; Заочная	            из стр. 11 - не прошли итоговую аттестацию / 12.0	0	0	0	0	0	0	0	0	0	0	0	0	0	0	0	0	0	0	0	0
Республика Хакасия	Частные; Заочная	"            из стр. 11 – лица с ограниченными возможностями здоровья,
            инвалиды, дети-инвалиды / 13.0"	0	0	0	0	0	0	0	0	0	0	0	0	0	0	0	0	0	0	0	0
Республика Хакасия	Частные; Заочная	         отчислено в виде меры дисциплинарного взыскания / 14.0	0	0	0	0	0	0	0	0	0	0	0	0	0	0	0	0	0	0	0	0
Республика Хакасия	Частные; Заочная	         отчислено из-за просрочки оплаты обучения / 15.0	0	0	0	0	0	0	0	0	0	0	0	0	0	0	0	0	0	0	0	0
Республика Хакасия	Частные; Заочная	"    в том числе:
    переведено на другие формы обучения данной
    организации на программы того же уровня / 7.0"	0	0	0	0	0	0	0	0	0	0	0	0	0	3	3	0	0	0	2	2
Республика Хакасия	Частные; Заочная	"    в том числе:
    переведено с других форм обучения данной
    образовательной организации с программ того же уровня / 2.0"	0	0	0	0	0	0	0	0	0	0	0	0	0	0	0	0	0	0	0	0
Республика Хакасия	Частные; Заочная	    восстановлены из числа ранее отчисленных / 4.0	0	0	0	0	0	0	0	0	0	0	0	0	0	0	0	0	0	0	0	0
Республика Хакасия	Частные; Заочная	    выбыло по другим причинам / 16.0	0	0	0	0	0	0	0	0	0	0	0	0	0	0	0	0	0	0	0	0
Республика Хакасия	Частные; Заочная	"    добровольно прекратили образовательные отношения
    (бросили учебу) / 10.0"	0	0	0	0	0	0	0	0	0	0	0	0	0	8	8	0	0	0	11	11
Республика Хакасия	Частные; Заочная	"    отчислено:
         по неуспеваемости / 11.0"	0	0	0	0	0	0	0	0	0	0	0	0	0	0	0	0	0	0	0	0
Республика Хакасия	Частные; Заочная	"    переведено в другие образовательные организации
    на программы того же уровня / 8.0"	0	0	0	0	0	0	0	0	0	0	0	0	0	0	0	0	0	0	0	0
Республика Хакасия	Частные; Заочная	"    переведено из других образовательных организаций 
    с программ того же уровня / 3.0"	0	0	0	0	0	0	0	0	0	0	0	0	0	0	0	0	0	0	0	0
Республика Хакасия	Частные; Заочная	    по болезни / 9.0	0	0	0	0	0	0	0	0	0	0	0	0	0	0	0	0	0	0	0	0
Республика Хакасия	Частные; Заочная	    прибыло по другим причинам / 5.0	0	0	0	0	0	0	0	0	0	0	0	0	0	6	6	0	0	0	1	1
Республика Хакасия	Частные; Заочная	Выбыло студентов - всего (сумма стр. 07-11, 13-15) / 6.0	0	0	0	0	0	0	0	0	0	0	0	0	0	11	11	0	0	0	13	13
Республика Хакасия	Частные; Заочная	Прибыло студентов - всего (сумма стр. 02-05) / 1.0	0	0	0	0	0	0	0	0	0	0	0	0	0	6	6	0	0	0	1	1
Республика Хакасия	Частные; Заочная	"Численность студентов на начало прошлого учебного года
(на 1 октября) / 17.0"	0	0	0	0	0	0	0	0	0	0	0	0	0	67	67	0	0	0	108	108
Республика Хакасия	Частные; Очная	            из стр. 11 - не прошли итоговую аттестацию / 12.0	0	0	0	0	0	0	0	0	0	0	0	0	0	0	0	0	0	0	0	0
Республика Хакасия	Частные; Очная	"            из стр. 11 – лица с ограниченными возможностями здоровья,
            инвалиды, дети-инвалиды / 13.0"	0	0	0	0	0	0	0	0	0	0	0	0	0	0	0	0	0	0	0	0
Республика Хакасия	Частные; Очная	         отчислено в виде меры дисциплинарного взыскания / 14.0	0	0	0	0	0	0	0	0	0	0	0	0	0	0	0	0	0	0	0	0
Республика Хакасия	Частные; Очная	         отчислено из-за просрочки оплаты обучения / 15.0	0	0	0	0	0	0	0	0	0	0	0	0	0	13	13	0	0	0	8	8
Республика Хакасия	Частные; Очная	"    в том числе:
    переведено на другие формы обучения данной
    организации на программы того же уровня / 7.0"	0	0	0	0	0	0	0	0	0	0	0	0	0	0	0	0	0	0	0	0
Республика Хакасия	Частные; Очная	"    в том числе:
    переведено с других форм обучения данной
    образовательной организации с программ того же уровня / 2.0"	0	0	0	0	0	0	0	0	0	0	0	0	0	0	0	0	0	0	0	0
Республика Хакасия	Частные; Очная	    восстановлены из числа ранее отчисленных / 4.0	0	0	0	0	0	0	0	0	0	0	0	0	0	17	17	0	0	0	4	4
Республика Хакасия	Частные; Очная	    выбыло по другим причинам / 16.0	0	0	0	0	0	0	0	0	0	0	0	0	0	0	0	0	0	0	0	0
Республика Хакасия	Частные; Очная	"    добровольно прекратили образовательные отношения
    (бросили учебу) / 10.0"	0	0	0	0	0	0	0	0	0	0	4	0	0	25	29	0	0	0	11	11
Республика Хакасия	Частные; Очная	"    отчислено:
         по неуспеваемости / 11.0"	0	0	0	0	0	0	0	0	0	0	0	0	0	31	31	0	0	0	18	18
Республика Хакасия	Частные; Очная	"    переведено в другие образовательные организации
    на программы того же уровня / 8.0"	0	0	0	0	0	0	0	0	0	0	0	0	0	6	6	0	0	0	2	2
Республика Хакасия	Частные; Очная	"    переведено из других образовательных организаций 
    с программ того же уровня / 3.0"	0	0	0	0	0	0	0	0	0	0	0	0	0	8	8	0	0	0	1	1
Республика Хакасия	Частные; Очная	    по болезни / 9.0	0	0	0	0	0	0	0	0	0	0	0	0	0	0	0	0	0	0	0	0
Республика Хакасия	Частные; Очная	    прибыло по другим причинам / 5.0	0	0	0	0	0	0	0	0	0	0	0	0	0	0	0	0	0	0	0	0
Республика Хакасия	Частные; Очная	Выбыло студентов - всего (сумма стр. 07-11, 13-15) / 6.0	0	0	0	0	0	0	0	0	0	0	4	0	0	75	79	0	0	0	39	39
Республика Хакасия	Частные; Очная	Прибыло студентов - всего (сумма стр. 02-05) / 1.0	0	0	0	0	0	0	0	0	0	0	0	0	0	25	25	0	0	0	5	5
Республика Хакасия	Частные; Очная	"Численность студентов на начало прошлого учебного года
(на 1 октября) / 17.0"	0	0	0	0	0	0	0	0	0	0	25	0	10	519	554	0	0	0	168	168
Республика Хакасия	Частные; Очно-заочная	            из стр. 11 - не прошли итоговую аттестацию / 12.0	0	0	0	0	0	0	0	0	0	0	0	0	0	0	0	0	0	0	0	0
Республика Хакасия	Частные; Очно-заочная	"            из стр. 11 – лица с ограниченными возможностями здоровья,
            инвалиды, дети-инвалиды / 13.0"	0	0	0	0	0	0	0	0	0	0	0	0	0	0	0	0	0	0	0	0
Республика Хакасия	Частные; Очно-заочная	         отчислено в виде меры дисциплинарного взыскания / 14.0	0	0	0	0	0	0	0	0	0	0	0	0	0	0	0	0	0	0	0	0
Республика Хакасия	Частные; Очно-заочная	         отчислено из-за просрочки оплаты обучения / 15.0	0	0	0	0	0	0	0	0	0	0	0	0	0	0	0	0	0	0	0	0
Республика Хакасия	Частные; Очно-заочная	"    в том числе:
    переведено на другие формы обучения данной
    организации на программы того же уровня / 7.0"	0	0	0	0	0	0	0	0	0	0	0	0	0	0	0	0	0	0	0	0
Республика Хакасия	Частные; Очно-заочная	"    в том числе:
    переведено с других форм обучения данной
    образовательной организации с программ того же уровня / 2.0"	0	0	0	0	0	0	0	0	0	0	0	0	0	0	0	0	0	0	0	0
Республика Хакасия	Частные; Очно-заочная	    восстановлены из числа ранее отчисленных / 4.0	0	0	0	0	0	0	0	0	0	0	0	0	0	0	0	0	0	0	0	0
Республика Хакасия	Частные; Очно-заочная	    выбыло по другим причинам / 16.0	0	0	0	0	0	0	0	0	0	0	0	0	0	0	0	0	0	0	0	0
Республика Хакасия	Частные; Очно-заочная	"    добровольно прекратили образовательные отношения
    (бросили учебу) / 10.0"	0	0	0	0	0	0	0	0	0	0	0	0	0	0	0	0	0	0	9	9
Республика Хакасия	Частные; Очно-заочная	"    отчислено:
         по неуспеваемости / 11.0"	0	0	0	0	0	0	0	0	0	0	0	0	0	0	0	0	0	0	0	0
Республика Хакасия	Частные; Очно-заочная	"    переведено в другие образовательные организации
    на программы того же уровня / 8.0"	0	0	0	0	0	0	0	0	0	0	0	0	0	0	0	0	0	0	0	0
Республика Хакасия	Частные; Очно-заочная	"    переведено из других образовательных организаций 
    с программ того же уровня / 3.0"	0	0	0	0	0	0	0	0	0	0	0	0	0	0	0	0	0	0	2	2
Республика Хакасия	Частные; Очно-заочная	    по болезни / 9.0	0	0	0	0	0	0	0	0	0	0	0	0	0	0	0	0	0	0	0	0
Республика Хакасия	Частные; Очно-заочная	    прибыло по другим причинам / 5.0	0	0	0	0	0	0	0	0	0	0	0	0	0	0	0	0	0	0	0	0
Республика Хакасия	Частные; Очно-заочная	Выбыло студентов - всего (сумма стр. 07-11, 13-15) / 6.0	0	0	0	0	0	0	0	0	0	0	0	0	0	0	0	0	0	0	9	9
Республика Хакасия	Частные; Очно-заочная	Прибыло студентов - всего (сумма стр. 02-05) / 1.0	0	0	0	0	0	0	0	0	0	0	0	0	0	0	0	0	0	0	2	2
Республика Хакасия	Частные; Очно-заочная	"Численность студентов на начало прошлого учебного года
(на 1 октября) / 17.0"	0	0	0	0	0	0	0	0	0	0	0	0	0	0	0	0	0	0	306	306
Российская Федерация	Государственные, муниципальные (без учета организаций в ведении ФСИН)	            из стр. 11 - не прошли итоговую аттестацию / 12.0	803	14	0	14	831	20	10	2	30	62	856	0	73	344	1273	288	0	51	270	609
Российская Федерация	Государственные, муниципальные (без учета организаций в ведении ФСИН)	"            из стр. 11 – лица с ограниченными возможностями здоровья,
            инвалиды, дети-инвалиды / 13.0"	55	0	4	1	60	12	0	0	0	12	89	0	37	29	155	34	0	13	10	57
Российская Федерация	Государственные, муниципальные (без учета организаций в ведении ФСИН)	         отчислено в виде меры дисциплинарного взыскания / 14.0	494	1	1	21	517	22	0	0	7	29	701	0	91	393	1185	129	9	55	198	391
Российская Федерация	Государственные, муниципальные (без учета организаций в ведении ФСИН)	         отчислено из-за просрочки оплаты обучения / 15.0	0	0	0	279	279	0	0	0	166	166	0	0	0	5256	5256	0	0	0	4293	4293
Российская Федерация	Государственные, муниципальные (без учета организаций в ведении ФСИН)	"    в том числе:
    переведено на другие формы обучения данной
    организации на программы того же уровня / 7.0"	1243	16	37	407	1703	26	0	0	48	74	6385	20	770	7758	14933	1282	6	109	2241	3638
Российская Федерация	Государственные, муниципальные (без учета организаций в ведении ФСИН)	"    в том числе:
    переведено с других форм обучения данной
    образовательной организации с программ того же уровня / 2.0"	2063	15	56	171	2305	81	0	7	62	150	4731	24	820	5235	10810	2575	11	351	4099	7036
Российская Федерация	Государственные, муниципальные (без учета организаций в ведении ФСИН)	    восстановлены из числа ранее отчисленных / 4.0	2101	6	25	153	2285	64	0	1	47	112	4752	41	769	6254	11816	2126	24	201	4223	6574
Российская Федерация	Государственные, муниципальные (без учета организаций в ведении ФСИН)	    выбыло по другим причинам / 16.0	11256	40	79	984	12359	710	7	6	125	848	17610	153	1652	10751	30166	5452	76	585	5919	12032
Российская Федерация	Государственные, муниципальные (без учета организаций в ведении ФСИН)	"    добровольно прекратили образовательные отношения
    (бросили учебу) / 10.0"	23644	131	249	1903	25927	1420	9	6	334	1769	46837	320	8182	28797	84136	17159	87	2821	16465	36532
Российская Федерация	Государственные, муниципальные (без учета организаций в ведении ФСИН)	"    отчислено:
         по неуспеваемости / 11.0"	10237	115	65	438	10855	382	15	2	299	698	15725	91	2750	10823	29389	6865	45	1488	6976	15374
Российская Федерация	Государственные, муниципальные (без учета организаций в ведении ФСИН)	"    переведено в другие образовательные организации
    на программы того же уровня / 8.0"	5221	49	51	346	5667	140	1	0	24	165	16453	61	2458	11030	30002	1852	3	137	2002	3994
Российская Федерация	Государственные, муниципальные (без учета организаций в ведении ФСИН)	"    переведено из других образовательных организаций 
    с программ того же уровня / 3.0"	7315	6	51	414	7786	148	0	45	98	291	12558	36	1545	7949	22088	1744	12	92	1898	3746
Российская Федерация	Государственные, муниципальные (без учета организаций в ведении ФСИН)	    по болезни / 9.0	637	2	4	12	655	17	0	0	13	30	527	6	158	240	931	154	1	44	230	429
Российская Федерация	Государственные, муниципальные (без учета организаций в ведении ФСИН)	    прибыло по другим причинам / 5.0	6734	10	68	765	7577	670	2	0	166	838	13447	64	1673	7759	22943	4025	26	732	4995	9778
Российская Федерация	Государственные, муниципальные (без учета организаций в ведении ФСИН)	Выбыло студентов - всего (сумма стр. 07-11, 13-15) / 6.0	52732	354	486	4390	57962	2717	32	14	1016	3779	104238	651	16061	75048	195998	32893	227	5239	38324	76683
Российская Федерация	Государственные, муниципальные (без учета организаций в ведении ФСИН)	Прибыло студентов - всего (сумма стр. 02-05) / 1.0	18213	37	200	1503	19953	963	2	53	373	1391	35488	165	4807	27197	67657	10470	73	1376	15215	27134
Российская Федерация	Государственные, муниципальные (без учета организаций в ведении ФСИН)	"Численность студентов на начало прошлого учебного года
(на 1 октября) / 17.0"	505477	3067	5131	27874	541549	19299	71	99	7039	26508	1221135	6836	224146	566779	2018896	271662	2093	48396	243982	566133
Российская Федерация	Государственные, муниципальные (без учета организаций в ведении ФСИН); Заочная	            из стр. 11 - не прошли итоговую аттестацию / 12.0	0	0	0	0	0	0	0	0	0	0	27	0	4	58	89	186	0	27	144	357
Российская Федерация	Государственные, муниципальные (без учета организаций в ведении ФСИН); Заочная	"            из стр. 11 – лица с ограниченными возможностями здоровья,
            инвалиды, дети-инвалиды / 13.0"	0	0	0	0	0	0	0	0	0	0	1	0	0	1	2	4	0	0	1	5
Российская Федерация	Государственные, муниципальные (без учета организаций в ведении ФСИН); Заочная	         отчислено в виде меры дисциплинарного взыскания / 14.0	0	0	0	0	0	0	0	0	0	0	1	0	0	19	20	23	9	15	63	110
Российская Федерация	Государственные, муниципальные (без учета организаций в ведении ФСИН); Заочная	         отчислено из-за просрочки оплаты обучения / 15.0	0	0	0	0	0	0	0	0	0	0	0	0	0	2209	2209	0	0	0	2872	2872
Российская Федерация	Государственные, муниципальные (без учета организаций в ведении ФСИН); Заочная	"    в том числе:
    переведено на другие формы обучения данной
    организации на программы того же уровня / 7.0"	0	0	0	0	0	0	0	0	3	3	113	8	8	572	701	256	3	40	583	882
Российская Федерация	Государственные, муниципальные (без учета организаций в ведении ФСИН); Заочная	"    в том числе:
    переведено с других форм обучения данной
    образовательной организации с программ того же уровня / 2.0"	0	0	0	0	0	0	0	0	0	0	377	17	45	3426	3865	1225	8	148	3244	4625
Российская Федерация	Государственные, муниципальные (без учета организаций в ведении ФСИН); Заочная	    восстановлены из числа ранее отчисленных / 4.0	0	0	0	0	0	0	0	0	0	0	109	1	23	1577	1710	948	1	80	2575	3604
Российская Федерация	Государственные, муниципальные (без учета организаций в ведении ФСИН); Заочная	    выбыло по другим причинам / 16.0	0	0	0	0	0	0	0	0	0	0	139	0	35	1292	1466	2329	22	300	2823	5474
Российская Федерация	Государственные, муниципальные (без учета организаций в ведении ФСИН); Заочная	"    добровольно прекратили образовательные отношения
    (бросили учебу) / 10.0"	0	0	0	0	0	0	0	0	0	0	528	10	124	2567	3229	5712	28	883	5985	12608
Российская Федерация	Государственные, муниципальные (без учета организаций в ведении ФСИН); Заочная	"    отчислено:
         по неуспеваемости / 11.0"	0	0	0	0	0	0	0	0	0	0	452	14	89	2369	2924	3965	11	662	3712	8350
Российская Федерация	Государственные, муниципальные (без учета организаций в ведении ФСИН); Заочная	"    переведено в другие образовательные организации
    на программы того же уровня / 8.0"	0	0	0	0	0	0	0	0	0	0	50	4	14	417	485	217	0	15	413	645
Российская Федерация	Государственные, муниципальные (без учета организаций в ведении ФСИН); Заочная	"    переведено из других образовательных организаций 
    с программ того же уровня / 3.0"	0	0	0	0	0	0	0	0	0	0	62	3	16	841	922	424	7	18	754	1203
Российская Федерация	Государственные, муниципальные (без учета организаций в ведении ФСИН); Заочная	    по болезни / 9.0	0	0	0	0	0	0	0	0	0	0	4	0	1	15	20	54	0	12	64	130
Российская Федерация	Государственные, муниципальные (без учета организаций в ведении ФСИН); Заочная	    прибыло по другим причинам / 5.0	0	0	0	0	0	0	0	0	0	0	72	0	19	1351	1442	1692	6	167	2924	4789
Российская Федерация	Государственные, муниципальные (без учета организаций в ведении ФСИН); Заочная	Выбыло студентов - всего (сумма стр. 07-11, 13-15) / 6.0	0	0	0	0	0	0	0	0	3	3	1287	36	271	9460	11054	12556	73	1927	16515	31071
Российская Федерация	Государственные, муниципальные (без учета организаций в ведении ФСИН); Заочная	Прибыло студентов - всего (сумма стр. 02-05) / 1.0	0	0	0	0	0	0	0	0	0	0	620	21	103	7195	7939	4289	22	413	9497	14221
Российская Федерация	Государственные, муниципальные (без учета организаций в ведении ФСИН); Заочная	"Численность студентов на начало прошлого учебного года
(на 1 октября) / 17.0"	0	0	0	0	0	0	0	0	19	19	10076	230	1761	48190	60257	100579	809	15016	99682	216086
Российская Федерация	Государственные, муниципальные (без учета организаций в ведении ФСИН); Очная	            из стр. 11 - не прошли итоговую аттестацию / 12.0	803	14	0	14	831	20	10	2	29	61	829	0	69	280	1178	81	0	21	117	219
Российская Федерация	Государственные, муниципальные (без учета организаций в ведении ФСИН); Очная	"            из стр. 11 – лица с ограниченными возможностями здоровья,
            инвалиды, дети-инвалиды / 13.0"	55	0	4	1	60	12	0	0	0	12	88	0	37	28	153	29	0	13	7	49
Российская Федерация	Государственные, муниципальные (без учета организаций в ведении ФСИН); Очная	         отчислено в виде меры дисциплинарного взыскания / 14.0	493	1	1	19	514	22	0	0	7	29	700	0	91	373	1164	88	0	40	87	215
Российская Федерация	Государственные, муниципальные (без учета организаций в ведении ФСИН); Очная	         отчислено из-за просрочки оплаты обучения / 15.0	0	0	0	267	267	0	0	0	127	127	0	0	0	2901	2901	0	0	0	995	995
Российская Федерация	Государственные, муниципальные (без учета организаций в ведении ФСИН); Очная	"    в том числе:
    переведено на другие формы обучения данной
    организации на программы того же уровня / 7.0"	1238	16	37	395	1686	26	0	0	25	51	6268	12	758	7007	14045	980	3	69	1540	2592
Российская Федерация	Государственные, муниципальные (без учета организаций в ведении ФСИН); Очная	"    в том числе:
    переведено с других форм обучения данной
    образовательной организации с программ того же уровня / 2.0"	2056	15	56	153	2280	81	0	7	55	143	4343	7	775	1700	6825	1185	3	203	591	1982
Российская Федерация	Государственные, муниципальные (без учета организаций в ведении ФСИН); Очная	    восстановлены из числа ранее отчисленных / 4.0	2097	6	25	148	2276	62	0	1	20	83	4638	40	746	4615	10039	1060	23	116	1339	2538
Российская Федерация	Государственные, муниципальные (без учета организаций в ведении ФСИН); Очная	    выбыло по другим причинам / 16.0	11256	40	79	901	12276	682	7	6	97	792	17448	153	1617	9342	28560	2777	54	277	2533	5641
Российская Федерация	Государственные, муниципальные (без учета организаций в ведении ФСИН); Очная	"    добровольно прекратили образовательные отношения
    (бросили учебу) / 10.0"	23625	130	249	1861	25865	1335	9	6	298	1648	46222	310	8055	25985	80572	10479	59	1936	8031	20505
Российская Федерация	Государственные, муниципальные (без учета организаций в ведении ФСИН); Очная	"    отчислено:
         по неуспеваемости / 11.0"	10235	114	65	422	10836	381	15	2	191	589	15248	77	2659	8360	26344	2449	26	823	2863	6161
Российская Федерация	Государственные, муниципальные (без учета организаций в ведении ФСИН); Очная	"    переведено в другие образовательные организации
    на программы того же уровня / 8.0"	5217	49	51	338	5655	140	1	0	24	165	16402	57	2444	10514	29417	1586	3	121	1358	3068
Российская Федерация	Государственные, муниципальные (без учета организаций в ведении ФСИН); Очная	"    переведено из других образовательных организаций 
    с программ того же уровня / 3.0"	7307	6	51	378	7742	148	0	45	94	287	12484	33	1529	6997	21043	1237	5	70	939	2251
Российская Федерация	Государственные, муниципальные (без учета организаций в ведении ФСИН); Очная	    по болезни / 9.0	637	2	4	12	655	15	0	0	13	28	521	6	157	220	904	99	1	32	137	269
Российская Федерация	Государственные, муниципальные (без учета организаций в ведении ФСИН); Очная	    прибыло по другим причинам / 5.0	6722	10	68	698	7498	664	2	0	116	782	13344	64	1654	6299	21361	2190	20	564	1625	4399
Российская Федерация	Государственные, муниципальные (без учета организаций в ведении ФСИН); Очная	Выбыло студентов - всего (сумма стр. 07-11, 13-15) / 6.0	52701	352	486	4215	57754	2601	32	14	782	3429	102809	615	15781	64702	183907	18458	146	3298	17544	39446
Российская Федерация	Государственные, муниципальные (без учета организаций в ведении ФСИН); Очная	Прибыло студентов - всего (сумма стр. 02-05) / 1.0	18182	37	200	1377	19796	955	2	53	285	1295	34809	144	4704	19611	59268	5672	51	953	4494	11170
Российская Федерация	Государственные, муниципальные (без учета организаций в ведении ФСИН); Очная	"Численность студентов на начало прошлого учебного года
(на 1 октября) / 17.0"	505089	3014	5131	27129	540363	18197	71	99	6309	24676	1210176	6606	222320	513761	1952863	156010	1284	33264	111462	302020
Российская Федерация	Заочная	            из стр. 11 - не прошли итоговую аттестацию / 12.0	0	0	0	0	0	0	0	0	0	0	27	0	4	193	224	186	0	27	279	492
Российская Федерация	Заочная	"            из стр. 11 – лица с ограниченными возможностями здоровья,
            инвалиды, дети-инвалиды / 13.0"	0	0	0	0	0	0	0	0	0	0	1	0	0	2	3	4	0	0	1	5
Российская Федерация	Заочная	         отчислено в виде меры дисциплинарного взыскания / 14.0	0	0	0	0	0	0	0	0	0	0	1	0	0	60	61	23	9	15	85	132
Российская Федерация	Заочная	         отчислено из-за просрочки оплаты обучения / 15.0	0	0	0	1	1	0	0	0	0	0	0	0	0	5851	5851	0	0	0	5818	5818
Российская Федерация	Заочная	"    в том числе:
    переведено на другие формы обучения данной
    организации на программы того же уровня / 7.0"	0	0	0	2	2	0	0	0	3	3	113	8	8	1845	1974	256	3	40	1561	1860
Российская Федерация	Заочная	"    в том числе:
    переведено с других форм обучения данной
    образовательной организации с программ того же уровня / 2.0"	0	0	0	2	2	0	0	0	0	0	379	17	45	6988	7429	1227	8	148	5014	6397
Российская Федерация	Заочная	    восстановлены из числа ранее отчисленных / 4.0	0	0	0	0	0	0	0	0	1	1	109	5	23	4285	4422	948	1	80	4776	5805
Российская Федерация	Заочная	    выбыло по другим причинам / 16.0	0	0	0	0	0	0	0	0	0	0	139	0	35	2589	2763	2334	22	300	4546	7202
Российская Федерация	Заочная	"    добровольно прекратили образовательные отношения
    (бросили учебу) / 10.0"	0	0	0	0	0	0	0	0	1	1	530	10	124	5462	6126	5716	28	883	8593	15220
Российская Федерация	Заочная	"    отчислено:
         по неуспеваемости / 11.0"	0	0	0	0	0	0	0	0	0	0	452	14	89	4839	5394	3976	11	662	6064	10713
Российская Федерация	Заочная	"    переведено в другие образовательные организации
    на программы того же уровня / 8.0"	0	0	0	1	1	0	0	0	0	0	50	4	14	1257	1325	217	0	15	1073	1305
Российская Федерация	Заочная	"    переведено из других образовательных организаций 
    с программ того же уровня / 3.0"	0	0	0	2	2	0	0	0	0	0	62	4	16	4756	4838	424	7	18	3001	3450
Российская Федерация	Заочная	    по болезни / 9.0	0	0	0	0	0	0	0	0	0	0	4	0	1	29	34	54	0	12	83	149
Российская Федерация	Заочная	    прибыло по другим причинам / 5.0	0	0	0	0	0	0	0	0	0	0	72	9	19	5984	6084	1692	6	167	6001	7866
Российская Федерация	Заочная	Выбыло студентов - всего (сумма стр. 07-11, 13-15) / 6.0	0	0	0	4	4	0	0	0	4	4	1289	36	271	21932	23528	12576	73	1927	27823	42399
Российская Федерация	Заочная	Прибыло студентов - всего (сумма стр. 02-05) / 1.0	0	0	0	4	4	0	0	0	1	1	622	35	103	22013	22773	4291	22	413	18792	23518
Российская Федерация	Заочная	"Численность студентов на начало прошлого учебного года
(на 1 октября) / 17.0"	0	0	0	10	10	0	0	0	19	19	10132	230	1761	105414	117537	100738	811	15016	146088	262653
Российская Федерация	Очная	            из стр. 11 - не прошли итоговую аттестацию / 12.0	805	14	1	15	835	20	10	2	45	77	833	1	69	587	1490	81	0	21	223	325
Российская Федерация	Очная	"            из стр. 11 – лица с ограниченными возможностями здоровья,
            инвалиды, дети-инвалиды / 13.0"	55	0	4	1	60	12	0	0	0	12	88	0	37	30	155	29	0	13	7	49
Российская Федерация	Очная	         отчислено в виде меры дисциплинарного взыскания / 14.0	493	1	1	30	525	22	0	0	9	31	705	0	91	528	1324	88	0	40	109	237
Российская Федерация	Очная	         отчислено из-за просрочки оплаты обучения / 15.0	0	0	0	284	284	0	0	0	174	174	0	0	0	6045	6045	0	0	0	1945	1945
Российская Федерация	Очная	"    в том числе:
    переведено на другие формы обучения данной
    организации на программы того же уровня / 7.0"	1238	16	37	396	1687	26	0	0	33	59	6292	29	758	10985	18064	984	3	69	3037	4093
Российская Федерация	Очная	"    в том числе:
    переведено с других форм обучения данной
    образовательной организации с программ того же уровня / 2.0"	2056	15	56	157	2284	81	0	7	60	148	4367	8	778	3802	8955	1185	3	203	1004	2395
Российская Федерация	Очная	    восстановлены из числа ранее отчисленных / 4.0	2098	6	25	160	2289	62	0	1	29	92	4645	60	746	6582	12033	1060	23	116	1907	3106
Российская Федерация	Очная	    выбыло по другим причинам / 16.0	11258	40	79	929	12306	682	7	6	140	835	17464	231	1640	14616	33951	2781	54	277	4883	7995
Российская Федерация	Очная	"    добровольно прекратили образовательные отношения
    (бросили учебу) / 10.0"	23631	130	249	1932	25942	1335	9	6	341	1691	46382	398	8071	34462	89313	10517	59	1942	10747	23265
Российская Федерация	Очная	"    отчислено:
         по неуспеваемости / 11.0"	10242	114	66	453	10875	383	15	2	263	663	15291	85	2662	13073	31111	2455	27	827	4317	7626
Российская Федерация	Очная	"    переведено в другие образовательные организации
    на программы того же уровня / 8.0"	5217	49	51	354	5671	140	1	0	111	252	16428	104	2444	14770	33746	1586	3	123	2252	3964
Российская Федерация	Очная	"    переведено из других образовательных организаций 
    с программ того же уровня / 3.0"	7308	6	51	471	7836	148	0	45	140	333	12497	54	1529	13904	27984	1238	5	70	2695	4008
Российская Федерация	Очная	    по болезни / 9.0	637	2	4	15	658	15	0	0	13	28	523	6	157	293	979	100	1	32	157	290
Российская Федерация	Очная	    прибыло по другим причинам / 5.0	6722	10	68	768	7568	664	2	0	355	1021	13504	64	1684	13577	28829	2204	20	564	5403	8191
Российская Федерация	Очная	Выбыло студентов - всего (сумма стр. 07-11, 13-15) / 6.0	52716	352	487	4393	57948	2603	32	14	1084	3733	103085	853	15823	94772	214533	18511	147	3310	27447	49415
Российская Федерация	Очная	Прибыло студентов - всего (сумма стр. 02-05) / 1.0	18184	37	200	1556	19977	955	2	53	584	1594	35013	186	4737	37865	77801	5687	51	953	11009	17700
Российская Федерация	Очная	"Численность студентов на начало прошлого учебного года
(на 1 октября) / 17.0"	505401	3064	5165	28601	542231	18278	71	99	8332	26780	1214975	9725	223114	725729	2173543	156573	1371	33343	156652	347939
Российская Федерация	Очно-заочная	            из стр. 11 - не прошли итоговую аттестацию / 12.0	0	0	0	0	0	0	0	0	4	4	0	0	0	6	6	21	0	3	18	42
Российская Федерация	Очно-заочная	"            из стр. 11 – лица с ограниченными возможностями здоровья,
            инвалиды, дети-инвалиды / 13.0"	0	0	0	0	0	0	0	0	0	0	0	0	0	0	0	1	0	0	2	3
Российская Федерация	Очно-заочная	         отчислено в виде меры дисциплинарного взыскания / 14.0	1	0	0	2	3	0	0	0	0	0	0	0	0	6	6	18	0	0	49	67
Российская Федерация	Очно-заочная	         отчислено из-за просрочки оплаты обучения / 15.0	0	0	0	46	46	0	0	0	287	287	0	0	0	686	686	0	0	0	1089	1089
Российская Федерация	Очно-заочная	"    в том числе:
    переведено на другие формы обучения данной
    организации на программы того же уровня / 7.0"	5	0	0	17	22	0	0	0	26	26	4	0	4	715	723	46	0	0	1015	1061
Российская Федерация	Очно-заочная	"    в том числе:
    переведено с других форм обучения данной
    образовательной организации с программ того же уровня / 2.0"	7	0	0	62	69	0	0	0	86	86	11	0	0	354	365	165	0	0	972	1137
Российская Федерация	Очно-заочная	    восстановлены из числа ранее отчисленных / 4.0	4	0	0	6	10	2	0	0	29	31	5	0	0	145	150	118	1	5	429	553
Российская Федерация	Очно-заочная	    выбыло по другим причинам / 16.0	0	0	0	90	90	28	0	0	498	526	23	0	0	479	502	346	0	8	969	1323
Российская Федерация	Очно-заочная	"    добровольно прекратили образовательные отношения
    (бросили учебу) / 10.0"	19	1	0	73	93	85	0	0	411	496	87	0	3	1433	1523	968	3	2	3803	4776
Российская Федерация	Очно-заочная	"    отчислено:
         по неуспеваемости / 11.0"	2	1	0	18	21	1	0	0	243	244	25	0	2	700	727	451	8	3	913	1375
Российская Федерация	Очно-заочная	"    переведено в другие образовательные организации
    на программы того же уровня / 8.0"	4	0	0	21	25	0	0	0	0	0	1	0	0	501	502	49	3	1	757	810
Российская Федерация	Очно-заочная	"    переведено из других образовательных организаций 
    с программ того же уровня / 3.0"	8	0	0	71	79	0	0	0	9	9	12	0	0	802	814	83	0	4	990	1077
Российская Федерация	Очно-заочная	    по болезни / 9.0	0	0	0	9	9	2	0	0	1	3	2	0	0	9	11	1	0	0	71	72
Российская Федерация	Очно-заочная	    прибыло по другим причинам / 5.0	12	0	0	74	86	6	0	0	1726	1732	31	0	0	3398	3429	143	0	1	3447	3591
Российская Федерация	Очно-заочная	Выбыло студентов - всего (сумма стр. 07-11, 13-15) / 6.0	31	2	0	276	309	116	0	0	1466	1582	142	0	9	4529	4680	1879	14	14	8666	10573
Российская Федерация	Очно-заочная	Прибыло студентов - всего (сумма стр. 02-05) / 1.0	31	0	0	213	244	8	0	0	1850	1858	59	0	0	4699	4758	509	1	10	5838	6358
Российская Федерация	Очно-заочная	"Численность студентов на начало прошлого учебного года
(на 1 октября) / 17.0"	388	53	0	1192	1633	1102	0	0	1026	2128	883	0	65	8718	9666	15073	24	116	42784	57997
Российская Федерация	Очно-заочная; Государственные, муниципальные (без учета организаций в ведении ФСИН)	            из стр. 11 - не прошли итоговую аттестацию / 12.0	0	0	0	0	0	0	0	0	1	1	0	0	0	6	6	21	0	3	9	33
Российская Федерация	Очно-заочная; Государственные, муниципальные (без учета организаций в ведении ФСИН)	"            из стр. 11 – лица с ограниченными возможностями здоровья,
            инвалиды, дети-инвалиды / 13.0"	0	0	0	0	0	0	0	0	0	0	0	0	0	0	0	1	0	0	2	3
Российская Федерация	Очно-заочная; Государственные, муниципальные (без учета организаций в ведении ФСИН)	         отчислено в виде меры дисциплинарного взыскания / 14.0	1	0	0	2	3	0	0	0	0	0	0	0	0	1	1	18	0	0	48	66
Российская Федерация	Очно-заочная; Государственные, муниципальные (без учета организаций в ведении ФСИН)	         отчислено из-за просрочки оплаты обучения / 15.0	0	0	0	12	12	0	0	0	39	39	0	0	0	146	146	0	0	0	426	426
Российская Федерация	Очно-заочная; Государственные, муниципальные (без учета организаций в ведении ФСИН)	"    в том числе:
    переведено на другие формы обучения данной
    организации на программы того же уровня / 7.0"	5	0	0	12	17	0	0	0	20	20	4	0	4	179	187	46	0	0	118	164
Российская Федерация	Очно-заочная; Государственные, муниципальные (без учета организаций в ведении ФСИН)	"    в том числе:
    переведено с других форм обучения данной
    образовательной организации с программ того же уровня / 2.0"	7	0	0	18	25	0	0	0	7	7	11	0	0	109	120	165	0	0	264	429
Российская Федерация	Очно-заочная; Государственные, муниципальные (без учета организаций в ведении ФСИН)	    восстановлены из числа ранее отчисленных / 4.0	4	0	0	5	9	2	0	0	27	29	5	0	0	62	67	118	0	5	309	432
Российская Федерация	Очно-заочная; Государственные, муниципальные (без учета организаций в ведении ФСИН)	    выбыло по другим причинам / 16.0	0	0	0	83	83	28	0	0	28	56	23	0	0	117	140	346	0	8	563	917
Российская Федерация	Очно-заочная; Государственные, муниципальные (без учета организаций в ведении ФСИН)	"    добровольно прекратили образовательные отношения
    (бросили учебу) / 10.0"	19	1	0	42	62	85	0	0	36	121	87	0	3	245	335	968	0	2	2449	3419
Российская Федерация	Очно-заочная; Государственные, муниципальные (без учета организаций в ведении ФСИН)	"    отчислено:
         по неуспеваемости / 11.0"	2	1	0	16	19	1	0	0	108	109	25	0	2	94	121	451	8	3	401	863
Российская Федерация	Очно-заочная; Государственные, муниципальные (без учета организаций в ведении ФСИН)	"    переведено в другие образовательные организации
    на программы того же уровня / 8.0"	4	0	0	8	12	0	0	0	0	0	1	0	0	99	100	49	0	1	231	281
Российская Федерация	Очно-заочная; Государственные, муниципальные (без учета организаций в ведении ФСИН)	"    переведено из других образовательных организаций 
    с программ того же уровня / 3.0"	8	0	0	36	44	0	0	0	4	4	12	0	0	111	123	83	0	4	205	292
Российская Федерация	Очно-заочная; Государственные, муниципальные (без учета организаций в ведении ФСИН)	    по болезни / 9.0	0	0	0	0	0	2	0	0	0	2	2	0	0	5	7	1	0	0	29	30
Российская Федерация	Очно-заочная; Государственные, муниципальные (без учета организаций в ведении ФСИН)	    прибыло по другим причинам / 5.0	12	0	0	67	79	6	0	0	50	56	31	0	0	109	140	143	0	1	446	590
Российская Федерация	Очно-заочная; Государственные, муниципальные (без учета организаций в ведении ФСИН)	Выбыло студентов - всего (сумма стр. 07-11, 13-15) / 6.0	31	2	0	175	208	116	0	0	231	347	142	0	9	886	1037	1879	8	14	4265	6166
Российская Федерация	Очно-заочная; Государственные, муниципальные (без учета организаций в ведении ФСИН)	Прибыло студентов - всего (сумма стр. 02-05) / 1.0	31	0	0	126	157	8	0	0	88	96	59	0	0	391	450	509	0	10	1224	1743
Российская Федерация	Очно-заочная; Государственные, муниципальные (без учета организаций в ведении ФСИН)	"Численность студентов на начало прошлого учебного года
(на 1 октября) / 17.0"	388	53	0	745	1186	1102	0	0	711	1813	883	0	65	4828	5776	15073	0	116	32838	48027
Российская Федерация	Частные	            из стр. 11 - не прошли итоговую аттестацию / 12.0	2	0	1	1	4	0	0	0	19	19	4	1	0	442	447	0	0	0	250	250
Российская Федерация	Частные	"            из стр. 11 – лица с ограниченными возможностями здоровья,
            инвалиды, дети-инвалиды / 13.0"	0	0	0	0	0	0	0	0	0	0	0	0	0	3	3	0	0	0	0	0
Российская Федерация	Частные	         отчислено в виде меры дисциплинарного взыскания / 14.0	0	0	0	11	11	0	0	0	2	2	5	0	0	201	206	0	0	0	45	45
Российская Федерация	Частные	         отчислено из-за просрочки оплаты обучения / 15.0	0	0	0	52	52	0	0	0	295	295	0	0	0	7326	7326	0	0	0	4559	4559
Российская Федерация	Частные	"    в том числе:
    переведено на другие формы обучения данной
    организации на программы того же уровня / 7.0"	0	0	0	8	8	0	0	0	14	14	24	17	0	5787	5828	4	0	0	3372	3376
Российская Федерация	Частные	"    в том числе:
    переведено с других форм обучения данной
    образовательной организации с программ того же уровня / 2.0"	0	0	0	50	50	0	0	0	84	84	26	1	3	5909	5939	2	0	0	2891	2893
Российская Федерация	Частные	    восстановлены из числа ранее отчисленных / 4.0	1	0	0	13	14	0	0	0	12	12	7	24	0	4758	4789	0	1	0	2889	2890
Российская Федерация	Частные	    выбыло по другим причинам / 16.0	2	0	0	35	37	0	0	0	513	513	16	78	23	6933	7050	9	0	0	4479	4488
Российская Федерация	Частные	"    добровольно прекратили образовательные отношения
    (бросили учебу) / 10.0"	6	0	0	102	108	0	0	0	419	419	162	88	16	12560	12826	42	3	6	6678	6729
Российская Федерация	Частные	"    отчислено:
         по неуспеваемости / 11.0"	7	0	1	33	41	2	0	0	207	209	43	8	3	7789	7843	17	1	4	4318	4340
Российская Федерация	Частные	"    переведено в другие образовательные организации
    на программы того же уровня / 8.0"	0	0	0	30	30	0	0	0	87	87	26	47	0	5498	5571	0	3	2	2080	2085
Российская Федерация	Частные	"    переведено из других образовательных организаций 
    с программ того же уровня / 3.0"	1	0	0	130	131	0	0	0	51	51	13	22	0	11513	11548	1	0	0	4788	4789
Российская Федерация	Частные	    по болезни / 9.0	0	0	0	12	12	0	0	0	1	1	2	0	0	91	93	1	0	0	81	82
Российская Федерация	Частные	    прибыло по другим причинам / 5.0	0	0	0	77	77	0	0	0	1915	1915	160	9	30	15200	15399	14	0	0	9856	9870
Российская Федерация	Частные	Выбыло студентов - всего (сумма стр. 07-11, 13-15) / 6.0	15	0	1	283	299	2	0	0	1538	1540	278	238	42	46185	46743	73	7	12	25612	25704
Российская Федерация	Частные	Прибыло студентов - всего (сумма стр. 02-05) / 1.0	2	0	0	270	272	0	0	0	2062	2062	206	56	33	37380	37675	17	1	0	20424	20442
Российская Федерация	Частные	"Численность студентов на начало прошлого учебного года
(на 1 октября) / 17.0"	312	50	34	1929	2325	81	0	0	2338	2419	4855	3119	794	273082	281850	722	113	79	101542	102456
Российская Федерация	Частные; Заочная	            из стр. 11 - не прошли итоговую аттестацию / 12.0	0	0	0	0	0	0	0	0	0	0	0	0	0	135	135	0	0	0	135	135
Российская Федерация	Частные; Заочная	"            из стр. 11 – лица с ограниченными возможностями здоровья,
            инвалиды, дети-инвалиды / 13.0"	0	0	0	0	0	0	0	0	0	0	0	0	0	1	1	0	0	0	0	0
Российская Федерация	Частные; Заочная	         отчислено в виде меры дисциплинарного взыскания / 14.0	0	0	0	0	0	0	0	0	0	0	0	0	0	41	41	0	0	0	22	22
Российская Федерация	Частные; Заочная	         отчислено из-за просрочки оплаты обучения / 15.0	0	0	0	1	1	0	0	0	0	0	0	0	0	3642	3642	0	0	0	2946	2946
Российская Федерация	Частные; Заочная	"    в том числе:
    переведено на другие формы обучения данной
    организации на программы того же уровня / 7.0"	0	0	0	2	2	0	0	0	0	0	0	0	0	1273	1273	0	0	0	978	978
Российская Федерация	Частные; Заочная	"    в том числе:
    переведено с других форм обучения данной
    образовательной организации с программ того же уровня / 2.0"	0	0	0	2	2	0	0	0	0	0	2	0	0	3562	3564	2	0	0	1770	1772
Российская Федерация	Частные; Заочная	    восстановлены из числа ранее отчисленных / 4.0	0	0	0	0	0	0	0	0	1	1	0	4	0	2708	2712	0	0	0	2201	2201
Российская Федерация	Частные; Заочная	    выбыло по другим причинам / 16.0	0	0	0	0	0	0	0	0	0	0	0	0	0	1297	1297	5	0	0	1723	1728
Российская Федерация	Частные; Заочная	"    добровольно прекратили образовательные отношения
    (бросили учебу) / 10.0"	0	0	0	0	0	0	0	0	1	1	2	0	0	2895	2897	4	0	0	2608	2612
Российская Федерация	Частные; Заочная	"    отчислено:
         по неуспеваемости / 11.0"	0	0	0	0	0	0	0	0	0	0	0	0	0	2470	2470	11	0	0	2352	2363
Российская Федерация	Частные; Заочная	"    переведено в другие образовательные организации
    на программы того же уровня / 8.0"	0	0	0	1	1	0	0	0	0	0	0	0	0	840	840	0	0	0	660	660
Российская Федерация	Частные; Заочная	"    переведено из других образовательных организаций 
    с программ того же уровня / 3.0"	0	0	0	2	2	0	0	0	0	0	0	1	0	3915	3916	0	0	0	2247	2247
Российская Федерация	Частные; Заочная	    по болезни / 9.0	0	0	0	0	0	0	0	0	0	0	0	0	0	14	14	0	0	0	19	19
Российская Федерация	Частные; Заочная	    прибыло по другим причинам / 5.0	0	0	0	0	0	0	0	0	0	0	0	9	0	4633	4642	0	0	0	3077	3077
Российская Федерация	Частные; Заочная	Выбыло студентов - всего (сумма стр. 07-11, 13-15) / 6.0	0	0	0	4	4	0	0	0	1	1	2	0	0	12472	12474	20	0	0	11308	11328
Российская Федерация	Частные; Заочная	Прибыло студентов - всего (сумма стр. 02-05) / 1.0	0	0	0	4	4	0	0	0	1	1	2	14	0	14818	14834	2	0	0	9295	9297
Российская Федерация	Частные; Заочная	"Численность студентов на начало прошлого учебного года
(на 1 октября) / 17.0"	0	0	0	10	10	0	0	0	0	0	56	0	0	57224	57280	159	2	0	46406	46567
Российская Федерация	Частные; Очная	            из стр. 11 - не прошли итоговую аттестацию / 12.0	2	0	1	1	4	0	0	0	16	16	4	1	0	307	312	0	0	0	106	106
Российская Федерация	Частные; Очная	"            из стр. 11 – лица с ограниченными возможностями здоровья,
            инвалиды, дети-инвалиды / 13.0"	0	0	0	0	0	0	0	0	0	0	0	0	0	2	2	0	0	0	0	0
Российская Федерация	Частные; Очная	         отчислено в виде меры дисциплинарного взыскания / 14.0	0	0	0	11	11	0	0	0	2	2	5	0	0	155	160	0	0	0	22	22
Российская Федерация	Частные; Очная	         отчислено из-за просрочки оплаты обучения / 15.0	0	0	0	17	17	0	0	0	47	47	0	0	0	3144	3144	0	0	0	950	950
Российская Федерация	Частные; Очная	"    в том числе:
    переведено на другие формы обучения данной
    организации на программы того же уровня / 7.0"	0	0	0	1	1	0	0	0	8	8	24	17	0	3978	4019	4	0	0	1497	1501
Российская Федерация	Частные; Очная	"    в том числе:
    переведено с других форм обучения данной
    образовательной организации с программ того же уровня / 2.0"	0	0	0	4	4	0	0	0	5	5	24	1	3	2102	2130	0	0	0	413	413
Российская Федерация	Частные; Очная	    восстановлены из числа ранее отчисленных / 4.0	1	0	0	12	13	0	0	0	9	9	7	20	0	1967	1994	0	0	0	568	568
Российская Федерация	Частные; Очная	    выбыло по другим причинам / 16.0	2	0	0	28	30	0	0	0	43	43	16	78	23	5274	5391	4	0	0	2350	2354
Российская Федерация	Частные; Очная	"    добровольно прекратили образовательные отношения
    (бросили учебу) / 10.0"	6	0	0	71	77	0	0	0	43	43	160	88	16	8477	8741	38	0	6	2716	2760
Российская Федерация	Частные; Очная	"    отчислено:
         по неуспеваемости / 11.0"	7	0	1	31	39	2	0	0	72	74	43	8	3	4713	4767	6	1	4	1454	1465
Российская Федерация	Частные; Очная	"    переведено в другие образовательные организации
    на программы того же уровня / 8.0"	0	0	0	16	16	0	0	0	87	87	26	47	0	4256	4329	0	0	2	894	896
Российская Федерация	Частные; Очная	"    переведено из других образовательных организаций 
    с программ того же уровня / 3.0"	1	0	0	93	94	0	0	0	46	46	13	21	0	6907	6941	1	0	0	1756	1757
Российская Федерация	Частные; Очная	    по болезни / 9.0	0	0	0	3	3	0	0	0	0	0	2	0	0	73	75	1	0	0	20	21
Российская Федерация	Частные; Очная	    прибыло по другим причинам / 5.0	0	0	0	70	70	0	0	0	239	239	160	0	30	7278	7468	14	0	0	3778	3792
Российская Федерация	Частные; Очная	Выбыло студентов - всего (сумма стр. 07-11, 13-15) / 6.0	15	0	1	178	194	2	0	0	302	304	276	238	42	30070	30626	53	1	12	9903	9969
Российская Федерация	Частные; Очная	Прибыло студентов - всего (сумма стр. 02-05) / 1.0	2	0	0	179	181	0	0	0	299	299	204	42	33	18254	18533	15	0	0	6515	6530
Российская Федерация	Частные; Очная	"Численность студентов на начало прошлого учебного года
(на 1 октября) / 17.0"	312	50	34	1472	1868	81	0	0	2023	2104	4799	3119	794	211968	220680	563	87	79	45190	45919
Российская Федерация	Частные; Очно-заочная	            из стр. 11 - не прошли итоговую аттестацию / 12.0	0	0	0	0	0	0	0	0	3	3	0	0	0	0	0	0	0	0	9	9
Российская Федерация	Частные; Очно-заочная	"            из стр. 11 – лица с ограниченными возможностями здоровья,
            инвалиды, дети-инвалиды / 13.0"	0	0	0	0	0	0	0	0	0	0	0	0	0	0	0	0	0	0	0	0
Российская Федерация	Частные; Очно-заочная	         отчислено в виде меры дисциплинарного взыскания / 14.0	0	0	0	0	0	0	0	0	0	0	0	0	0	5	5	0	0	0	1	1
Российская Федерация	Частные; Очно-заочная	         отчислено из-за просрочки оплаты обучения / 15.0	0	0	0	34	34	0	0	0	248	248	0	0	0	540	540	0	0	0	663	663
Российская Федерация	Частные; Очно-заочная	"    в том числе:
    переведено на другие формы обучения данной
    организации на программы того же уровня / 7.0"	0	0	0	5	5	0	0	0	6	6	0	0	0	536	536	0	0	0	897	897
Российская Федерация	Частные; Очно-заочная	"    в том числе:
    переведено с других форм обучения данной
    образовательной организации с программ того же уровня / 2.0"	0	0	0	44	44	0	0	0	79	79	0	0	0	245	245	0	0	0	708	708
Российская Федерация	Частные; Очно-заочная	    восстановлены из числа ранее отчисленных / 4.0	0	0	0	1	1	0	0	0	2	2	0	0	0	83	83	0	1	0	120	121
Российская Федерация	Частные; Очно-заочная	    выбыло по другим причинам / 16.0	0	0	0	7	7	0	0	0	470	470	0	0	0	362	362	0	0	0	406	406
Российская Федерация	Частные; Очно-заочная	"    добровольно прекратили образовательные отношения
    (бросили учебу) / 10.0"	0	0	0	31	31	0	0	0	375	375	0	0	0	1188	1188	0	3	0	1354	1357
Российская Федерация	Частные; Очно-заочная	"    отчислено:
         по неуспеваемости / 11.0"	0	0	0	2	2	0	0	0	135	135	0	0	0	606	606	0	0	0	512	512
Российская Федерация	Частные; Очно-заочная	"    переведено в другие образовательные организации
    на программы того же уровня / 8.0"	0	0	0	13	13	0	0	0	0	0	0	0	0	402	402	0	3	0	526	529
Российская Федерация	Частные; Очно-заочная	"    переведено из других образовательных организаций 
    с программ того же уровня / 3.0"	0	0	0	35	35	0	0	0	5	5	0	0	0	691	691	0	0	0	785	785
Российская Федерация	Частные; Очно-заочная	    по болезни / 9.0	0	0	0	9	9	0	0	0	1	1	0	0	0	4	4	0	0	0	42	42
Российская Федерация	Частные; Очно-заочная	    прибыло по другим причинам / 5.0	0	0	0	7	7	0	0	0	1676	1676	0	0	0	3289	3289	0	0	0	3001	3001
Российская Федерация	Частные; Очно-заочная	Выбыло студентов - всего (сумма стр. 07-11, 13-15) / 6.0	0	0	0	101	101	0	0	0	1235	1235	0	0	0	3643	3643	0	6	0	4401	4407
Российская Федерация	Частные; Очно-заочная	Прибыло студентов - всего (сумма стр. 02-05) / 1.0	0	0	0	87	87	0	0	0	1762	1762	0	0	0	4308	4308	0	1	0	4614	4615
Российская Федерация	Частные; Очно-заочная	"Численность студентов на начало прошлого учебного года
(на 1 октября) / 17.0"	0	0	0	447	447	0	0	0	315	315	0	0	0	3890	3890	0	24	0	9946	9970
Ростовская область	Государственные, муниципальные (без учета организаций в ведении ФСИН); Заочная	            из стр. 11 - не прошли итоговую аттестацию / 12.0	0	0	0	0	0	0	0	0	0	0	0	0	0	1	1	3	0	4	2	9
Ростовская область	Государственные, муниципальные (без учета организаций в ведении ФСИН); Заочная	"            из стр. 11 – лица с ограниченными возможностями здоровья,
            инвалиды, дети-инвалиды / 13.0"	0	0	0	0	0	0	0	0	0	0	0	0	0	0	0	0	0	0	0	0
Ростовская область	Государственные, муниципальные (без учета организаций в ведении ФСИН); Заочная	         отчислено в виде меры дисциплинарного взыскания / 14.0	0	0	0	0	0	0	0	0	0	0	0	0	0	4	4	0	0	0	3	3
Ростовская область	Государственные, муниципальные (без учета организаций в ведении ФСИН); Заочная	         отчислено из-за просрочки оплаты обучения / 15.0	0	0	0	0	0	0	0	0	0	0	0	0	0	85	85	0	0	0	77	77
Ростовская область	Государственные, муниципальные (без учета организаций в ведении ФСИН); Заочная	"    в том числе:
    переведено на другие формы обучения данной
    организации на программы того же уровня / 7.0"	0	0	0	0	0	0	0	0	0	0	23	6	0	38	67	16	3	15	27	61
Ростовская область	Государственные, муниципальные (без учета организаций в ведении ФСИН); Заочная	"    в том числе:
    переведено с других форм обучения данной
    образовательной организации с программ того же уровня / 2.0"	0	0	0	0	0	0	0	0	0	0	40	17	12	263	332	62	8	7	155	232
Ростовская область	Государственные, муниципальные (без учета организаций в ведении ФСИН); Заочная	    восстановлены из числа ранее отчисленных / 4.0	0	0	0	0	0	0	0	0	0	0	14	1	2	47	64	42	0	6	72	120
Ростовская область	Государственные, муниципальные (без учета организаций в ведении ФСИН); Заочная	    выбыло по другим причинам / 16.0	0	0	0	0	0	0	0	0	0	0	4	0	0	94	98	50	15	1	124	190
Ростовская область	Государственные, муниципальные (без учета организаций в ведении ФСИН); Заочная	"    добровольно прекратили образовательные отношения
    (бросили учебу) / 10.0"	0	0	0	0	0	0	0	0	0	0	86	3	6	126	221	330	5	16	179	530
Ростовская область	Государственные, муниципальные (без учета организаций в ведении ФСИН); Заочная	"    отчислено:
         по неуспеваемости / 11.0"	0	0	0	0	0	0	0	0	0	0	0	0	0	50	50	120	0	4	113	237
Ростовская область	Государственные, муниципальные (без учета организаций в ведении ФСИН); Заочная	"    переведено в другие образовательные организации
    на программы того же уровня / 8.0"	0	0	0	0	0	0	0	0	0	0	2	4	0	70	76	2	0	0	43	45
Ростовская область	Государственные, муниципальные (без учета организаций в ведении ФСИН); Заочная	"    переведено из других образовательных организаций 
    с программ того же уровня / 3.0"	0	0	0	0	0	0	0	0	0	0	6	3	0	79	88	114	7	3	39	163
Ростовская область	Государственные, муниципальные (без учета организаций в ведении ФСИН); Заочная	    по болезни / 9.0	0	0	0	0	0	0	0	0	0	0	0	0	0	0	0	0	0	0	2	2
Ростовская область	Государственные, муниципальные (без учета организаций в ведении ФСИН); Заочная	    прибыло по другим причинам / 5.0	0	0	0	0	0	0	0	0	0	0	3	0	3	98	104	49	0	5	67	121
Ростовская область	Государственные, муниципальные (без учета организаций в ведении ФСИН); Заочная	Выбыло студентов - всего (сумма стр. 07-11, 13-15) / 6.0	0	0	0	0	0	0	0	0	0	0	115	13	6	467	601	518	23	36	568	1145
Ростовская область	Государственные, муниципальные (без учета организаций в ведении ФСИН); Заочная	Прибыло студентов - всего (сумма стр. 02-05) / 1.0	0	0	0	0	0	0	0	0	0	0	63	21	17	487	588	267	15	21	333	636
Ростовская область	Государственные, муниципальные (без учета организаций в ведении ФСИН); Заочная	"Численность студентов на начало прошлого учебного года
(на 1 октября) / 17.0"	0	0	0	0	0	0	0	0	0	0	666	175	37	2359	3237	5325	368	230	3597	9520
Ростовская область	Государственные, муниципальные (без учета организаций в ведении ФСИН); Очная	            из стр. 11 - не прошли итоговую аттестацию / 12.0	32	0	0	0	32	0	0	0	0	0	9	0	0	3	12	1	0	0	1	2
Ростовская область	Государственные, муниципальные (без учета организаций в ведении ФСИН); Очная	"            из стр. 11 – лица с ограниченными возможностями здоровья,
            инвалиды, дети-инвалиды / 13.0"	1	0	0	0	1	0	0	0	0	0	1	0	5	0	6	1	0	0	0	1
Ростовская область	Государственные, муниципальные (без учета организаций в ведении ФСИН); Очная	         отчислено в виде меры дисциплинарного взыскания / 14.0	18	0	0	0	18	0	0	0	0	0	11	0	5	16	32	0	0	7	5	12
Ростовская область	Государственные, муниципальные (без учета организаций в ведении ФСИН); Очная	         отчислено из-за просрочки оплаты обучения / 15.0	0	0	0	3	3	0	0	0	1	1	0	0	0	69	69	0	0	0	67	67
Ростовская область	Государственные, муниципальные (без учета организаций в ведении ФСИН); Очная	"    в том числе:
    переведено на другие формы обучения данной
    организации на программы того же уровня / 7.0"	22	0	0	1	23	0	0	0	0	0	238	0	26	250	514	120	0	0	109	229
Ростовская область	Государственные, муниципальные (без учета организаций в ведении ФСИН); Очная	"    в том числе:
    переведено с других форм обучения данной
    образовательной организации с программ того же уровня / 2.0"	39	0	4	2	45	0	0	7	4	11	248	0	4	90	342	143	0	24	46	213
Ростовская область	Государственные, муниципальные (без учета организаций в ведении ФСИН); Очная	    восстановлены из числа ранее отчисленных / 4.0	57	0	0	0	57	2	0	0	0	2	122	0	36	117	275	5	0	3	32	40
Ростовская область	Государственные, муниципальные (без учета организаций в ведении ФСИН); Очная	    выбыло по другим причинам / 16.0	547	0	9	14	570	7	0	2	2	11	479	0	17	200	696	18	0	16	25	59
Ростовская область	Государственные, муниципальные (без учета организаций в ведении ФСИН); Очная	"    добровольно прекратили образовательные отношения
    (бросили учебу) / 10.0"	963	0	10	32	1005	16	0	2	9	27	1265	0	212	709	2186	214	9	35	152	410
Ростовская область	Государственные, муниципальные (без учета организаций в ведении ФСИН); Очная	"    отчислено:
         по неуспеваемости / 11.0"	315	0	0	0	315	4	0	0	0	4	238	0	40	179	457	36	0	7	73	116
Ростовская область	Государственные, муниципальные (без учета организаций в ведении ФСИН); Очная	"    переведено в другие образовательные организации
    на программы того же уровня / 8.0"	331	0	8	19	358	27	0	0	1	28	609	0	99	383	1091	60	0	9	54	123
Ростовская область	Государственные, муниципальные (без учета организаций в ведении ФСИН); Очная	"    переведено из других образовательных организаций 
    с программ того же уровня / 3.0"	727	0	0	6	733	25	0	0	4	29	795	0	62	200	1057	28	0	1	51	80
Ростовская область	Государственные, муниципальные (без учета организаций в ведении ФСИН); Очная	    по болезни / 9.0	22	0	0	0	22	0	0	0	0	0	6	0	1	1	8	1	0	0	2	3
Ростовская область	Государственные, муниципальные (без учета организаций в ведении ФСИН); Очная	    прибыло по другим причинам / 5.0	501	0	5	18	524	4	0	0	0	4	418	0	56	119	593	12	0	1	41	54
Ростовская область	Государственные, муниципальные (без учета организаций в ведении ФСИН); Очная	Выбыло студентов - всего (сумма стр. 07-11, 13-15) / 6.0	2218	0	27	69	2314	54	0	4	13	71	2846	0	400	1807	5053	449	9	74	487	1019
Ростовская область	Государственные, муниципальные (без учета организаций в ведении ФСИН); Очная	Прибыло студентов - всего (сумма стр. 02-05) / 1.0	1324	0	9	26	1359	31	0	7	8	46	1583	0	158	526	2267	188	0	29	170	387
Ростовская область	Государственные, муниципальные (без учета организаций в ведении ФСИН); Очная	"Численность студентов на начало прошлого учебного года
(на 1 октября) / 17.0"	20562	0	0	414	20976	548	0	0	193	741	37548	0	6756	17428	61732	4590	0	574	3967	9131
Ростовская область	Очно-заочная; Государственные, муниципальные (без учета организаций в ведении ФСИН)	            из стр. 11 - не прошли итоговую аттестацию / 12.0	0	0	0	0	0	0	0	0	0	0	0	0	0	0	0	0	0	0	0	0
Ростовская область	Очно-заочная; Государственные, муниципальные (без учета организаций в ведении ФСИН)	"            из стр. 11 – лица с ограниченными возможностями здоровья,
            инвалиды, дети-инвалиды / 13.0"	0	0	0	0	0	0	0	0	0	0	0	0	0	0	0	0	0	0	0	0
Ростовская область	Очно-заочная; Государственные, муниципальные (без учета организаций в ведении ФСИН)	         отчислено в виде меры дисциплинарного взыскания / 14.0	1	0	0	0	1	0	0	0	0	0	0	0	0	0	0	0	0	0	0	0
Ростовская область	Очно-заочная; Государственные, муниципальные (без учета организаций в ведении ФСИН)	         отчислено из-за просрочки оплаты обучения / 15.0	0	0	0	0	0	0	0	0	0	0	0	0	0	0	0	0	0	0	20	20
Ростовская область	Очно-заочная; Государственные, муниципальные (без учета организаций в ведении ФСИН)	"    в том числе:
    переведено на другие формы обучения данной
    организации на программы того же уровня / 7.0"	0	0	0	0	0	0	0	0	0	0	0	0	0	0	0	4	0	0	3	7
Ростовская область	Очно-заочная; Государственные, муниципальные (без учета организаций в ведении ФСИН)	"    в том числе:
    переведено с других форм обучения данной
    образовательной организации с программ того же уровня / 2.0"	0	0	0	0	0	0	0	0	0	0	0	0	0	0	0	15	0	0	4	19
Ростовская область	Очно-заочная; Государственные, муниципальные (без учета организаций в ведении ФСИН)	    восстановлены из числа ранее отчисленных / 4.0	0	0	0	0	0	0	0	0	0	0	0	0	0	0	0	1	0	0	3	4
Ростовская область	Очно-заочная; Государственные, муниципальные (без учета организаций в ведении ФСИН)	    выбыло по другим причинам / 16.0	0	0	0	1	1	0	0	0	0	0	0	0	0	0	0	10	0	0	12	22
Ростовская область	Очно-заочная; Государственные, муниципальные (без учета организаций в ведении ФСИН)	"    добровольно прекратили образовательные отношения
    (бросили учебу) / 10.0"	0	1	0	3	4	0	0	0	0	0	0	0	0	0	0	58	0	0	41	99
Ростовская область	Очно-заочная; Государственные, муниципальные (без учета организаций в ведении ФСИН)	"    отчислено:
         по неуспеваемости / 11.0"	0	1	0	0	1	0	0	0	0	0	0	0	0	0	0	3	0	0	3	6
Ростовская область	Очно-заочная; Государственные, муниципальные (без учета организаций в ведении ФСИН)	"    переведено в другие образовательные организации
    на программы того же уровня / 8.0"	0	0	0	0	0	0	0	0	0	0	0	0	0	0	0	0	0	0	2	2
Ростовская область	Очно-заочная; Государственные, муниципальные (без учета организаций в ведении ФСИН)	"    переведено из других образовательных организаций 
    с программ того же уровня / 3.0"	0	0	0	0	0	0	0	0	0	0	0	0	0	0	0	3	0	0	1	4
Ростовская область	Очно-заочная; Государственные, муниципальные (без учета организаций в ведении ФСИН)	    по болезни / 9.0	0	0	0	0	0	0	0	0	0	0	0	0	0	0	0	0	0	0	0	0
Ростовская область	Очно-заочная; Государственные, муниципальные (без учета организаций в ведении ФСИН)	    прибыло по другим причинам / 5.0	0	0	0	0	0	0	0	0	0	0	0	0	0	0	0	1	0	0	0	1
Ростовская область	Очно-заочная; Государственные, муниципальные (без учета организаций в ведении ФСИН)	Выбыло студентов - всего (сумма стр. 07-11, 13-15) / 6.0	1	2	0	4	7	0	0	0	0	0	0	0	0	0	0	75	0	0	81	156
Ростовская область	Очно-заочная; Государственные, муниципальные (без учета организаций в ведении ФСИН)	Прибыло студентов - всего (сумма стр. 02-05) / 1.0	0	0	0	0	0	0	0	0	0	0	0	0	0	0	0	20	0	0	8	28
Ростовская область	Очно-заочная; Государственные, муниципальные (без учета организаций в ведении ФСИН)	"Численность студентов на начало прошлого учебного года
(на 1 октября) / 17.0"	39	53	0	63	155	70	0	0	0	70	0	0	0	0	0	785	0	0	710	1495
Ростовская область	Частные; Заочная	            из стр. 11 - не прошли итоговую аттестацию / 12.0	0	0	0	0	0	0	0	0	0	0	0	0	0	0	0	0	0	0	0	0
Ростовская область	Частные; Заочная	"            из стр. 11 – лица с ограниченными возможностями здоровья,
            инвалиды, дети-инвалиды / 13.0"	0	0	0	0	0	0	0	0	0	0	0	0	0	0	0	0	0	0	0	0
Ростовская область	Частные; Заочная	         отчислено в виде меры дисциплинарного взыскания / 14.0	0	0	0	0	0	0	0	0	0	0	0	0	0	0	0	0	0	0	0	0
Ростовская область	Частные; Заочная	         отчислено из-за просрочки оплаты обучения / 15.0	0	0	0	0	0	0	0	0	0	0	0	0	0	17	17	0	0	0	6	6
Ростовская область	Частные; Заочная	"    в том числе:
    переведено на другие формы обучения данной
    организации на программы того же уровня / 7.0"	0	0	0	0	0	0	0	0	0	0	0	0	0	52	52	0	0	0	10	10
Ростовская область	Частные; Заочная	"    в том числе:
    переведено с других форм обучения данной
    образовательной организации с программ того же уровня / 2.0"	0	0	0	0	0	0	0	0	0	0	0	0	0	58	58	0	0	0	12	12
Ростовская область	Частные; Заочная	    восстановлены из числа ранее отчисленных / 4.0	0	0	0	0	0	0	0	0	0	0	0	0	0	18	18	0	0	0	4	4
Ростовская область	Частные; Заочная	    выбыло по другим причинам / 16.0	0	0	0	0	0	0	0	0	0	0	0	0	0	9	9	0	0	0	0	0
Ростовская область	Частные; Заочная	"    добровольно прекратили образовательные отношения
    (бросили учебу) / 10.0"	0	0	0	0	0	0	0	0	0	0	0	0	0	12	12	0	0	0	14	14
Ростовская область	Частные; Заочная	"    отчислено:
         по неуспеваемости / 11.0"	0	0	0	0	0	0	0	0	0	0	0	0	0	10	10	0	0	0	2	2
Ростовская область	Частные; Заочная	"    переведено в другие образовательные организации
    на программы того же уровня / 8.0"	0	0	0	0	0	0	0	0	0	0	0	0	0	3	3	0	0	0	0	0
Ростовская область	Частные; Заочная	"    переведено из других образовательных организаций 
    с программ того же уровня / 3.0"	0	0	0	0	0	0	0	0	0	0	0	0	0	13	13	0	0	0	2	2
Ростовская область	Частные; Заочная	    по болезни / 9.0	0	0	0	0	0	0	0	0	0	0	0	0	0	0	0	0	0	0	0	0
Ростовская область	Частные; Заочная	    прибыло по другим причинам / 5.0	0	0	0	0	0	0	0	0	0	0	0	0	0	1	1	0	0	0	0	0
Ростовская область	Частные; Заочная	Выбыло студентов - всего (сумма стр. 07-11, 13-15) / 6.0	0	0	0	0	0	0	0	0	0	0	0	0	0	103	103	0	0	0	32	32
Ростовская область	Частные; Заочная	Прибыло студентов - всего (сумма стр. 02-05) / 1.0	0	0	0	0	0	0	0	0	0	0	0	0	0	90	90	0	0	0	18	18
Ростовская область	Частные; Заочная	"Численность студентов на начало прошлого учебного года
(на 1 октября) / 17.0"	0	0	0	0	0	0	0	0	0	0	0	0	0	319	319	0	0	0	134	134
Ростовская область	Частные; Очная	            из стр. 11 - не прошли итоговую аттестацию / 12.0	0	0	0	0	0	0	0	0	0	0	0	0	0	3	3	0	0	0	2	2
Ростовская область	Частные; Очная	"            из стр. 11 – лица с ограниченными возможностями здоровья,
            инвалиды, дети-инвалиды / 13.0"	0	0	0	0	0	0	0	0	0	0	0	0	0	0	0	0	0	0	0	0
Ростовская область	Частные; Очная	         отчислено в виде меры дисциплинарного взыскания / 14.0	0	0	0	0	0	0	0	0	0	0	0	0	0	1	1	0	0	0	0	0
Ростовская область	Частные; Очная	         отчислено из-за просрочки оплаты обучения / 15.0	0	0	0	0	0	0	0	0	0	0	0	0	0	41	41	0	0	0	50	50
Ростовская область	Частные; Очная	"    в том числе:
    переведено на другие формы обучения данной
    организации на программы того же уровня / 7.0"	0	0	0	0	0	0	0	0	0	0	0	0	0	58	58	0	0	0	12	12
Ростовская область	Частные; Очная	"    в том числе:
    переведено с других форм обучения данной
    образовательной организации с программ того же уровня / 2.0"	0	0	0	0	0	0	0	0	0	0	0	0	0	52	52	0	0	0	31	31
Ростовская область	Частные; Очная	    восстановлены из числа ранее отчисленных / 4.0	0	0	0	0	0	0	0	0	0	0	0	0	0	53	53	0	0	0	8	8
Ростовская область	Частные; Очная	    выбыло по другим причинам / 16.0	0	0	0	0	0	0	0	0	0	0	0	0	15	61	76	0	0	0	16	16
Ростовская область	Частные; Очная	"    добровольно прекратили образовательные отношения
    (бросили учебу) / 10.0"	0	0	0	0	0	0	0	0	0	0	0	0	2	103	105	0	0	0	22	22
Ростовская область	Частные; Очная	"    отчислено:
         по неуспеваемости / 11.0"	0	0	0	0	0	0	0	0	0	0	0	0	1	99	100	0	0	0	34	34
Ростовская область	Частные; Очная	"    переведено в другие образовательные организации
    на программы того же уровня / 8.0"	0	0	0	0	0	0	0	0	0	0	0	0	0	42	42	0	0	0	1	1
Ростовская область	Частные; Очная	"    переведено из других образовательных организаций 
    с программ того же уровня / 3.0"	0	0	0	0	0	0	0	0	0	0	0	0	0	89	89	0	0	0	7	7
Ростовская область	Частные; Очная	    по болезни / 9.0	0	0	0	0	0	0	0	0	0	0	0	0	0	0	0	0	0	0	0	0
Ростовская область	Частные; Очная	    прибыло по другим причинам / 5.0	0	0	0	0	0	0	0	0	0	0	0	0	18	67	85	0	0	0	29	29
Ростовская область	Частные; Очная	Выбыло студентов - всего (сумма стр. 07-11, 13-15) / 6.0	0	0	0	0	0	0	0	0	0	0	0	0	18	405	423	0	0	0	135	135
Ростовская область	Частные; Очная	Прибыло студентов - всего (сумма стр. 02-05) / 1.0	0	0	0	0	0	0	0	0	0	0	0	0	18	261	279	0	0	0	75	75
Ростовская область	Частные; Очная	"Численность студентов на начало прошлого учебного года
(на 1 октября) / 17.0"	0	0	0	0	0	0	0	0	0	0	0	0	65	2917	2982	0	0	0	540	540
Ростовская область	Частные; Очно-заочная	            из стр. 11 - не прошли итоговую аттестацию / 12.0	0	0	0	0	0	0	0	0	0	0	0	0	0	0	0	0	0	0	0	0
Ростовская область	Частные; Очно-заочная	"            из стр. 11 – лица с ограниченными возможностями здоровья,
            инвалиды, дети-инвалиды / 13.0"	0	0	0	0	0	0	0	0	0	0	0	0	0	0	0	0	0	0	0	0
Ростовская область	Частные; Очно-заочная	         отчислено в виде меры дисциплинарного взыскания / 14.0	0	0	0	0	0	0	0	0	0	0	0	0	0	0	0	0	0	0	0	0
Ростовская область	Частные; Очно-заочная	         отчислено из-за просрочки оплаты обучения / 15.0	0	0	0	0	0	0	0	0	0	0	0	0	0	0	0	0	0	0	0	0
Ростовская область	Частные; Очно-заочная	"    в том числе:
    переведено на другие формы обучения данной
    организации на программы того же уровня / 7.0"	0	0	0	0	0	0	0	0	0	0	0	0	0	0	0	0	0	0	0	0
Ростовская область	Частные; Очно-заочная	"    в том числе:
    переведено с других форм обучения данной
    образовательной организации с программ того же уровня / 2.0"	0	0	0	0	0	0	0	0	0	0	0	0	0	1	1	0	0	0	2	2
Ростовская область	Частные; Очно-заочная	    восстановлены из числа ранее отчисленных / 4.0	0	0	0	0	0	0	0	0	0	0	0	0	0	0	0	0	0	0	0	0
Ростовская область	Частные; Очно-заочная	    выбыло по другим причинам / 16.0	0	0	0	0	0	0	0	0	0	0	0	0	0	1	1	0	0	0	0	0
Ростовская область	Частные; Очно-заочная	"    добровольно прекратили образовательные отношения
    (бросили учебу) / 10.0"	0	0	0	0	0	0	0	0	0	0	0	0	0	2	2	0	0	0	0	0
Ростовская область	Частные; Очно-заочная	"    отчислено:
         по неуспеваемости / 11.0"	0	0	0	0	0	0	0	0	0	0	0	0	0	0	0	0	0	0	0	0
Ростовская область	Частные; Очно-заочная	"    переведено в другие образовательные организации
    на программы того же уровня / 8.0"	0	0	0	0	0	0	0	0	0	0	0	0	0	0	0	0	0	0	0	0
Ростовская область	Частные; Очно-заочная	"    переведено из других образовательных организаций 
    с программ того же уровня / 3.0"	0	0	0	0	0	0	0	0	0	0	0	0	0	0	0	0	0	0	0	0
Ростовская область	Частные; Очно-заочная	    по болезни / 9.0	0	0	0	0	0	0	0	0	0	0	0	0	0	0	0	0	0	0	0	0
Ростовская область	Частные; Очно-заочная	    прибыло по другим причинам / 5.0	0	0	0	0	0	0	0	0	0	0	0	0	0	0	0	0	0	0	0	0
Ростовская область	Частные; Очно-заочная	Выбыло студентов - всего (сумма стр. 07-11, 13-15) / 6.0	0	0	0	0	0	0	0	0	0	0	0	0	0	3	3	0	0	0	0	0
Ростовская область	Частные; Очно-заочная	Прибыло студентов - всего (сумма стр. 02-05) / 1.0	0	0	0	0	0	0	0	0	0	0	0	0	0	1	1	0	0	0	2	2
Ростовская область	Частные; Очно-заочная	"Численность студентов на начало прошлого учебного года
(на 1 октября) / 17.0"	0	0	0	0	0	0	0	0	0	0	0	0	0	0	0	0	0	0	0	0
Рязанская область	Государственные, муниципальные (без учета организаций в ведении ФСИН); Заочная	            из стр. 11 - не прошли итоговую аттестацию / 12.0	0	0	0	0	0	0	0	0	0	0	0	0	0	0	0	0	0	0	0	0
Рязанская область	Государственные, муниципальные (без учета организаций в ведении ФСИН); Заочная	"            из стр. 11 – лица с ограниченными возможностями здоровья,
            инвалиды, дети-инвалиды / 13.0"	0	0	0	0	0	0	0	0	0	0	0	0	0	0	0	0	0	0	0	0
Рязанская область	Государственные, муниципальные (без учета организаций в ведении ФСИН); Заочная	         отчислено в виде меры дисциплинарного взыскания / 14.0	0	0	0	0	0	0	0	0	0	0	0	0	0	0	0	0	0	0	0	0
Рязанская область	Государственные, муниципальные (без учета организаций в ведении ФСИН); Заочная	         отчислено из-за просрочки оплаты обучения / 15.0	0	0	0	0	0	0	0	0	0	0	0	0	0	4	4	0	0	0	5	5
Рязанская область	Государственные, муниципальные (без учета организаций в ведении ФСИН); Заочная	"    в том числе:
    переведено на другие формы обучения данной
    организации на программы того же уровня / 7.0"	0	0	0	0	0	0	0	0	0	0	0	0	0	0	0	0	0	0	1	1
Рязанская область	Государственные, муниципальные (без учета организаций в ведении ФСИН); Заочная	"    в том числе:
    переведено с других форм обучения данной
    образовательной организации с программ того же уровня / 2.0"	0	0	0	0	0	0	0	0	0	0	0	0	0	9	9	0	0	4	37	41
Рязанская область	Государственные, муниципальные (без учета организаций в ведении ФСИН); Заочная	    восстановлены из числа ранее отчисленных / 4.0	0	0	0	0	0	0	0	0	0	0	0	0	0	4	4	0	0	2	24	26
Рязанская область	Государственные, муниципальные (без учета организаций в ведении ФСИН); Заочная	    выбыло по другим причинам / 16.0	0	0	0	0	0	0	0	0	0	0	0	0	0	0	0	5	0	1	18	24
Рязанская область	Государственные, муниципальные (без учета организаций в ведении ФСИН); Заочная	"    добровольно прекратили образовательные отношения
    (бросили учебу) / 10.0"	0	0	0	0	0	0	0	0	0	0	0	0	0	6	6	6	0	16	42	64
Рязанская область	Государственные, муниципальные (без учета организаций в ведении ФСИН); Заочная	"    отчислено:
         по неуспеваемости / 11.0"	0	0	0	0	0	0	0	0	0	0	0	0	0	13	13	1	0	2	48	51
Рязанская область	Государственные, муниципальные (без учета организаций в ведении ФСИН); Заочная	"    переведено в другие образовательные организации
    на программы того же уровня / 8.0"	0	0	0	0	0	0	0	0	0	0	0	0	0	3	3	0	0	0	1	1
Рязанская область	Государственные, муниципальные (без учета организаций в ведении ФСИН); Заочная	"    переведено из других образовательных организаций 
    с программ того же уровня / 3.0"	0	0	0	0	0	0	0	0	0	0	0	0	0	4	4	0	0	0	9	9
Рязанская область	Государственные, муниципальные (без учета организаций в ведении ФСИН); Заочная	    по болезни / 9.0	0	0	0	0	0	0	0	0	0	0	0	0	0	0	0	0	0	0	0	0
Рязанская область	Государственные, муниципальные (без учета организаций в ведении ФСИН); Заочная	    прибыло по другим причинам / 5.0	0	0	0	0	0	0	0	0	0	0	0	0	0	0	0	0	0	0	31	31
Рязанская область	Государственные, муниципальные (без учета организаций в ведении ФСИН); Заочная	Выбыло студентов - всего (сумма стр. 07-11, 13-15) / 6.0	0	0	0	0	0	0	0	0	0	0	0	0	0	26	26	12	0	19	115	146
Рязанская область	Государственные, муниципальные (без учета организаций в ведении ФСИН); Заочная	Прибыло студентов - всего (сумма стр. 02-05) / 1.0	0	0	0	0	0	0	0	0	0	0	0	0	0	17	17	0	0	6	101	107
Рязанская область	Государственные, муниципальные (без учета организаций в ведении ФСИН); Заочная	"Численность студентов на начало прошлого учебного года
(на 1 октября) / 17.0"	0	0	0	0	0	0	0	0	0	0	0	0	0	210	210	342	0	99	633	1074
Рязанская область	Государственные, муниципальные (без учета организаций в ведении ФСИН); Очная	            из стр. 11 - не прошли итоговую аттестацию / 12.0	1	0	0	0	1	0	0	0	0	0	3	0	0	0	3	0	0	0	0	0
Рязанская область	Государственные, муниципальные (без учета организаций в ведении ФСИН); Очная	"            из стр. 11 – лица с ограниченными возможностями здоровья,
            инвалиды, дети-инвалиды / 13.0"	4	0	0	0	4	0	0	0	0	0	0	0	0	0	0	0	0	0	0	0
Рязанская область	Государственные, муниципальные (без учета организаций в ведении ФСИН); Очная	         отчислено в виде меры дисциплинарного взыскания / 14.0	1	0	0	0	1	0	0	0	0	0	1	0	0	0	1	1	0	0	0	1
Рязанская область	Государственные, муниципальные (без учета организаций в ведении ФСИН); Очная	         отчислено из-за просрочки оплаты обучения / 15.0	0	0	0	0	0	0	0	0	0	0	0	0	0	5	5	0	0	0	0	0
Рязанская область	Государственные, муниципальные (без учета организаций в ведении ФСИН); Очная	"    в том числе:
    переведено на другие формы обучения данной
    организации на программы того же уровня / 7.0"	10	0	0	0	10	0	0	0	0	0	32	0	9	33	74	0	0	0	12	12
Рязанская область	Государственные, муниципальные (без учета организаций в ведении ФСИН); Очная	"    в том числе:
    переведено с других форм обучения данной
    образовательной организации с программ того же уровня / 2.0"	27	0	0	0	27	0	0	0	0	0	29	0	1	9	39	13	0	2	3	18
Рязанская область	Государственные, муниципальные (без учета организаций в ведении ФСИН); Очная	    восстановлены из числа ранее отчисленных / 4.0	7	0	0	0	7	0	0	0	0	0	45	0	0	55	100	5	0	3	26	34
Рязанская область	Государственные, муниципальные (без учета организаций в ведении ФСИН); Очная	    выбыло по другим причинам / 16.0	26	0	0	0	26	0	0	0	0	0	95	0	3	36	134	3	0	34	5	42
Рязанская область	Государственные, муниципальные (без учета организаций в ведении ФСИН); Очная	"    добровольно прекратили образовательные отношения
    (бросили учебу) / 10.0"	137	0	0	5	142	3	0	0	1	4	594	0	55	241	890	54	0	19	83	156
Рязанская область	Государственные, муниципальные (без учета организаций в ведении ФСИН); Очная	"    отчислено:
         по неуспеваемости / 11.0"	53	0	0	0	53	0	0	0	0	0	183	0	8	71	262	13	0	12	20	45
Рязанская область	Государственные, муниципальные (без учета организаций в ведении ФСИН); Очная	"    переведено в другие образовательные организации
    на программы того же уровня / 8.0"	71	0	0	0	71	0	0	0	0	0	144	0	13	44	201	4	0	4	5	13
Рязанская область	Государственные, муниципальные (без учета организаций в ведении ФСИН); Очная	"    переведено из других образовательных организаций 
    с программ того же уровня / 3.0"	23	0	0	0	23	0	0	0	0	0	79	0	12	44	135	4	0	0	3	7
Рязанская область	Государственные, муниципальные (без учета организаций в ведении ФСИН); Очная	    по болезни / 9.0	53	0	0	0	53	0	0	0	0	0	18	0	27	1	46	0	0	6	0	6
Рязанская область	Государственные, муниципальные (без учета организаций в ведении ФСИН); Очная	    прибыло по другим причинам / 5.0	29	0	0	0	29	0	0	0	0	0	86	0	12	87	185	56	0	14	44	114
Рязанская область	Государственные, муниципальные (без учета организаций в ведении ФСИН); Очная	Выбыло студентов - всего (сумма стр. 07-11, 13-15) / 6.0	351	0	0	5	356	3	0	0	1	4	1067	0	115	431	1613	75	0	75	125	275
Рязанская область	Государственные, муниципальные (без учета организаций в ведении ФСИН); Очная	Прибыло студентов - всего (сумма стр. 02-05) / 1.0	86	0	0	0	86	0	0	0	0	0	239	0	25	195	459	78	0	19	76	173
Рязанская область	Государственные, муниципальные (без учета организаций в ведении ФСИН); Очная	"Численность студентов на начало прошлого учебного года
(на 1 октября) / 17.0"	2445	0	0	8	2453	64	0	0	14	78	13395	0	1714	3884	18993	703	0	551	986	2240
Рязанская область	Очно-заочная; Государственные, муниципальные (без учета организаций в ведении ФСИН)	            из стр. 11 - не прошли итоговую аттестацию / 12.0	0	0	0	0	0	0	0	0	0	0	0	0	0	0	0	0	0	0	0	0
Рязанская область	Очно-заочная; Государственные, муниципальные (без учета организаций в ведении ФСИН)	"            из стр. 11 – лица с ограниченными возможностями здоровья,
            инвалиды, дети-инвалиды / 13.0"	0	0	0	0	0	0	0	0	0	0	0	0	0	0	0	0	0	0	0	0
Рязанская область	Очно-заочная; Государственные, муниципальные (без учета организаций в ведении ФСИН)	         отчислено в виде меры дисциплинарного взыскания / 14.0	0	0	0	0	0	0	0	0	0	0	0	0	0	0	0	0	0	0	0	0
Рязанская область	Очно-заочная; Государственные, муниципальные (без учета организаций в ведении ФСИН)	         отчислено из-за просрочки оплаты обучения / 15.0	0	0	0	0	0	0	0	0	0	0	0	0	0	0	0	0	0	0	0	0
Рязанская область	Очно-заочная; Государственные, муниципальные (без учета организаций в ведении ФСИН)	"    в том числе:
    переведено на другие формы обучения данной
    организации на программы того же уровня / 7.0"	0	0	0	0	0	0	0	0	0	0	0	0	0	0	0	0	0	0	0	0
Рязанская область	Очно-заочная; Государственные, муниципальные (без учета организаций в ведении ФСИН)	"    в том числе:
    переведено с других форм обучения данной
    образовательной организации с программ того же уровня / 2.0"	0	0	0	0	0	0	0	0	0	0	0	0	0	0	0	0	0	0	0	0
Рязанская область	Очно-заочная; Государственные, муниципальные (без учета организаций в ведении ФСИН)	    восстановлены из числа ранее отчисленных / 4.0	0	0	0	0	0	0	0	0	0	0	0	0	0	0	0	0	0	0	0	0
Рязанская область	Очно-заочная; Государственные, муниципальные (без учета организаций в ведении ФСИН)	    выбыло по другим причинам / 16.0	0	0	0	0	0	0	0	0	0	0	0	0	0	0	0	0	0	0	0	0
Рязанская область	Очно-заочная; Государственные, муниципальные (без учета организаций в ведении ФСИН)	"    добровольно прекратили образовательные отношения
    (бросили учебу) / 10.0"	0	0	0	0	0	0	0	0	0	0	0	0	0	0	0	0	0	0	0	0
Рязанская область	Очно-заочная; Государственные, муниципальные (без учета организаций в ведении ФСИН)	"    отчислено:
         по неуспеваемости / 11.0"	0	0	0	0	0	0	0	0	0	0	0	0	0	0	0	0	0	0	0	0
Рязанская область	Очно-заочная; Государственные, муниципальные (без учета организаций в ведении ФСИН)	"    переведено в другие образовательные организации
    на программы того же уровня / 8.0"	0	0	0	0	0	0	0	0	0	0	0	0	0	0	0	0	0	0	0	0
Рязанская область	Очно-заочная; Государственные, муниципальные (без учета организаций в ведении ФСИН)	"    переведено из других образовательных организаций 
    с программ того же уровня / 3.0"	0	0	0	0	0	0	0	0	0	0	0	0	0	0	0	0	0	0	0	0
Рязанская область	Очно-заочная; Государственные, муниципальные (без учета организаций в ведении ФСИН)	    по болезни / 9.0	0	0	0	0	0	0	0	0	0	0	0	0	0	0	0	0	0	0	0	0
Рязанская область	Очно-заочная; Государственные, муниципальные (без учета организаций в ведении ФСИН)	    прибыло по другим причинам / 5.0	0	0	0	0	0	0	0	0	0	0	0	0	0	0	0	0	0	0	0	0
Рязанская область	Очно-заочная; Государственные, муниципальные (без учета организаций в ведении ФСИН)	Выбыло студентов - всего (сумма стр. 07-11, 13-15) / 6.0	0	0	0	0	0	0	0	0	0	0	0	0	0	0	0	0	0	0	0	0
Рязанская область	Очно-заочная; Государственные, муниципальные (без учета организаций в ведении ФСИН)	Прибыло студентов - всего (сумма стр. 02-05) / 1.0	0	0	0	0	0	0	0	0	0	0	0	0	0	0	0	0	0	0	0	0
Рязанская область	Очно-заочная; Государственные, муниципальные (без учета организаций в ведении ФСИН)	"Численность студентов на начало прошлого учебного года
(на 1 октября) / 17.0"	0	0	0	0	0	35	0	0	0	35	0	0	0	0	0	0	0	0	0	0
Рязанская область	Частные; Заочная	            из стр. 11 - не прошли итоговую аттестацию / 12.0	0	0	0	0	0	0	0	0	0	0	0	0	0	0	0	0	0	0	0	0
Рязанская область	Частные; Заочная	"            из стр. 11 – лица с ограниченными возможностями здоровья,
            инвалиды, дети-инвалиды / 13.0"	0	0	0	0	0	0	0	0	0	0	0	0	0	0	0	0	0	0	0	0
Рязанская область	Частные; Заочная	         отчислено в виде меры дисциплинарного взыскания / 14.0	0	0	0	0	0	0	0	0	0	0	0	0	0	0	0	0	0	0	0	0
Рязанская область	Частные; Заочная	         отчислено из-за просрочки оплаты обучения / 15.0	0	0	0	0	0	0	0	0	0	0	0	0	0	23	23	0	0	0	12	12
Рязанская область	Частные; Заочная	"    в том числе:
    переведено на другие формы обучения данной
    организации на программы того же уровня / 7.0"	0	0	0	0	0	0	0	0	0	0	0	0	0	1	1	0	0	0	0	0
Рязанская область	Частные; Заочная	"    в том числе:
    переведено с других форм обучения данной
    образовательной организации с программ того же уровня / 2.0"	0	0	0	0	0	0	0	0	0	0	0	0	0	3	3	0	0	0	2	2
Рязанская область	Частные; Заочная	    восстановлены из числа ранее отчисленных / 4.0	0	0	0	0	0	0	0	0	0	0	0	0	0	1	1	0	0	0	2	2
Рязанская область	Частные; Заочная	    выбыло по другим причинам / 16.0	0	0	0	0	0	0	0	0	0	0	0	0	0	0	0	0	0	0	3	3
Рязанская область	Частные; Заочная	"    добровольно прекратили образовательные отношения
    (бросили учебу) / 10.0"	0	0	0	0	0	0	0	0	0	0	0	0	0	4	4	0	0	0	2	2
Рязанская область	Частные; Заочная	"    отчислено:
         по неуспеваемости / 11.0"	0	0	0	0	0	0	0	0	0	0	0	0	0	1	1	0	0	0	0	0
Рязанская область	Частные; Заочная	"    переведено в другие образовательные организации
    на программы того же уровня / 8.0"	0	0	0	0	0	0	0	0	0	0	0	0	0	0	0	0	0	0	0	0
Рязанская область	Частные; Заочная	"    переведено из других образовательных организаций 
    с программ того же уровня / 3.0"	0	0	0	0	0	0	0	0	0	0	0	0	0	18	18	0	0	0	0	0
Рязанская область	Частные; Заочная	    по болезни / 9.0	0	0	0	0	0	0	0	0	0	0	0	0	0	0	0	0	0	0	0	0
Рязанская область	Частные; Заочная	    прибыло по другим причинам / 5.0	0	0	0	0	0	0	0	0	0	0	0	0	0	0	0	0	0	0	0	0
Рязанская область	Частные; Заочная	Выбыло студентов - всего (сумма стр. 07-11, 13-15) / 6.0	0	0	0	0	0	0	0	0	0	0	0	0	0	29	29	0	0	0	17	17
Рязанская область	Частные; Заочная	Прибыло студентов - всего (сумма стр. 02-05) / 1.0	0	0	0	0	0	0	0	0	0	0	0	0	0	22	22	0	0	0	4	4
Рязанская область	Частные; Заочная	"Численность студентов на начало прошлого учебного года
(на 1 октября) / 17.0"	0	0	0	0	0	0	0	0	0	0	0	0	0	185	185	0	0	0	162	162
Рязанская область	Частные; Очная	            из стр. 11 - не прошли итоговую аттестацию / 12.0	0	0	0	0	0	0	0	0	0	0	0	0	0	0	0	0	0	0	0	0
Рязанская область	Частные; Очная	"            из стр. 11 – лица с ограниченными возможностями здоровья,
            инвалиды, дети-инвалиды / 13.0"	0	0	0	0	0	0	0	0	0	0	0	0	0	0	0	0	0	0	0	0
Рязанская область	Частные; Очная	         отчислено в виде меры дисциплинарного взыскания / 14.0	0	0	0	0	0	0	0	0	0	0	0	0	0	0	0	0	0	0	0	0
Рязанская область	Частные; Очная	         отчислено из-за просрочки оплаты обучения / 15.0	0	0	0	0	0	0	0	0	0	0	0	0	0	4	4	0	0	0	4	4
Рязанская область	Частные; Очная	"    в том числе:
    переведено на другие формы обучения данной
    организации на программы того же уровня / 7.0"	0	0	0	0	0	0	0	0	0	0	0	0	0	3	3	0	0	0	3	3
Рязанская область	Частные; Очная	"    в том числе:
    переведено с других форм обучения данной
    образовательной организации с программ того же уровня / 2.0"	0	0	0	0	0	0	0	0	0	0	0	0	0	1	1	0	0	0	1	1
Рязанская область	Частные; Очная	    восстановлены из числа ранее отчисленных / 4.0	0	0	0	0	0	0	0	0	0	0	0	0	0	9	9	0	0	0	6	6
Рязанская область	Частные; Очная	    выбыло по другим причинам / 16.0	0	0	0	0	0	0	0	0	0	0	0	0	0	7	7	0	0	0	3	3
Рязанская область	Частные; Очная	"    добровольно прекратили образовательные отношения
    (бросили учебу) / 10.0"	0	0	0	0	0	0	0	0	0	0	0	0	0	29	29	0	0	0	8	8
Рязанская область	Частные; Очная	"    отчислено:
         по неуспеваемости / 11.0"	0	0	0	0	0	0	0	0	0	0	0	0	0	18	18	0	0	0	10	10
Рязанская область	Частные; Очная	"    переведено в другие образовательные организации
    на программы того же уровня / 8.0"	0	0	0	0	0	0	0	0	0	0	0	0	0	4	4	0	0	0	0	0
Рязанская область	Частные; Очная	"    переведено из других образовательных организаций 
    с программ того же уровня / 3.0"	0	0	0	0	0	0	0	0	0	0	0	0	0	25	25	0	0	0	1	1
Рязанская область	Частные; Очная	    по болезни / 9.0	0	0	0	0	0	0	0	0	0	0	0	0	0	0	0	0	0	0	0	0
Рязанская область	Частные; Очная	    прибыло по другим причинам / 5.0	0	0	0	0	0	0	0	0	5	5	0	0	0	0	0	0	0	0	0	0
Рязанская область	Частные; Очная	Выбыло студентов - всего (сумма стр. 07-11, 13-15) / 6.0	0	0	0	0	0	0	0	0	0	0	0	0	0	65	65	0	0	0	28	28
Рязанская область	Частные; Очная	Прибыло студентов - всего (сумма стр. 02-05) / 1.0	0	0	0	0	0	0	0	0	5	5	0	0	0	35	35	0	0	0	8	8
Рязанская область	Частные; Очная	"Численность студентов на начало прошлого учебного года
(на 1 октября) / 17.0"	0	0	0	0	0	0	0	0	0	0	0	0	0	677	677	0	0	0	189	189
Самарская область	Государственные, муниципальные (без учета организаций в ведении ФСИН); Заочная	            из стр. 11 - не прошли итоговую аттестацию / 12.0	0	0	0	0	0	0	0	0	0	0	0	0	0	0	0	1	0	0	0	1
Самарская область	Государственные, муниципальные (без учета организаций в ведении ФСИН); Заочная	"            из стр. 11 – лица с ограниченными возможностями здоровья,
            инвалиды, дети-инвалиды / 13.0"	0	0	0	0	0	0	0	0	0	0	0	0	0	0	0	0	0	0	0	0
Самарская область	Государственные, муниципальные (без учета организаций в ведении ФСИН); Заочная	         отчислено в виде меры дисциплинарного взыскания / 14.0	0	0	0	0	0	0	0	0	0	0	0	0	0	0	0	0	0	0	1	1
Самарская область	Государственные, муниципальные (без учета организаций в ведении ФСИН); Заочная	         отчислено из-за просрочки оплаты обучения / 15.0	0	0	0	0	0	0	0	0	0	0	0	0	0	9	9	0	0	0	24	24
Самарская область	Государственные, муниципальные (без учета организаций в ведении ФСИН); Заочная	"    в том числе:
    переведено на другие формы обучения данной
    организации на программы того же уровня / 7.0"	0	0	0	0	0	0	0	0	0	0	5	0	0	13	18	11	0	1	16	28
Самарская область	Государственные, муниципальные (без учета организаций в ведении ФСИН); Заочная	"    в том числе:
    переведено с других форм обучения данной
    образовательной организации с программ того же уровня / 2.0"	0	0	0	0	0	0	0	0	0	0	11	0	0	79	90	23	0	5	33	61
Самарская область	Государственные, муниципальные (без учета организаций в ведении ФСИН); Заочная	    восстановлены из числа ранее отчисленных / 4.0	0	0	0	0	0	0	0	0	0	0	6	0	0	42	48	24	0	1	11	36
Самарская область	Государственные, муниципальные (без учета организаций в ведении ФСИН); Заочная	    выбыло по другим причинам / 16.0	0	0	0	0	0	0	0	0	0	0	6	0	0	1	7	56	0	0	11	67
Самарская область	Государственные, муниципальные (без учета организаций в ведении ФСИН); Заочная	"    добровольно прекратили образовательные отношения
    (бросили учебу) / 10.0"	0	0	0	0	0	0	0	0	0	0	37	0	0	64	101	137	0	43	51	231
Самарская область	Государственные, муниципальные (без учета организаций в ведении ФСИН); Заочная	"    отчислено:
         по неуспеваемости / 11.0"	0	0	0	0	0	0	0	0	0	0	38	0	0	80	118	133	0	13	42	188
Самарская область	Государственные, муниципальные (без учета организаций в ведении ФСИН); Заочная	"    переведено в другие образовательные организации
    на программы того же уровня / 8.0"	0	0	0	0	0	0	0	0	0	0	2	0	0	5	7	1	0	0	1	2
Самарская область	Государственные, муниципальные (без учета организаций в ведении ФСИН); Заочная	"    переведено из других образовательных организаций 
    с программ того же уровня / 3.0"	0	0	0	0	0	0	0	0	0	0	8	0	0	54	62	6	0	0	10	16
Самарская область	Государственные, муниципальные (без учета организаций в ведении ФСИН); Заочная	    по болезни / 9.0	0	0	0	0	0	0	0	0	0	0	0	0	0	0	0	0	0	0	0	0
Самарская область	Государственные, муниципальные (без учета организаций в ведении ФСИН); Заочная	    прибыло по другим причинам / 5.0	0	0	0	0	0	0	0	0	0	0	7	0	0	6	13	33	0	0	20	53
Самарская область	Государственные, муниципальные (без учета организаций в ведении ФСИН); Заочная	Выбыло студентов - всего (сумма стр. 07-11, 13-15) / 6.0	0	0	0	0	0	0	0	0	0	0	88	0	0	172	260	338	0	57	146	541
Самарская область	Государственные, муниципальные (без учета организаций в ведении ФСИН); Заочная	Прибыло студентов - всего (сумма стр. 02-05) / 1.0	0	0	0	0	0	0	0	0	0	0	32	0	0	181	213	86	0	6	74	166
Самарская область	Государственные, муниципальные (без учета организаций в ведении ФСИН); Заочная	"Численность студентов на начало прошлого учебного года
(на 1 октября) / 17.0"	0	0	0	0	0	0	0	0	0	0	864	0	0	721	1585	3760	0	460	953	5173
Самарская область	Государственные, муниципальные (без учета организаций в ведении ФСИН); Очная	            из стр. 11 - не прошли итоговую аттестацию / 12.0	8	0	0	0	8	0	0	0	0	0	18	0	0	6	24	0	0	9	11	20
Самарская область	Государственные, муниципальные (без учета организаций в ведении ФСИН); Очная	"            из стр. 11 – лица с ограниченными возможностями здоровья,
            инвалиды, дети-инвалиды / 13.0"	1	0	0	0	1	0	0	0	0	0	5	0	0	0	5	0	0	0	0	0
Самарская область	Государственные, муниципальные (без учета организаций в ведении ФСИН); Очная	         отчислено в виде меры дисциплинарного взыскания / 14.0	0	0	0	0	0	0	0	0	0	0	2	0	1	0	3	0	0	0	1	1
Самарская область	Государственные, муниципальные (без учета организаций в ведении ФСИН); Очная	         отчислено из-за просрочки оплаты обучения / 15.0	0	0	0	7	7	0	0	0	2	2	0	0	0	51	51	0	0	0	12	12
Самарская область	Государственные, муниципальные (без учета организаций в ведении ФСИН); Очная	"    в том числе:
    переведено на другие формы обучения данной
    организации на программы того же уровня / 7.0"	23	0	0	5	28	0	0	0	0	0	149	0	32	128	309	4	0	5	16	25
Самарская область	Государственные, муниципальные (без учета организаций в ведении ФСИН); Очная	"    в том числе:
    переведено с других форм обучения данной
    образовательной организации с программ того же уровня / 2.0"	62	0	0	5	67	0	0	0	0	0	118	0	6	34	158	6	0	0	2	8
Самарская область	Государственные, муниципальные (без учета организаций в ведении ФСИН); Очная	    восстановлены из числа ранее отчисленных / 4.0	20	0	0	3	23	0	0	0	0	0	131	0	23	119	273	21	0	0	38	59
Самарская область	Государственные, муниципальные (без учета организаций в ведении ФСИН); Очная	    выбыло по другим причинам / 16.0	309	0	0	32	341	11	0	0	9	20	435	0	17	165	617	44	0	2	26	72
Самарская область	Государственные, муниципальные (без учета организаций в ведении ФСИН); Очная	"    добровольно прекратили образовательные отношения
    (бросили учебу) / 10.0"	413	0	1	60	474	10	0	0	4	14	1015	0	142	472	1629	128	0	20	80	228
Самарская область	Государственные, муниципальные (без учета организаций в ведении ФСИН); Очная	"    отчислено:
         по неуспеваемости / 11.0"	303	0	0	11	314	3	0	0	1	4	477	0	47	171	695	33	0	15	49	97
Самарская область	Государственные, муниципальные (без учета организаций в ведении ФСИН); Очная	"    переведено в другие образовательные организации
    на программы того же уровня / 8.0"	137	0	0	10	147	1	0	0	1	2	557	0	36	283	876	24	0	5	15	44
Самарская область	Государственные, муниципальные (без учета организаций в ведении ФСИН); Очная	"    переведено из других образовательных организаций 
    с программ того же уровня / 3.0"	120	0	0	17	137	0	0	0	0	0	357	0	33	190	580	7	0	1	45	53
Самарская область	Государственные, муниципальные (без учета организаций в ведении ФСИН); Очная	    по болезни / 9.0	1	0	0	0	1	0	0	0	0	0	5	0	0	1	6	0	0	0	0	0
Самарская область	Государственные, муниципальные (без учета организаций в ведении ФСИН); Очная	    прибыло по другим причинам / 5.0	116	0	0	10	126	9	0	0	3	12	248	0	15	155	418	14	0	3	67	84
Самарская область	Государственные, муниципальные (без учета организаций в ведении ФСИН); Очная	Выбыло студентов - всего (сумма стр. 07-11, 13-15) / 6.0	1186	0	1	125	1312	25	0	0	17	42	2640	0	275	1271	4186	233	0	47	199	479
Самарская область	Государственные, муниципальные (без учета организаций в ведении ФСИН); Очная	Прибыло студентов - всего (сумма стр. 02-05) / 1.0	318	0	0	35	353	9	0	0	3	12	854	0	77	498	1429	48	0	4	152	204
Самарская область	Государственные, муниципальные (без учета организаций в ведении ФСИН); Очная	"Численность студентов на начало прошлого учебного года
(на 1 октября) / 17.0"	12401	0	0	963	13364	366	0	0	112	478	37218	0	4539	12022	53779	1925	0	457	1529	3911
Самарская область	Очно-заочная; Государственные, муниципальные (без учета организаций в ведении ФСИН)	            из стр. 11 - не прошли итоговую аттестацию / 12.0	0	0	0	0	0	0	0	0	0	0	0	0	0	0	0	0	0	0	0	0
Самарская область	Очно-заочная; Государственные, муниципальные (без учета организаций в ведении ФСИН)	"            из стр. 11 – лица с ограниченными возможностями здоровья,
            инвалиды, дети-инвалиды / 13.0"	0	0	0	0	0	0	0	0	0	0	0	0	0	0	0	0	0	0	0	0
Самарская область	Очно-заочная; Государственные, муниципальные (без учета организаций в ведении ФСИН)	         отчислено в виде меры дисциплинарного взыскания / 14.0	0	0	0	0	0	0	0	0	0	0	0	0	0	0	0	0	0	0	0	0
Самарская область	Очно-заочная; Государственные, муниципальные (без учета организаций в ведении ФСИН)	         отчислено из-за просрочки оплаты обучения / 15.0	0	0	0	0	0	0	0	0	0	0	0	0	0	2	2	0	0	0	3	3
Самарская область	Очно-заочная; Государственные, муниципальные (без учета организаций в ведении ФСИН)	"    в том числе:
    переведено на другие формы обучения данной
    организации на программы того же уровня / 7.0"	3	0	0	0	3	0	0	0	0	0	0	0	0	7	7	1	0	0	1	2
Самарская область	Очно-заочная; Государственные, муниципальные (без учета организаций в ведении ФСИН)	"    в том числе:
    переведено с других форм обучения данной
    образовательной организации с программ того же уровня / 2.0"	1	0	0	0	1	0	0	0	0	0	0	0	0	8	8	2	0	0	12	14
Самарская область	Очно-заочная; Государственные, муниципальные (без учета организаций в ведении ФСИН)	    восстановлены из числа ранее отчисленных / 4.0	2	0	0	2	4	0	0	0	0	0	1	0	0	3	4	5	0	1	5	11
Самарская область	Очно-заочная; Государственные, муниципальные (без учета организаций в ведении ФСИН)	    выбыло по другим причинам / 16.0	0	0	0	0	0	0	0	0	0	0	0	0	0	3	3	5	0	0	4	9
Самарская область	Очно-заочная; Государственные, муниципальные (без учета организаций в ведении ФСИН)	"    добровольно прекратили образовательные отношения
    (бросили учебу) / 10.0"	3	0	0	1	4	2	0	0	0	2	0	0	0	5	5	49	0	2	61	112
Самарская область	Очно-заочная; Государственные, муниципальные (без учета организаций в ведении ФСИН)	"    отчислено:
         по неуспеваемости / 11.0"	2	0	0	8	10	0	0	0	0	0	0	0	0	0	0	11	0	0	34	45
Самарская область	Очно-заочная; Государственные, муниципальные (без учета организаций в ведении ФСИН)	"    переведено в другие образовательные организации
    на программы того же уровня / 8.0"	2	0	0	0	2	0	0	0	0	0	0	0	0	3	3	2	0	0	1	3
Самарская область	Очно-заочная; Государственные, муниципальные (без учета организаций в ведении ФСИН)	"    переведено из других образовательных организаций 
    с программ того же уровня / 3.0"	7	0	0	6	13	0	0	0	0	0	0	0	0	1	1	0	0	1	23	24
Самарская область	Очно-заочная; Государственные, муниципальные (без учета организаций в ведении ФСИН)	    по болезни / 9.0	0	0	0	0	0	0	0	0	0	0	0	0	0	0	0	0	0	0	0	0
Самарская область	Очно-заочная; Государственные, муниципальные (без учета организаций в ведении ФСИН)	    прибыло по другим причинам / 5.0	0	0	0	0	0	0	0	0	0	0	0	0	0	0	0	4	0	0	3	7
Самарская область	Очно-заочная; Государственные, муниципальные (без учета организаций в ведении ФСИН)	Выбыло студентов - всего (сумма стр. 07-11, 13-15) / 6.0	10	0	0	9	19	2	0	0	0	2	0	0	0	20	20	68	0	2	104	174
Самарская область	Очно-заочная; Государственные, муниципальные (без учета организаций в ведении ФСИН)	Прибыло студентов - всего (сумма стр. 02-05) / 1.0	10	0	0	8	18	0	0	0	0	0	1	0	0	12	13	11	0	2	43	56
Самарская область	Очно-заочная; Государственные, муниципальные (без учета организаций в ведении ФСИН)	"Численность студентов на начало прошлого учебного года
(на 1 октября) / 17.0"	74	0	0	1	75	79	0	0	0	79	9	0	0	109	118	1001	0	30	925	1956
Самарская область	Частные; Заочная	            из стр. 11 - не прошли итоговую аттестацию / 12.0	0	0	0	0	0	0	0	0	0	0	0	0	0	0	0	0	0	0	0	0
Самарская область	Частные; Заочная	"            из стр. 11 – лица с ограниченными возможностями здоровья,
            инвалиды, дети-инвалиды / 13.0"	0	0	0	0	0	0	0	0	0	0	0	0	0	0	0	0	0	0	0	0
Самарская область	Частные; Заочная	         отчислено в виде меры дисциплинарного взыскания / 14.0	0	0	0	0	0	0	0	0	0	0	0	0	0	0	0	0	0	0	0	0
Самарская область	Частные; Заочная	         отчислено из-за просрочки оплаты обучения / 15.0	0	0	0	0	0	0	0	0	0	0	0	0	0	0	0	0	0	0	22	22
Самарская область	Частные; Заочная	"    в том числе:
    переведено на другие формы обучения данной
    организации на программы того же уровня / 7.0"	0	0	0	0	0	0	0	0	0	0	0	0	0	0	0	0	0	0	1	1
Самарская область	Частные; Заочная	"    в том числе:
    переведено с других форм обучения данной
    образовательной организации с программ того же уровня / 2.0"	0	0	0	0	0	0	0	0	0	0	0	0	0	0	0	0	0	0	12	12
Самарская область	Частные; Заочная	    восстановлены из числа ранее отчисленных / 4.0	0	0	0	0	0	0	0	0	0	0	0	0	0	0	0	0	0	0	5	5
Самарская область	Частные; Заочная	    выбыло по другим причинам / 16.0	0	0	0	0	0	0	0	0	0	0	0	0	0	0	0	0	0	0	6	6
Самарская область	Частные; Заочная	"    добровольно прекратили образовательные отношения
    (бросили учебу) / 10.0"	0	0	0	0	0	0	0	0	0	0	0	0	0	0	0	0	0	0	11	11
Самарская область	Частные; Заочная	"    отчислено:
         по неуспеваемости / 11.0"	0	0	0	0	0	0	0	0	0	0	0	0	0	0	0	0	0	0	15	15
Самарская область	Частные; Заочная	"    переведено в другие образовательные организации
    на программы того же уровня / 8.0"	0	0	0	0	0	0	0	0	0	0	0	0	0	0	0	0	0	0	1	1
Самарская область	Частные; Заочная	"    переведено из других образовательных организаций 
    с программ того же уровня / 3.0"	0	0	0	0	0	0	0	0	0	0	0	0	0	0	0	0	0	0	5	5
Самарская область	Частные; Заочная	    по болезни / 9.0	0	0	0	0	0	0	0	0	0	0	0	0	0	0	0	0	0	0	0	0
Самарская область	Частные; Заочная	    прибыло по другим причинам / 5.0	0	0	0	0	0	0	0	0	0	0	0	0	0	0	0	0	0	0	0	0
Самарская область	Частные; Заочная	Выбыло студентов - всего (сумма стр. 07-11, 13-15) / 6.0	0	0	0	0	0	0	0	0	0	0	0	0	0	0	0	0	0	0	56	56
Самарская область	Частные; Заочная	Прибыло студентов - всего (сумма стр. 02-05) / 1.0	0	0	0	0	0	0	0	0	0	0	0	0	0	0	0	0	0	0	22	22
Самарская область	Частные; Заочная	"Численность студентов на начало прошлого учебного года
(на 1 октября) / 17.0"	0	0	0	0	0	0	0	0	0	0	0	0	0	0	0	0	0	0	423	423
Самарская область	Частные; Очная	            из стр. 11 - не прошли итоговую аттестацию / 12.0	0	0	0	0	0	0	0	0	0	0	0	0	0	0	0	0	0	0	0	0
Самарская область	Частные; Очная	"            из стр. 11 – лица с ограниченными возможностями здоровья,
            инвалиды, дети-инвалиды / 13.0"	0	0	0	0	0	0	0	0	0	0	0	0	0	0	0	0	0	0	0	0
Самарская область	Частные; Очная	         отчислено в виде меры дисциплинарного взыскания / 14.0	0	0	0	0	0	0	0	0	0	0	0	0	0	0	0	0	0	0	0	0
Самарская область	Частные; Очная	         отчислено из-за просрочки оплаты обучения / 15.0	0	0	0	0	0	0	0	0	0	0	0	0	0	77	77	0	0	0	9	9
Самарская область	Частные; Очная	"    в том числе:
    переведено на другие формы обучения данной
    организации на программы того же уровня / 7.0"	0	0	0	0	0	0	0	0	0	0	1	0	0	0	1	3	0	0	12	15
Самарская область	Частные; Очная	"    в том числе:
    переведено с других форм обучения данной
    образовательной организации с программ того же уровня / 2.0"	0	0	0	0	0	0	0	0	0	0	0	0	0	99	99	0	0	0	10	10
Самарская область	Частные; Очная	    восстановлены из числа ранее отчисленных / 4.0	0	0	0	0	0	0	0	0	0	0	0	0	0	32	32	0	0	0	8	8
Самарская область	Частные; Очная	    выбыло по другим причинам / 16.0	0	0	0	0	0	0	0	0	0	0	1	0	0	7	8	0	0	0	2	2
Самарская область	Частные; Очная	"    добровольно прекратили образовательные отношения
    (бросили учебу) / 10.0"	0	0	0	0	0	0	0	0	0	0	1	0	0	207	208	0	0	0	34	34
Самарская область	Частные; Очная	"    отчислено:
         по неуспеваемости / 11.0"	0	0	0	0	0	0	0	0	0	0	0	0	0	160	160	0	0	0	30	30
Самарская область	Частные; Очная	"    переведено в другие образовательные организации
    на программы того же уровня / 8.0"	0	0	0	0	0	0	0	0	0	0	3	0	0	86	89	0	0	0	9	9
Самарская область	Частные; Очная	"    переведено из других образовательных организаций 
    с программ того же уровня / 3.0"	0	0	0	0	0	0	0	0	0	0	0	0	0	130	130	0	0	0	21	21
Самарская область	Частные; Очная	    по болезни / 9.0	0	0	0	0	0	0	0	0	0	0	0	0	0	0	0	0	0	0	0	0
Самарская область	Частные; Очная	    прибыло по другим причинам / 5.0	0	0	0	0	0	0	0	0	0	0	0	0	0	2	2	0	0	0	49	49
Самарская область	Частные; Очная	Выбыло студентов - всего (сумма стр. 07-11, 13-15) / 6.0	0	0	0	0	0	0	0	0	0	0	6	0	0	537	543	3	0	0	96	99
Самарская область	Частные; Очная	Прибыло студентов - всего (сумма стр. 02-05) / 1.0	0	0	0	0	0	0	0	0	0	0	0	0	0	263	263	0	0	0	88	88
Самарская область	Частные; Очная	"Численность студентов на начало прошлого учебного года
(на 1 октября) / 17.0"	0	0	0	0	0	0	0	0	0	0	185	0	0	4729	4914	76	0	0	642	718
Самарская область	Частные; Очно-заочная	            из стр. 11 - не прошли итоговую аттестацию / 12.0	0	0	0	0	0	0	0	0	0	0	0	0	0	0	0	0	0	0	0	0
Самарская область	Частные; Очно-заочная	"            из стр. 11 – лица с ограниченными возможностями здоровья,
            инвалиды, дети-инвалиды / 13.0"	0	0	0	0	0	0	0	0	0	0	0	0	0	0	0	0	0	0	0	0
Самарская область	Частные; Очно-заочная	         отчислено в виде меры дисциплинарного взыскания / 14.0	0	0	0	0	0	0	0	0	0	0	0	0	0	0	0	0	0	0	0	0
Самарская область	Частные; Очно-заочная	         отчислено из-за просрочки оплаты обучения / 15.0	0	0	0	0	0	0	0	0	0	0	0	0	0	0	0	0	0	0	0	0
Самарская область	Частные; Очно-заочная	"    в том числе:
    переведено на другие формы обучения данной
    организации на программы того же уровня / 7.0"	0	0	0	0	0	0	0	0	0	0	0	0	0	0	0	0	0	0	0	0
Самарская область	Частные; Очно-заочная	"    в том числе:
    переведено с других форм обучения данной
    образовательной организации с программ того же уровня / 2.0"	0	0	0	0	0	0	0	0	0	0	0	0	0	0	0	0	0	0	0	0
Самарская область	Частные; Очно-заочная	    восстановлены из числа ранее отчисленных / 4.0	0	0	0	0	0	0	0	0	0	0	0	0	0	0	0	0	0	0	0	0
Самарская область	Частные; Очно-заочная	    выбыло по другим причинам / 16.0	0	0	0	0	0	0	0	0	0	0	0	0	0	0	0	0	0	0	0	0
Самарская область	Частные; Очно-заочная	"    добровольно прекратили образовательные отношения
    (бросили учебу) / 10.0"	0	0	0	0	0	0	0	0	0	0	0	0	0	0	0	0	0	0	51	51
Самарская область	Частные; Очно-заочная	"    отчислено:
         по неуспеваемости / 11.0"	0	0	0	0	0	0	0	0	0	0	0	0	0	0	0	0	0	0	1	1
Самарская область	Частные; Очно-заочная	"    переведено в другие образовательные организации
    на программы того же уровня / 8.0"	0	0	0	0	0	0	0	0	0	0	0	0	0	0	0	0	0	0	214	214
Самарская область	Частные; Очно-заочная	"    переведено из других образовательных организаций 
    с программ того же уровня / 3.0"	0	0	0	0	0	0	0	0	0	0	0	0	0	0	0	0	0	0	168	168
Самарская область	Частные; Очно-заочная	    по болезни / 9.0	0	0	0	0	0	0	0	0	0	0	0	0	0	0	0	0	0	0	0	0
Самарская область	Частные; Очно-заочная	    прибыло по другим причинам / 5.0	0	0	0	0	0	0	0	0	0	0	0	0	0	0	0	0	0	0	0	0
Самарская область	Частные; Очно-заочная	Выбыло студентов - всего (сумма стр. 07-11, 13-15) / 6.0	0	0	0	0	0	0	0	0	0	0	0	0	0	0	0	0	0	0	266	266
Самарская область	Частные; Очно-заочная	Прибыло студентов - всего (сумма стр. 02-05) / 1.0	0	0	0	0	0	0	0	0	0	0	0	0	0	0	0	0	0	0	168	168
Самарская область	Частные; Очно-заочная	"Численность студентов на начало прошлого учебного года
(на 1 октября) / 17.0"	0	0	0	0	0	0	0	0	0	0	0	0	0	0	0	0	0	0	861	861
Саратовская область	Государственные, муниципальные (без учета организаций в ведении ФСИН); Заочная	            из стр. 11 - не прошли итоговую аттестацию / 12.0	0	0	0	0	0	0	0	0	0	0	1	0	0	4	5	17	0	0	2	19
Саратовская область	Государственные, муниципальные (без учета организаций в ведении ФСИН); Заочная	"            из стр. 11 – лица с ограниченными возможностями здоровья,
            инвалиды, дети-инвалиды / 13.0"	0	0	0	0	0	0	0	0	0	0	0	0	0	0	0	0	0	0	0	0
Саратовская область	Государственные, муниципальные (без учета организаций в ведении ФСИН); Заочная	         отчислено в виде меры дисциплинарного взыскания / 14.0	0	0	0	0	0	0	0	0	0	0	0	0	0	2	2	0	0	0	0	0
Саратовская область	Государственные, муниципальные (без учета организаций в ведении ФСИН); Заочная	         отчислено из-за просрочки оплаты обучения / 15.0	0	0	0	0	0	0	0	0	0	0	0	0	0	39	39	0	0	0	21	21
Саратовская область	Государственные, муниципальные (без учета организаций в ведении ФСИН); Заочная	"    в том числе:
    переведено на другие формы обучения данной
    организации на программы того же уровня / 7.0"	0	0	0	0	0	0	0	0	0	0	0	0	0	4	4	9	0	1	8	18
Саратовская область	Государственные, муниципальные (без учета организаций в ведении ФСИН); Заочная	"    в том числе:
    переведено с других форм обучения данной
    образовательной организации с программ того же уровня / 2.0"	0	0	0	0	0	0	0	0	0	0	5	0	0	29	34	10	0	1	37	48
Саратовская область	Государственные, муниципальные (без учета организаций в ведении ФСИН); Заочная	    восстановлены из числа ранее отчисленных / 4.0	0	0	0	0	0	0	0	0	0	0	9	0	0	10	19	12	0	0	27	39
Саратовская область	Государственные, муниципальные (без учета организаций в ведении ФСИН); Заочная	    выбыло по другим причинам / 16.0	0	0	0	0	0	0	0	0	0	0	0	0	0	2	2	62	0	0	44	106
Саратовская область	Государственные, муниципальные (без учета организаций в ведении ФСИН); Заочная	"    добровольно прекратили образовательные отношения
    (бросили учебу) / 10.0"	0	0	0	0	0	0	0	0	0	0	1	0	1	37	39	130	0	29	83	242
Саратовская область	Государственные, муниципальные (без учета организаций в ведении ФСИН); Заочная	"    отчислено:
         по неуспеваемости / 11.0"	0	0	0	0	0	0	0	0	0	0	4	0	0	11	15	74	0	18	55	147
Саратовская область	Государственные, муниципальные (без учета организаций в ведении ФСИН); Заочная	"    переведено в другие образовательные организации
    на программы того же уровня / 8.0"	0	0	0	0	0	0	0	0	0	0	0	0	0	0	0	10	0	0	2	12
Саратовская область	Государственные, муниципальные (без учета организаций в ведении ФСИН); Заочная	"    переведено из других образовательных организаций 
    с программ того же уровня / 3.0"	0	0	0	0	0	0	0	0	0	0	0	0	1	9	10	0	0	0	3	3
Саратовская область	Государственные, муниципальные (без учета организаций в ведении ФСИН); Заочная	    по болезни / 9.0	0	0	0	0	0	0	0	0	0	0	0	0	0	0	0	0	0	0	0	0
Саратовская область	Государственные, муниципальные (без учета организаций в ведении ФСИН); Заочная	    прибыло по другим причинам / 5.0	0	0	0	0	0	0	0	0	0	0	0	0	0	12	12	67	0	0	28	95
Саратовская область	Государственные, муниципальные (без учета организаций в ведении ФСИН); Заочная	Выбыло студентов - всего (сумма стр. 07-11, 13-15) / 6.0	0	0	0	0	0	0	0	0	0	0	5	0	1	95	101	285	0	48	213	546
Саратовская область	Государственные, муниципальные (без учета организаций в ведении ФСИН); Заочная	Прибыло студентов - всего (сумма стр. 02-05) / 1.0	0	0	0	0	0	0	0	0	0	0	14	0	1	60	75	89	0	1	95	185
Саратовская область	Государственные, муниципальные (без учета организаций в ведении ФСИН); Заочная	"Численность студентов на начало прошлого учебного года
(на 1 октября) / 17.0"	0	0	0	0	0	0	0	0	0	0	7	0	44	665	716	2383	0	659	1510	4552
Саратовская область	Государственные, муниципальные (без учета организаций в ведении ФСИН); Очная	            из стр. 11 - не прошли итоговую аттестацию / 12.0	6	0	0	0	6	1	0	0	0	1	6	0	2	0	8	0	0	0	1	1
Саратовская область	Государственные, муниципальные (без учета организаций в ведении ФСИН); Очная	"            из стр. 11 – лица с ограниченными возможностями здоровья,
            инвалиды, дети-инвалиды / 13.0"	3	0	0	0	3	0	0	0	0	0	0	0	0	0	0	0	0	0	0	0
Саратовская область	Государственные, муниципальные (без учета организаций в ведении ФСИН); Очная	         отчислено в виде меры дисциплинарного взыскания / 14.0	14	0	0	0	14	1	0	0	0	1	13	0	0	26	39	2	0	2	7	11
Саратовская область	Государственные, муниципальные (без учета организаций в ведении ФСИН); Очная	         отчислено из-за просрочки оплаты обучения / 15.0	0	0	0	6	6	0	0	0	2	2	0	0	0	44	44	0	0	0	11	11
Саратовская область	Государственные, муниципальные (без учета организаций в ведении ФСИН); Очная	"    в том числе:
    переведено на другие формы обучения данной
    организации на программы того же уровня / 7.0"	10	0	0	4	14	0	0	0	0	0	57	0	5	123	185	12	0	4	52	68
Саратовская область	Государственные, муниципальные (без учета организаций в ведении ФСИН); Очная	"    в том числе:
    переведено с других форм обучения данной
    образовательной организации с программ того же уровня / 2.0"	7	0	0	9	16	0	0	0	0	0	42	0	31	33	106	222	0	22	142	386
Саратовская область	Государственные, муниципальные (без учета организаций в ведении ФСИН); Очная	    восстановлены из числа ранее отчисленных / 4.0	40	1	0	7	48	2	0	0	0	2	76	0	18	120	214	223	0	21	103	347
Саратовская область	Государственные, муниципальные (без учета организаций в ведении ФСИН); Очная	    выбыло по другим причинам / 16.0	136	0	0	10	146	4	0	0	2	6	198	0	60	132	390	29	0	16	59	104
Саратовская область	Государственные, муниципальные (без учета организаций в ведении ФСИН); Очная	"    добровольно прекратили образовательные отношения
    (бросили учебу) / 10.0"	317	0	0	26	343	13	0	0	2	15	757	0	332	507	1596	156	0	56	163	375
Саратовская область	Государственные, муниципальные (без учета организаций в ведении ФСИН); Очная	"    отчислено:
         по неуспеваемости / 11.0"	128	0	0	0	128	5	0	0	0	5	211	0	79	97	387	22	0	17	40	79
Саратовская область	Государственные, муниципальные (без учета организаций в ведении ФСИН); Очная	"    переведено в другие образовательные организации
    на программы того же уровня / 8.0"	32	0	0	9	41	0	0	0	0	0	161	0	86	170	417	12	0	4	21	37
Саратовская область	Государственные, муниципальные (без учета организаций в ведении ФСИН); Очная	"    переведено из других образовательных организаций 
    с программ того же уровня / 3.0"	59	0	0	3	62	0	0	0	0	0	141	0	66	98	305	93	0	3	87	183
Саратовская область	Государственные, муниципальные (без учета организаций в ведении ФСИН); Очная	    по болезни / 9.0	1	0	0	0	1	0	0	0	0	0	6	0	0	0	6	0	0	0	0	0
Саратовская область	Государственные, муниципальные (без учета организаций в ведении ФСИН); Очная	    прибыло по другим причинам / 5.0	54	0	0	1	55	2	0	0	0	2	1022	0	62	123	1207	188	0	26	136	350
Саратовская область	Государственные, муниципальные (без учета организаций в ведении ФСИН); Очная	Выбыло студентов - всего (сумма стр. 07-11, 13-15) / 6.0	638	0	0	55	693	23	0	0	6	29	1403	0	562	1099	3064	233	0	99	353	685
Саратовская область	Государственные, муниципальные (без учета организаций в ведении ФСИН); Очная	Прибыло студентов - всего (сумма стр. 02-05) / 1.0	160	1	0	20	181	4	0	0	0	4	1281	0	177	374	1832	726	0	72	468	1266
Саратовская область	Государственные, муниципальные (без учета организаций в ведении ФСИН); Очная	"Численность студентов на начало прошлого учебного года
(на 1 октября) / 17.0"	7685	0	0	329	8014	226	0	0	15	241	17035	0	10271	9212	36518	1081	0	959	2311	4351
Саратовская область	Очно-заочная; Государственные, муниципальные (без учета организаций в ведении ФСИН)	            из стр. 11 - не прошли итоговую аттестацию / 12.0	0	0	0	0	0	0	0	0	0	0	0	0	0	0	0	0	0	0	0	0
Саратовская область	Очно-заочная; Государственные, муниципальные (без учета организаций в ведении ФСИН)	"            из стр. 11 – лица с ограниченными возможностями здоровья,
            инвалиды, дети-инвалиды / 13.0"	0	0	0	0	0	0	0	0	0	0	0	0	0	0	0	0	0	0	0	0
Саратовская область	Очно-заочная; Государственные, муниципальные (без учета организаций в ведении ФСИН)	         отчислено в виде меры дисциплинарного взыскания / 14.0	0	0	0	0	0	0	0	0	0	0	0	0	0	0	0	0	0	0	5	5
Саратовская область	Очно-заочная; Государственные, муниципальные (без учета организаций в ведении ФСИН)	         отчислено из-за просрочки оплаты обучения / 15.0	0	0	0	0	0	0	0	0	0	0	0	0	0	0	0	0	0	0	6	6
Саратовская область	Очно-заочная; Государственные, муниципальные (без учета организаций в ведении ФСИН)	"    в том числе:
    переведено на другие формы обучения данной
    организации на программы того же уровня / 7.0"	0	0	0	0	0	0	0	0	0	0	0	0	0	0	0	0	0	0	0	0
Саратовская область	Очно-заочная; Государственные, муниципальные (без учета организаций в ведении ФСИН)	"    в том числе:
    переведено с других форм обучения данной
    образовательной организации с программ того же уровня / 2.0"	0	0	0	1	1	0	0	0	0	0	0	0	0	0	0	0	0	0	0	0
Саратовская область	Очно-заочная; Государственные, муниципальные (без учета организаций в ведении ФСИН)	    восстановлены из числа ранее отчисленных / 4.0	0	0	0	0	0	0	0	0	0	0	0	0	0	2	2	0	0	0	2	2
Саратовская область	Очно-заочная; Государственные, муниципальные (без учета организаций в ведении ФСИН)	    выбыло по другим причинам / 16.0	0	0	0	0	0	0	0	0	0	0	2	0	0	7	9	0	0	0	3	3
Саратовская область	Очно-заочная; Государственные, муниципальные (без учета организаций в ведении ФСИН)	"    добровольно прекратили образовательные отношения
    (бросили учебу) / 10.0"	0	0	0	5	5	0	0	0	0	0	0	0	0	2	2	0	0	0	17	17
Саратовская область	Очно-заочная; Государственные, муниципальные (без учета организаций в ведении ФСИН)	"    отчислено:
         по неуспеваемости / 11.0"	0	0	0	0	0	0	0	0	0	0	0	0	0	1	1	0	0	0	10	10
Саратовская область	Очно-заочная; Государственные, муниципальные (без учета организаций в ведении ФСИН)	"    переведено в другие образовательные организации
    на программы того же уровня / 8.0"	0	0	0	2	2	0	0	0	0	0	0	0	0	2	2	0	0	0	0	0
Саратовская область	Очно-заочная; Государственные, муниципальные (без учета организаций в ведении ФСИН)	"    переведено из других образовательных организаций 
    с программ того же уровня / 3.0"	0	0	0	0	0	0	0	0	0	0	0	0	0	0	0	0	0	0	1	1
Саратовская область	Очно-заочная; Государственные, муниципальные (без учета организаций в ведении ФСИН)	    по болезни / 9.0	0	0	0	0	0	0	0	0	0	0	0	0	0	1	1	0	0	0	0	0
Саратовская область	Очно-заочная; Государственные, муниципальные (без учета организаций в ведении ФСИН)	    прибыло по другим причинам / 5.0	0	0	0	0	0	0	0	0	0	0	0	0	0	0	0	0	0	0	2	2
Саратовская область	Очно-заочная; Государственные, муниципальные (без учета организаций в ведении ФСИН)	Выбыло студентов - всего (сумма стр. 07-11, 13-15) / 6.0	0	0	0	7	7	0	0	0	0	0	2	0	0	13	15	0	0	0	41	41
Саратовская область	Очно-заочная; Государственные, муниципальные (без учета организаций в ведении ФСИН)	Прибыло студентов - всего (сумма стр. 02-05) / 1.0	0	0	0	1	1	0	0	0	0	0	0	0	0	2	2	0	0	0	5	5
Саратовская область	Очно-заочная; Государственные, муниципальные (без учета организаций в ведении ФСИН)	"Численность студентов на начало прошлого учебного года
(на 1 октября) / 17.0"	0	0	0	25	25	0	0	0	0	0	13	0	0	246	259	31	0	0	417	448
Саратовская область	Частные; Заочная	            из стр. 11 - не прошли итоговую аттестацию / 12.0	0	0	0	0	0	0	0	0	0	0	0	0	0	0	0	0	0	0	2	2
Саратовская область	Частные; Заочная	"            из стр. 11 – лица с ограниченными возможностями здоровья,
            инвалиды, дети-инвалиды / 13.0"	0	0	0	0	0	0	0	0	0	0	0	0	0	0	0	0	0	0	0	0
Саратовская область	Частные; Заочная	         отчислено в виде меры дисциплинарного взыскания / 14.0	0	0	0	0	0	0	0	0	0	0	0	0	0	0	0	0	0	0	0	0
Саратовская область	Частные; Заочная	         отчислено из-за просрочки оплаты обучения / 15.0	0	0	0	0	0	0	0	0	0	0	0	0	0	0	0	0	0	0	0	0
Саратовская область	Частные; Заочная	"    в том числе:
    переведено на другие формы обучения данной
    организации на программы того же уровня / 7.0"	0	0	0	0	0	0	0	0	0	0	0	0	0	0	0	0	0	0	2	2
Саратовская область	Частные; Заочная	"    в том числе:
    переведено с других форм обучения данной
    образовательной организации с программ того же уровня / 2.0"	0	0	0	0	0	0	0	0	0	0	0	0	0	0	0	0	0	0	0	0
Саратовская область	Частные; Заочная	    восстановлены из числа ранее отчисленных / 4.0	0	0	0	0	0	0	0	0	0	0	0	0	0	0	0	0	0	0	3	3
Саратовская область	Частные; Заочная	    выбыло по другим причинам / 16.0	0	0	0	0	0	0	0	0	0	0	0	0	0	0	0	0	0	0	0	0
Саратовская область	Частные; Заочная	"    добровольно прекратили образовательные отношения
    (бросили учебу) / 10.0"	0	0	0	0	0	0	0	0	0	0	0	0	0	0	0	0	0	0	4	4
Саратовская область	Частные; Заочная	"    отчислено:
         по неуспеваемости / 11.0"	0	0	0	0	0	0	0	0	0	0	0	0	0	0	0	0	0	0	2	2
Саратовская область	Частные; Заочная	"    переведено в другие образовательные организации
    на программы того же уровня / 8.0"	0	0	0	0	0	0	0	0	0	0	0	0	0	0	0	0	0	0	0	0
Саратовская область	Частные; Заочная	"    переведено из других образовательных организаций 
    с программ того же уровня / 3.0"	0	0	0	0	0	0	0	0	0	0	0	0	0	0	0	0	0	0	4	4
Саратовская область	Частные; Заочная	    по болезни / 9.0	0	0	0	0	0	0	0	0	0	0	0	0	0	0	0	0	0	0	0	0
Саратовская область	Частные; Заочная	    прибыло по другим причинам / 5.0	0	0	0	0	0	0	0	0	0	0	0	0	0	0	0	0	0	0	0	0
Саратовская область	Частные; Заочная	Выбыло студентов - всего (сумма стр. 07-11, 13-15) / 6.0	0	0	0	0	0	0	0	0	0	0	0	0	0	0	0	0	0	0	8	8
Саратовская область	Частные; Заочная	Прибыло студентов - всего (сумма стр. 02-05) / 1.0	0	0	0	0	0	0	0	0	0	0	0	0	0	0	0	0	0	0	7	7
Саратовская область	Частные; Заочная	"Численность студентов на начало прошлого учебного года
(на 1 октября) / 17.0"	0	0	0	0	0	0	0	0	0	0	0	0	0	0	0	0	0	0	95	95
Саратовская область	Частные; Очная	            из стр. 11 - не прошли итоговую аттестацию / 12.0	0	0	0	0	0	0	0	0	0	0	0	0	0	11	11	0	0	0	3	3
Саратовская область	Частные; Очная	"            из стр. 11 – лица с ограниченными возможностями здоровья,
            инвалиды, дети-инвалиды / 13.0"	0	0	0	0	0	0	0	0	0	0	0	0	0	0	0	0	0	0	0	0
Саратовская область	Частные; Очная	         отчислено в виде меры дисциплинарного взыскания / 14.0	0	0	0	0	0	0	0	0	0	0	0	0	0	0	0	0	0	0	0	0
Саратовская область	Частные; Очная	         отчислено из-за просрочки оплаты обучения / 15.0	0	0	0	0	0	0	0	0	0	0	0	0	0	18	18	0	0	0	9	9
Саратовская область	Частные; Очная	"    в том числе:
    переведено на другие формы обучения данной
    организации на программы того же уровня / 7.0"	0	0	0	0	0	0	0	0	0	0	0	0	0	0	0	0	0	0	0	0
Саратовская область	Частные; Очная	"    в том числе:
    переведено с других форм обучения данной
    образовательной организации с программ того же уровня / 2.0"	0	0	0	0	0	0	0	0	0	0	0	0	0	0	0	0	0	0	1	1
Саратовская область	Частные; Очная	    восстановлены из числа ранее отчисленных / 4.0	0	0	0	0	0	0	0	0	0	0	0	0	0	6	6	0	0	0	0	0
Саратовская область	Частные; Очная	    выбыло по другим причинам / 16.0	0	0	0	0	0	0	0	0	0	0	0	0	0	19	19	0	0	0	19	19
Саратовская область	Частные; Очная	"    добровольно прекратили образовательные отношения
    (бросили учебу) / 10.0"	0	0	0	0	0	0	0	0	0	0	0	0	0	62	62	0	0	0	19	19
Саратовская область	Частные; Очная	"    отчислено:
         по неуспеваемости / 11.0"	0	0	0	0	0	0	0	0	0	0	0	0	0	11	11	0	0	0	3	3
Саратовская область	Частные; Очная	"    переведено в другие образовательные организации
    на программы того же уровня / 8.0"	0	0	0	0	0	0	0	0	0	0	0	0	0	12	12	0	0	0	2	2
Саратовская область	Частные; Очная	"    переведено из других образовательных организаций 
    с программ того же уровня / 3.0"	0	0	0	0	0	0	0	0	0	0	0	0	0	31	31	0	0	0	8	8
Саратовская область	Частные; Очная	    по болезни / 9.0	0	0	0	0	0	0	0	0	0	0	0	0	0	0	0	0	0	0	0	0
Саратовская область	Частные; Очная	    прибыло по другим причинам / 5.0	0	0	0	0	0	0	0	0	0	0	0	0	0	30	30	0	0	0	2	2
Саратовская область	Частные; Очная	Выбыло студентов - всего (сумма стр. 07-11, 13-15) / 6.0	0	0	0	0	0	0	0	0	0	0	0	0	0	122	122	0	0	0	52	52
Саратовская область	Частные; Очная	Прибыло студентов - всего (сумма стр. 02-05) / 1.0	0	0	0	0	0	0	0	0	0	0	0	0	0	67	67	0	0	0	11	11
Саратовская область	Частные; Очная	"Численность студентов на начало прошлого учебного года
(на 1 октября) / 17.0"	0	0	0	0	0	0	0	0	0	0	0	0	0	1047	1047	0	0	0	115	115
Саратовская область	Частные; Очно-заочная	            из стр. 11 - не прошли итоговую аттестацию / 12.0	0	0	0	0	0	0	0	0	0	0	0	0	0	0	0	0	0	0	0	0
Саратовская область	Частные; Очно-заочная	"            из стр. 11 – лица с ограниченными возможностями здоровья,
            инвалиды, дети-инвалиды / 13.0"	0	0	0	0	0	0	0	0	0	0	0	0	0	0	0	0	0	0	0	0
Саратовская область	Частные; Очно-заочная	         отчислено в виде меры дисциплинарного взыскания / 14.0	0	0	0	0	0	0	0	0	0	0	0	0	0	0	0	0	0	0	0	0
Саратовская область	Частные; Очно-заочная	         отчислено из-за просрочки оплаты обучения / 15.0	0	0	0	0	0	0	0	0	0	0	0	0	0	0	0	0	0	0	0	0
Саратовская область	Частные; Очно-заочная	"    в том числе:
    переведено на другие формы обучения данной
    организации на программы того же уровня / 7.0"	0	0	0	0	0	0	0	0	0	0	0	0	0	0	0	0	0	0	0	0
Саратовская область	Частные; Очно-заочная	"    в том числе:
    переведено с других форм обучения данной
    образовательной организации с программ того же уровня / 2.0"	0	0	0	0	0	0	0	0	0	0	0	0	0	0	0	0	0	0	0	0
Саратовская область	Частные; Очно-заочная	    восстановлены из числа ранее отчисленных / 4.0	0	0	0	0	0	0	0	0	0	0	0	0	0	0	0	0	0	0	0	0
Саратовская область	Частные; Очно-заочная	    выбыло по другим причинам / 16.0	0	0	0	0	0	0	0	0	0	0	0	0	0	0	0	0	0	0	0	0
Саратовская область	Частные; Очно-заочная	"    добровольно прекратили образовательные отношения
    (бросили учебу) / 10.0"	0	0	0	0	0	0	0	0	0	0	0	0	0	0	0	0	0	0	0	0
Саратовская область	Частные; Очно-заочная	"    отчислено:
         по неуспеваемости / 11.0"	0	0	0	0	0	0	0	0	0	0	0	0	0	0	0	0	0	0	0	0
Саратовская область	Частные; Очно-заочная	"    переведено в другие образовательные организации
    на программы того же уровня / 8.0"	0	0	0	0	0	0	0	0	0	0	0	0	0	0	0	0	0	0	0	0
Саратовская область	Частные; Очно-заочная	"    переведено из других образовательных организаций 
    с программ того же уровня / 3.0"	0	0	0	0	0	0	0	0	0	0	0	0	0	0	0	0	0	0	0	0
Саратовская область	Частные; Очно-заочная	    по болезни / 9.0	0	0	0	0	0	0	0	0	0	0	0	0	0	0	0	0	0	0	0	0
Саратовская область	Частные; Очно-заочная	    прибыло по другим причинам / 5.0	0	0	0	0	0	0	0	0	0	0	0	0	0	0	0	0	0	0	0	0
Саратовская область	Частные; Очно-заочная	Выбыло студентов - всего (сумма стр. 07-11, 13-15) / 6.0	0	0	0	0	0	0	0	0	0	0	0	0	0	0	0	0	0	0	0	0
Саратовская область	Частные; Очно-заочная	Прибыло студентов - всего (сумма стр. 02-05) / 1.0	0	0	0	0	0	0	0	0	0	0	0	0	0	0	0	0	0	0	0	0
Саратовская область	Частные; Очно-заочная	"Численность студентов на начало прошлого учебного года
(на 1 октября) / 17.0"	0	0	0	0	0	0	0	0	0	0	0	0	0	0	0	0	0	0	93	93
Сахалинская область	Государственные, муниципальные (без учета организаций в ведении ФСИН); Заочная	            из стр. 11 - не прошли итоговую аттестацию / 12.0	0	0	0	0	0	0	0	0	0	0	0	0	0	0	0	0	0	0	8	8
Сахалинская область	Государственные, муниципальные (без учета организаций в ведении ФСИН); Заочная	"            из стр. 11 – лица с ограниченными возможностями здоровья,
            инвалиды, дети-инвалиды / 13.0"	0	0	0	0	0	0	0	0	0	0	0	0	0	0	0	0	0	0	0	0
Сахалинская область	Государственные, муниципальные (без учета организаций в ведении ФСИН); Заочная	         отчислено в виде меры дисциплинарного взыскания / 14.0	0	0	0	0	0	0	0	0	0	0	0	0	0	0	0	0	0	0	0	0
Сахалинская область	Государственные, муниципальные (без учета организаций в ведении ФСИН); Заочная	         отчислено из-за просрочки оплаты обучения / 15.0	0	0	0	0	0	0	0	0	0	0	0	0	0	22	22	0	0	0	19	19
Сахалинская область	Государственные, муниципальные (без учета организаций в ведении ФСИН); Заочная	"    в том числе:
    переведено на другие формы обучения данной
    организации на программы того же уровня / 7.0"	0	0	0	0	0	0	0	0	0	0	0	0	0	0	0	1	0	0	4	5
Сахалинская область	Государственные, муниципальные (без учета организаций в ведении ФСИН); Заочная	"    в том числе:
    переведено с других форм обучения данной
    образовательной организации с программ того же уровня / 2.0"	0	0	0	0	0	0	0	0	0	0	0	0	0	5	5	5	0	1	4	10
Сахалинская область	Государственные, муниципальные (без учета организаций в ведении ФСИН); Заочная	    восстановлены из числа ранее отчисленных / 4.0	0	0	0	0	0	0	0	0	0	0	0	0	2	19	21	4	0	9	17	30
Сахалинская область	Государственные, муниципальные (без учета организаций в ведении ФСИН); Заочная	    выбыло по другим причинам / 16.0	0	0	0	0	0	0	0	0	0	0	0	0	0	29	29	8	0	5	31	44
Сахалинская область	Государственные, муниципальные (без учета организаций в ведении ФСИН); Заочная	"    добровольно прекратили образовательные отношения
    (бросили учебу) / 10.0"	0	0	0	0	0	0	0	0	0	0	0	0	5	25	30	27	0	14	44	85
Сахалинская область	Государственные, муниципальные (без учета организаций в ведении ФСИН); Заочная	"    отчислено:
         по неуспеваемости / 11.0"	0	0	0	0	0	0	0	0	0	0	0	0	3	6	9	28	0	20	32	80
Сахалинская область	Государственные, муниципальные (без учета организаций в ведении ФСИН); Заочная	"    переведено в другие образовательные организации
    на программы того же уровня / 8.0"	0	0	0	0	0	0	0	0	0	0	0	0	0	1	1	1	0	0	2	3
Сахалинская область	Государственные, муниципальные (без учета организаций в ведении ФСИН); Заочная	"    переведено из других образовательных организаций 
    с программ того же уровня / 3.0"	0	0	0	0	0	0	0	0	0	0	0	0	0	2	2	1	0	0	4	5
Сахалинская область	Государственные, муниципальные (без учета организаций в ведении ФСИН); Заочная	    по болезни / 9.0	0	0	0	0	0	0	0	0	0	0	0	0	0	0	0	0	0	0	0	0
Сахалинская область	Государственные, муниципальные (без учета организаций в ведении ФСИН); Заочная	    прибыло по другим причинам / 5.0	0	0	0	0	0	0	0	0	0	0	0	0	0	12	12	0	0	1	5	6
Сахалинская область	Государственные, муниципальные (без учета организаций в ведении ФСИН); Заочная	Выбыло студентов - всего (сумма стр. 07-11, 13-15) / 6.0	0	0	0	0	0	0	0	0	0	0	0	0	8	83	91	65	0	39	132	236
Сахалинская область	Государственные, муниципальные (без учета организаций в ведении ФСИН); Заочная	Прибыло студентов - всего (сумма стр. 02-05) / 1.0	0	0	0	0	0	0	0	0	0	0	0	0	2	38	40	10	0	11	30	51
Сахалинская область	Государственные, муниципальные (без учета организаций в ведении ФСИН); Заочная	"Численность студентов на начало прошлого учебного года
(на 1 октября) / 17.0"	0	0	0	0	0	0	0	0	0	0	12	0	48	477	537	578	0	174	721	1473
Сахалинская область	Государственные, муниципальные (без учета организаций в ведении ФСИН); Очная	            из стр. 11 - не прошли итоговую аттестацию / 12.0	11	0	0	0	11	0	0	0	0	0	5	0	0	0	5	0	0	0	0	0
Сахалинская область	Государственные, муниципальные (без учета организаций в ведении ФСИН); Очная	"            из стр. 11 – лица с ограниченными возможностями здоровья,
            инвалиды, дети-инвалиды / 13.0"	1	0	0	0	1	0	0	0	0	0	0	0	0	0	0	1	0	0	0	1
Сахалинская область	Государственные, муниципальные (без учета организаций в ведении ФСИН); Очная	         отчислено в виде меры дисциплинарного взыскания / 14.0	0	0	0	0	0	0	0	0	0	0	2	0	1	0	3	4	0	0	0	4
Сахалинская область	Государственные, муниципальные (без учета организаций в ведении ФСИН); Очная	         отчислено из-за просрочки оплаты обучения / 15.0	0	0	0	0	0	0	0	0	0	0	0	0	0	12	12	0	0	0	3	3
Сахалинская область	Государственные, муниципальные (без учета организаций в ведении ФСИН); Очная	"    в том числе:
    переведено на другие формы обучения данной
    организации на программы того же уровня / 7.0"	1	0	0	0	1	0	0	0	0	0	15	0	13	88	116	9	0	0	24	33
Сахалинская область	Государственные, муниципальные (без учета организаций в ведении ФСИН); Очная	"    в том числе:
    переведено с других форм обучения данной
    образовательной организации с программ того же уровня / 2.0"	2	0	0	0	2	0	0	0	0	0	15	0	26	6	47	7	0	8	0	15
Сахалинская область	Государственные, муниципальные (без учета организаций в ведении ФСИН); Очная	    восстановлены из числа ранее отчисленных / 4.0	7	0	0	0	7	0	0	0	0	0	27	0	32	45	104	10	0	0	14	24
Сахалинская область	Государственные, муниципальные (без учета организаций в ведении ФСИН); Очная	    выбыло по другим причинам / 16.0	91	0	0	0	91	5	0	0	2	7	124	0	42	10	176	10	0	3	3	16
Сахалинская область	Государственные, муниципальные (без учета организаций в ведении ФСИН); Очная	"    добровольно прекратили образовательные отношения
    (бросили учебу) / 10.0"	57	0	0	4	61	6	0	0	0	6	159	0	188	127	474	98	0	18	106	222
Сахалинская область	Государственные, муниципальные (без учета организаций в ведении ФСИН); Очная	"    отчислено:
         по неуспеваемости / 11.0"	108	0	0	0	108	0	0	0	0	0	91	0	25	21	137	21	0	4	25	50
Сахалинская область	Государственные, муниципальные (без учета организаций в ведении ФСИН); Очная	"    переведено в другие образовательные организации
    на программы того же уровня / 8.0"	6	0	0	0	6	0	0	0	0	0	27	0	13	11	51	2	0	1	3	6
Сахалинская область	Государственные, муниципальные (без учета организаций в ведении ФСИН); Очная	"    переведено из других образовательных организаций 
    с программ того же уровня / 3.0"	11	0	0	0	11	0	0	0	0	0	12	0	2	5	19	5	0	1	1	7
Сахалинская область	Государственные, муниципальные (без учета организаций в ведении ФСИН); Очная	    по болезни / 9.0	4	0	0	0	4	0	0	0	0	0	1	0	2	0	3	1	0	0	0	1
Сахалинская область	Государственные, муниципальные (без учета организаций в ведении ФСИН); Очная	    прибыло по другим причинам / 5.0	58	0	0	0	58	0	0	0	0	0	73	0	0	3	76	0	0	0	0	0
Сахалинская область	Государственные, муниципальные (без учета организаций в ведении ФСИН); Очная	Выбыло студентов - всего (сумма стр. 07-11, 13-15) / 6.0	267	0	0	4	271	11	0	0	2	13	419	0	284	269	972	145	0	26	164	335
Сахалинская область	Государственные, муниципальные (без учета организаций в ведении ФСИН); Очная	Прибыло студентов - всего (сумма стр. 02-05) / 1.0	78	0	0	0	78	0	0	0	0	0	127	0	60	59	246	22	0	9	15	46
Сахалинская область	Государственные, муниципальные (без учета организаций в ведении ФСИН); Очная	"Численность студентов на начало прошлого учебного года
(на 1 октября) / 17.0"	2056	0	0	43	2099	62	0	0	6	68	2906	0	1654	873	5433	852	0	170	573	1595
Сахалинская область	Очно-заочная; Государственные, муниципальные (без учета организаций в ведении ФСИН)	            из стр. 11 - не прошли итоговую аттестацию / 12.0	0	0	0	0	0	0	0	0	0	0	0	0	0	0	0	0	0	0	0	0
Сахалинская область	Очно-заочная; Государственные, муниципальные (без учета организаций в ведении ФСИН)	"            из стр. 11 – лица с ограниченными возможностями здоровья,
            инвалиды, дети-инвалиды / 13.0"	0	0	0	0	0	0	0	0	0	0	0	0	0	0	0	0	0	0	0	0
Сахалинская область	Очно-заочная; Государственные, муниципальные (без учета организаций в ведении ФСИН)	         отчислено в виде меры дисциплинарного взыскания / 14.0	0	0	0	0	0	0	0	0	0	0	0	0	0	0	0	0	0	0	0	0
Сахалинская область	Очно-заочная; Государственные, муниципальные (без учета организаций в ведении ФСИН)	         отчислено из-за просрочки оплаты обучения / 15.0	0	0	0	0	0	0	0	0	0	0	0	0	0	0	0	0	0	0	0	0
Сахалинская область	Очно-заочная; Государственные, муниципальные (без учета организаций в ведении ФСИН)	"    в том числе:
    переведено на другие формы обучения данной
    организации на программы того же уровня / 7.0"	0	0	0	0	0	0	0	0	0	0	0	0	0	0	0	0	0	0	0	0
Сахалинская область	Очно-заочная; Государственные, муниципальные (без учета организаций в ведении ФСИН)	"    в том числе:
    переведено с других форм обучения данной
    образовательной организации с программ того же уровня / 2.0"	0	0	0	0	0	0	0	0	0	0	0	0	0	0	0	10	0	0	6	16
Сахалинская область	Очно-заочная; Государственные, муниципальные (без учета организаций в ведении ФСИН)	    восстановлены из числа ранее отчисленных / 4.0	0	0	0	0	0	0	0	0	0	0	0	0	0	0	0	0	0	0	1	1
Сахалинская область	Очно-заочная; Государственные, муниципальные (без учета организаций в ведении ФСИН)	    выбыло по другим причинам / 16.0	0	0	0	0	0	0	0	0	0	0	0	0	0	0	0	0	0	0	0	0
Сахалинская область	Очно-заочная; Государственные, муниципальные (без учета организаций в ведении ФСИН)	"    добровольно прекратили образовательные отношения
    (бросили учебу) / 10.0"	0	0	0	0	0	0	0	0	0	0	0	0	0	0	0	11	0	0	8	19
Сахалинская область	Очно-заочная; Государственные, муниципальные (без учета организаций в ведении ФСИН)	"    отчислено:
         по неуспеваемости / 11.0"	0	0	0	0	0	0	0	0	0	0	0	0	0	0	0	14	0	0	6	20
Сахалинская область	Очно-заочная; Государственные, муниципальные (без учета организаций в ведении ФСИН)	"    переведено в другие образовательные организации
    на программы того же уровня / 8.0"	0	0	0	0	0	0	0	0	0	0	0	0	0	0	0	0	0	0	1	1
Сахалинская область	Очно-заочная; Государственные, муниципальные (без учета организаций в ведении ФСИН)	"    переведено из других образовательных организаций 
    с программ того же уровня / 3.0"	0	0	0	0	0	0	0	0	0	0	0	0	0	0	0	0	0	0	0	0
Сахалинская область	Очно-заочная; Государственные, муниципальные (без учета организаций в ведении ФСИН)	    по болезни / 9.0	0	0	0	0	0	0	0	0	0	0	0	0	0	0	0	0	0	0	0	0
Сахалинская область	Очно-заочная; Государственные, муниципальные (без учета организаций в ведении ФСИН)	    прибыло по другим причинам / 5.0	0	0	0	0	0	0	0	0	0	0	0	0	0	0	0	0	0	0	0	0
Сахалинская область	Очно-заочная; Государственные, муниципальные (без учета организаций в ведении ФСИН)	Выбыло студентов - всего (сумма стр. 07-11, 13-15) / 6.0	0	0	0	0	0	0	0	0	0	0	0	0	0	0	0	25	0	0	15	40
Сахалинская область	Очно-заочная; Государственные, муниципальные (без учета организаций в ведении ФСИН)	Прибыло студентов - всего (сумма стр. 02-05) / 1.0	0	0	0	0	0	0	0	0	0	0	0	0	0	0	0	10	0	0	7	17
Сахалинская область	Очно-заочная; Государственные, муниципальные (без учета организаций в ведении ФСИН)	"Численность студентов на начало прошлого учебного года
(на 1 октября) / 17.0"	0	0	0	0	0	0	0	0	0	0	0	0	0	3	3	129	0	0	142	271
Свердловская область	Государственные, муниципальные (без учета организаций в ведении ФСИН); Заочная	            из стр. 11 - не прошли итоговую аттестацию / 12.0	0	0	0	0	0	0	0	0	0	0	0	0	0	2	2	15	0	0	2	17
Свердловская область	Государственные, муниципальные (без учета организаций в ведении ФСИН); Заочная	"            из стр. 11 – лица с ограниченными возможностями здоровья,
            инвалиды, дети-инвалиды / 13.0"	0	0	0	0	0	0	0	0	0	0	0	0	0	0	0	1	0	0	0	1
Свердловская область	Государственные, муниципальные (без учета организаций в ведении ФСИН); Заочная	         отчислено в виде меры дисциплинарного взыскания / 14.0	0	0	0	0	0	0	0	0	0	0	0	0	0	0	0	0	0	0	1	1
Свердловская область	Государственные, муниципальные (без учета организаций в ведении ФСИН); Заочная	         отчислено из-за просрочки оплаты обучения / 15.0	0	0	0	0	0	0	0	0	0	0	0	0	0	33	33	0	0	0	90	90
Свердловская область	Государственные, муниципальные (без учета организаций в ведении ФСИН); Заочная	"    в том числе:
    переведено на другие формы обучения данной
    организации на программы того же уровня / 7.0"	0	0	0	0	0	0	0	0	0	0	8	0	0	2	10	21	0	0	59	80
Свердловская область	Государственные, муниципальные (без учета организаций в ведении ФСИН); Заочная	"    в том числе:
    переведено с других форм обучения данной
    образовательной организации с программ того же уровня / 2.0"	0	0	0	0	0	0	0	0	0	0	16	0	0	90	106	80	0	0	89	169
Свердловская область	Государственные, муниципальные (без учета организаций в ведении ФСИН); Заочная	    восстановлены из числа ранее отчисленных / 4.0	0	0	0	0	0	0	0	0	0	0	3	0	0	73	76	83	0	0	193	276
Свердловская область	Государственные, муниципальные (без учета организаций в ведении ФСИН); Заочная	    выбыло по другим причинам / 16.0	0	0	0	0	0	0	0	0	0	0	2	0	0	53	55	126	0	2	154	282
Свердловская область	Государственные, муниципальные (без учета организаций в ведении ФСИН); Заочная	"    добровольно прекратили образовательные отношения
    (бросили учебу) / 10.0"	0	0	0	0	0	0	0	0	0	0	34	0	0	165	199	393	0	21	297	711
Свердловская область	Государственные, муниципальные (без учета организаций в ведении ФСИН); Заочная	"    отчислено:
         по неуспеваемости / 11.0"	0	0	0	0	0	0	0	0	0	0	11	0	0	68	79	380	0	12	194	586
Свердловская область	Государственные, муниципальные (без учета организаций в ведении ФСИН); Заочная	"    переведено в другие образовательные организации
    на программы того же уровня / 8.0"	0	0	0	0	0	0	0	0	0	0	0	0	0	13	13	16	0	0	20	36
Свердловская область	Государственные, муниципальные (без учета организаций в ведении ФСИН); Заочная	"    переведено из других образовательных организаций 
    с программ того же уровня / 3.0"	0	0	0	0	0	0	0	0	0	0	0	0	0	24	24	17	0	5	29	51
Свердловская область	Государственные, муниципальные (без учета организаций в ведении ФСИН); Заочная	    по болезни / 9.0	0	0	0	0	0	0	0	0	0	0	0	0	0	0	0	4	0	0	0	4
Свердловская область	Государственные, муниципальные (без учета организаций в ведении ФСИН); Заочная	    прибыло по другим причинам / 5.0	0	0	0	0	0	0	0	0	0	0	3	0	0	53	56	147	0	3	241	391
Свердловская область	Государственные, муниципальные (без учета организаций в ведении ФСИН); Заочная	Выбыло студентов - всего (сумма стр. 07-11, 13-15) / 6.0	0	0	0	0	0	0	0	0	0	0	55	0	0	334	389	940	0	35	815	1790
Свердловская область	Государственные, муниципальные (без учета организаций в ведении ФСИН); Заочная	Прибыло студентов - всего (сумма стр. 02-05) / 1.0	0	0	0	0	0	0	0	0	0	0	22	0	0	240	262	327	0	8	552	887
Свердловская область	Государственные, муниципальные (без учета организаций в ведении ФСИН); Заочная	"Численность студентов на начало прошлого учебного года
(на 1 октября) / 17.0"	0	0	0	0	0	0	0	0	0	0	429	0	0	1650	2079	5905	0	496	3337	9738
Свердловская область	Государственные, муниципальные (без учета организаций в ведении ФСИН); Очная	            из стр. 11 - не прошли итоговую аттестацию / 12.0	15	0	0	0	15	0	0	0	0	0	40	0	0	5	45	1	0	1	4	6
Свердловская область	Государственные, муниципальные (без учета организаций в ведении ФСИН); Очная	"            из стр. 11 – лица с ограниченными возможностями здоровья,
            инвалиды, дети-инвалиды / 13.0"	4	0	0	0	4	0	0	0	0	0	7	0	1	3	11	0	0	0	2	2
Свердловская область	Государственные, муниципальные (без учета организаций в ведении ФСИН); Очная	         отчислено в виде меры дисциплинарного взыскания / 14.0	5	0	0	0	5	0	0	0	0	0	7	0	1	5	13	0	0	0	4	4
Свердловская область	Государственные, муниципальные (без учета организаций в ведении ФСИН); Очная	         отчислено из-за просрочки оплаты обучения / 15.0	0	0	0	21	21	0	0	0	3	3	0	0	0	169	169	0	0	0	50	50
Свердловская область	Государственные, муниципальные (без учета организаций в ведении ФСИН); Очная	"    в том числе:
    переведено на другие формы обучения данной
    организации на программы того же уровня / 7.0"	30	0	0	21	51	0	0	0	1	1	214	0	53	288	555	34	0	1	65	100
Свердловская область	Государственные, муниципальные (без учета организаций в ведении ФСИН); Очная	"    в том числе:
    переведено с других форм обучения данной
    образовательной организации с программ того же уровня / 2.0"	87	0	0	1	88	1	0	0	0	1	228	0	35	44	307	61	0	3	12	76
Свердловская область	Государственные, муниципальные (без учета организаций в ведении ФСИН); Очная	    восстановлены из числа ранее отчисленных / 4.0	54	0	2	12	68	0	0	0	0	0	155	5	20	186	366	23	0	1	73	97
Свердловская область	Государственные, муниципальные (без учета организаций в ведении ФСИН); Очная	    выбыло по другим причинам / 16.0	630	0	5	15	650	3	0	0	7	10	1326	5	40	599	1970	146	0	1	104	251
Свердловская область	Государственные, муниципальные (без учета организаций в ведении ФСИН); Очная	"    добровольно прекратили образовательные отношения
    (бросили учебу) / 10.0"	921	0	0	68	989	14	0	0	1	15	2050	88	195	1540	3873	359	4	46	393	802
Свердловская область	Государственные, муниципальные (без учета организаций в ведении ФСИН); Очная	"    отчислено:
         по неуспеваемости / 11.0"	443	0	0	23	466	15	0	0	0	15	945	19	70	432	1466	102	2	19	155	278
Свердловская область	Государственные, муниципальные (без учета организаций в ведении ФСИН); Очная	"    переведено в другие образовательные организации
    на программы того же уровня / 8.0"	146	0	6	9	161	0	0	0	0	0	573	13	50	359	995	43	0	1	55	99
Свердловская область	Государственные, муниципальные (без учета организаций в ведении ФСИН); Очная	"    переведено из других образовательных организаций 
    с программ того же уровня / 3.0"	152	0	4	18	174	0	0	0	1	1	327	2	29	251	609	36	0	6	27	69
Свердловская область	Государственные, муниципальные (без учета организаций в ведении ФСИН); Очная	    по болезни / 9.0	1	0	0	1	2	0	0	0	2	2	10	0	0	1	11	11	0	0	3	14
Свердловская область	Государственные, муниципальные (без учета организаций в ведении ФСИН); Очная	    прибыло по другим причинам / 5.0	320	0	2	29	351	0	0	0	1	1	1023	0	12	312	1347	149	0	8	32	189
Свердловская область	Государственные, муниципальные (без учета организаций в ведении ФСИН); Очная	Выбыло студентов - всего (сумма стр. 07-11, 13-15) / 6.0	2176	0	11	158	2345	32	0	0	14	46	5125	125	409	3393	9052	695	6	68	829	1598
Свердловская область	Государственные, муниципальные (без учета организаций в ведении ФСИН); Очная	Прибыло студентов - всего (сумма стр. 02-05) / 1.0	613	0	8	60	681	1	0	0	2	3	1733	7	96	793	2629	269	0	18	144	431
Свердловская область	Государственные, муниципальные (без учета организаций в ведении ФСИН); Очная	"Численность студентов на начало прошлого учебного года
(на 1 октября) / 17.0"	17122	0	110	543	17775	130	0	0	154	284	49353	1279	4340	18608	73580	5134	42	595	4243	10014
Свердловская область	Очно-заочная; Государственные, муниципальные (без учета организаций в ведении ФСИН)	            из стр. 11 - не прошли итоговую аттестацию / 12.0	0	0	0	0	0	0	0	0	0	0	0	0	0	0	0	0	0	3	0	3
Свердловская область	Очно-заочная; Государственные, муниципальные (без учета организаций в ведении ФСИН)	"            из стр. 11 – лица с ограниченными возможностями здоровья,
            инвалиды, дети-инвалиды / 13.0"	0	0	0	0	0	0	0	0	0	0	0	0	0	0	0	0	0	0	0	0
Свердловская область	Очно-заочная; Государственные, муниципальные (без учета организаций в ведении ФСИН)	         отчислено в виде меры дисциплинарного взыскания / 14.0	0	0	0	0	0	0	0	0	0	0	0	0	0	0	0	1	0	0	3	4
Свердловская область	Очно-заочная; Государственные, муниципальные (без учета организаций в ведении ФСИН)	         отчислено из-за просрочки оплаты обучения / 15.0	0	0	0	0	0	0	0	0	0	0	0	0	0	4	4	0	0	0	49	49
Свердловская область	Очно-заочная; Государственные, муниципальные (без учета организаций в ведении ФСИН)	"    в том числе:
    переведено на другие формы обучения данной
    организации на программы того же уровня / 7.0"	0	0	0	0	0	0	0	0	0	0	0	0	0	12	12	5	0	0	26	31
Свердловская область	Очно-заочная; Государственные, муниципальные (без учета организаций в ведении ФСИН)	"    в том числе:
    переведено с других форм обучения данной
    образовательной организации с программ того же уровня / 2.0"	0	0	0	0	0	0	0	0	0	0	0	0	0	0	0	29	0	0	55	84
Свердловская область	Очно-заочная; Государственные, муниципальные (без учета организаций в ведении ФСИН)	    восстановлены из числа ранее отчисленных / 4.0	2	0	0	0	2	2	0	0	0	2	0	0	0	1	1	10	0	4	16	30
Свердловская область	Очно-заочная; Государственные, муниципальные (без учета организаций в ведении ФСИН)	    выбыло по другим причинам / 16.0	0	0	0	5	5	1	0	0	0	1	1	0	0	1	2	75	0	8	66	149
Свердловская область	Очно-заочная; Государственные, муниципальные (без учета организаций в ведении ФСИН)	"    добровольно прекратили образовательные отношения
    (бросили учебу) / 10.0"	9	0	0	5	14	4	0	0	1	5	6	0	0	9	15	52	0	0	312	364
Свердловская область	Очно-заочная; Государственные, муниципальные (без учета организаций в ведении ФСИН)	"    отчислено:
         по неуспеваемости / 11.0"	0	0	0	0	0	0	0	0	0	0	0	0	0	1	1	35	0	3	6	44
Свердловская область	Очно-заочная; Государственные, муниципальные (без учета организаций в ведении ФСИН)	"    переведено в другие образовательные организации
    на программы того же уровня / 8.0"	0	0	0	0	0	0	0	0	0	0	0	0	0	0	0	2	0	0	2	4
Свердловская область	Очно-заочная; Государственные, муниципальные (без учета организаций в ведении ФСИН)	"    переведено из других образовательных организаций 
    с программ того же уровня / 3.0"	0	0	0	0	0	0	0	0	1	1	0	0	0	0	0	4	0	3	14	21
Свердловская область	Очно-заочная; Государственные, муниципальные (без учета организаций в ведении ФСИН)	    по болезни / 9.0	0	0	0	0	0	0	0	0	0	0	0	0	0	0	0	0	0	0	1	1
Свердловская область	Очно-заочная; Государственные, муниципальные (без учета организаций в ведении ФСИН)	    прибыло по другим причинам / 5.0	0	0	0	7	7	0	0	0	0	0	0	0	0	4	4	26	0	1	28	55
Свердловская область	Очно-заочная; Государственные, муниципальные (без учета организаций в ведении ФСИН)	Выбыло студентов - всего (сумма стр. 07-11, 13-15) / 6.0	9	0	0	10	19	5	0	0	1	6	7	0	0	27	34	170	0	11	465	646
Свердловская область	Очно-заочная; Государственные, муниципальные (без учета организаций в ведении ФСИН)	Прибыло студентов - всего (сумма стр. 02-05) / 1.0	2	0	0	7	9	2	0	0	1	3	0	0	0	5	5	69	0	8	113	190
Свердловская область	Очно-заочная; Государственные, муниципальные (без учета организаций в ведении ФСИН)	"Численность студентов на начало прошлого учебного года
(на 1 октября) / 17.0"	85	0	0	72	157	35	0	0	22	57	101	0	0	65	166	1235	0	68	2346	3649
Свердловская область	Частные; Заочная	            из стр. 11 - не прошли итоговую аттестацию / 12.0	0	0	0	0	0	0	0	0	0	0	0	0	0	36	36	0	0	0	17	17
Свердловская область	Частные; Заочная	"            из стр. 11 – лица с ограниченными возможностями здоровья,
            инвалиды, дети-инвалиды / 13.0"	0	0	0	0	0	0	0	0	0	0	0	0	0	0	0	0	0	0	0	0
Свердловская область	Частные; Заочная	         отчислено в виде меры дисциплинарного взыскания / 14.0	0	0	0	0	0	0	0	0	0	0	0	0	0	13	13	0	0	0	0	0
Свердловская область	Частные; Заочная	         отчислено из-за просрочки оплаты обучения / 15.0	0	0	0	0	0	0	0	0	0	0	0	0	0	151	151	0	0	0	78	78
Свердловская область	Частные; Заочная	"    в том числе:
    переведено на другие формы обучения данной
    организации на программы того же уровня / 7.0"	0	0	0	0	0	0	0	0	0	0	0	0	0	148	148	0	0	0	65	65
Свердловская область	Частные; Заочная	"    в том числе:
    переведено с других форм обучения данной
    образовательной организации с программ того же уровня / 2.0"	0	0	0	0	0	0	0	0	0	0	0	0	0	122	122	0	0	0	40	40
Свердловская область	Частные; Заочная	    восстановлены из числа ранее отчисленных / 4.0	0	0	0	0	0	0	0	0	0	0	0	0	0	86	86	0	0	0	41	41
Свердловская область	Частные; Заочная	    выбыло по другим причинам / 16.0	0	0	0	0	0	0	0	0	0	0	0	0	0	127	127	0	0	0	63	63
Свердловская область	Частные; Заочная	"    добровольно прекратили образовательные отношения
    (бросили учебу) / 10.0"	0	0	0	0	0	0	0	0	0	0	0	0	0	119	119	0	0	0	89	89
Свердловская область	Частные; Заочная	"    отчислено:
         по неуспеваемости / 11.0"	0	0	0	0	0	0	0	0	0	0	0	0	0	81	81	0	0	0	102	102
Свердловская область	Частные; Заочная	"    переведено в другие образовательные организации
    на программы того же уровня / 8.0"	0	0	0	0	0	0	0	0	0	0	0	0	0	59	59	0	0	0	51	51
Свердловская область	Частные; Заочная	"    переведено из других образовательных организаций 
    с программ того же уровня / 3.0"	0	0	0	0	0	0	0	0	0	0	0	0	0	118	118	0	0	0	34	34
Свердловская область	Частные; Заочная	    по болезни / 9.0	0	0	0	0	0	0	0	0	0	0	0	0	0	0	0	0	0	0	0	0
Свердловская область	Частные; Заочная	    прибыло по другим причинам / 5.0	0	0	0	0	0	0	0	0	0	0	0	0	0	168	168	0	0	0	105	105
Свердловская область	Частные; Заочная	Выбыло студентов - всего (сумма стр. 07-11, 13-15) / 6.0	0	0	0	0	0	0	0	0	0	0	0	0	0	698	698	0	0	0	448	448
Свердловская область	Частные; Заочная	Прибыло студентов - всего (сумма стр. 02-05) / 1.0	0	0	0	0	0	0	0	0	0	0	0	0	0	494	494	0	0	0	220	220
Свердловская область	Частные; Заочная	"Численность студентов на начало прошлого учебного года
(на 1 октября) / 17.0"	0	0	0	0	0	0	0	0	0	0	0	0	0	1492	1492	0	0	0	1220	1220
Свердловская область	Частные; Очная	            из стр. 11 - не прошли итоговую аттестацию / 12.0	0	0	0	0	0	0	0	0	0	0	0	0	0	0	0	0	0	0	0	0
Свердловская область	Частные; Очная	"            из стр. 11 – лица с ограниченными возможностями здоровья,
            инвалиды, дети-инвалиды / 13.0"	0	0	0	0	0	0	0	0	0	0	0	0	0	0	0	0	0	0	0	0
Свердловская область	Частные; Очная	         отчислено в виде меры дисциплинарного взыскания / 14.0	0	0	0	0	0	0	0	0	0	0	0	0	0	0	0	0	0	0	0	0
Свердловская область	Частные; Очная	         отчислено из-за просрочки оплаты обучения / 15.0	0	0	0	0	0	0	0	0	0	0	0	0	0	71	71	0	0	0	18	18
Свердловская область	Частные; Очная	"    в том числе:
    переведено на другие формы обучения данной
    организации на программы того же уровня / 7.0"	0	0	0	0	0	0	0	0	0	0	0	0	0	185	185	0	0	0	24	24
Свердловская область	Частные; Очная	"    в том числе:
    переведено с других форм обучения данной
    образовательной организации с программ того же уровня / 2.0"	0	0	0	0	0	0	0	0	0	0	0	0	0	119	119	0	0	0	6	6
Свердловская область	Частные; Очная	    восстановлены из числа ранее отчисленных / 4.0	0	0	0	0	0	0	0	0	0	0	0	0	0	36	36	0	0	0	4	4
Свердловская область	Частные; Очная	    выбыло по другим причинам / 16.0	0	0	0	11	11	0	0	0	0	0	0	0	0	31	31	0	0	0	10	10
Свердловская область	Частные; Очная	"    добровольно прекратили образовательные отношения
    (бросили учебу) / 10.0"	0	0	0	0	0	0	0	0	0	0	0	0	0	198	198	0	0	0	51	51
Свердловская область	Частные; Очная	"    отчислено:
         по неуспеваемости / 11.0"	0	0	0	0	0	0	0	0	0	0	0	0	0	65	65	0	0	0	2	2
Свердловская область	Частные; Очная	"    переведено в другие образовательные организации
    на программы того же уровня / 8.0"	0	0	0	0	0	0	0	0	0	0	0	0	0	91	91	0	0	0	40	40
Свердловская область	Частные; Очная	"    переведено из других образовательных организаций 
    с программ того же уровня / 3.0"	0	0	0	0	0	0	0	0	0	0	0	0	0	124	124	0	0	0	28	28
Свердловская область	Частные; Очная	    по болезни / 9.0	0	0	0	0	0	0	0	0	0	0	0	0	0	1	1	0	0	0	0	0
Свердловская область	Частные; Очная	    прибыло по другим причинам / 5.0	0	0	0	0	0	0	0	0	0	0	0	0	0	57	57	0	0	0	27	27
Свердловская область	Частные; Очная	Выбыло студентов - всего (сумма стр. 07-11, 13-15) / 6.0	0	0	0	11	11	0	0	0	0	0	0	0	0	642	642	0	0	0	145	145
Свердловская область	Частные; Очная	Прибыло студентов - всего (сумма стр. 02-05) / 1.0	0	0	0	0	0	0	0	0	0	0	0	0	0	336	336	0	0	0	65	65
Свердловская область	Частные; Очная	"Численность студентов на начало прошлого учебного года
(на 1 октября) / 17.0"	0	0	0	70	70	0	0	0	0	0	0	0	0	2720	2720	0	0	0	633	633
Свердловская область	Частные; Очно-заочная	            из стр. 11 - не прошли итоговую аттестацию / 12.0	0	0	0	0	0	0	0	0	0	0	0	0	0	0	0	0	0	0	0	0
Свердловская область	Частные; Очно-заочная	"            из стр. 11 – лица с ограниченными возможностями здоровья,
            инвалиды, дети-инвалиды / 13.0"	0	0	0	0	0	0	0	0	0	0	0	0	0	0	0	0	0	0	0	0
Свердловская область	Частные; Очно-заочная	         отчислено в виде меры дисциплинарного взыскания / 14.0	0	0	0	0	0	0	0	0	0	0	0	0	0	0	0	0	0	0	0	0
Свердловская область	Частные; Очно-заочная	         отчислено из-за просрочки оплаты обучения / 15.0	0	0	0	0	0	0	0	0	0	0	0	0	0	1	1	0	0	0	18	18
Свердловская область	Частные; Очно-заочная	"    в том числе:
    переведено на другие формы обучения данной
    организации на программы того же уровня / 7.0"	0	0	0	0	0	0	0	0	0	0	0	0	0	0	0	0	0	0	0	0
Свердловская область	Частные; Очно-заочная	"    в том числе:
    переведено с других форм обучения данной
    образовательной организации с программ того же уровня / 2.0"	0	0	0	0	0	0	0	0	0	0	0	0	0	1	1	0	0	0	2	2
Свердловская область	Частные; Очно-заочная	    восстановлены из числа ранее отчисленных / 4.0	0	0	0	0	0	0	0	0	0	0	0	0	0	6	6	0	0	0	7	7
Свердловская область	Частные; Очно-заочная	    выбыло по другим причинам / 16.0	0	0	0	0	0	0	0	0	0	0	0	0	0	0	0	0	0	0	5	5
Свердловская область	Частные; Очно-заочная	"    добровольно прекратили образовательные отношения
    (бросили учебу) / 10.0"	0	0	0	0	0	0	0	0	0	0	0	0	0	3	3	0	0	0	9	9
Свердловская область	Частные; Очно-заочная	"    отчислено:
         по неуспеваемости / 11.0"	0	0	0	0	0	0	0	0	0	0	0	0	0	0	0	0	0	0	19	19
Свердловская область	Частные; Очно-заочная	"    переведено в другие образовательные организации
    на программы того же уровня / 8.0"	0	0	0	0	0	0	0	0	0	0	0	0	0	0	0	0	0	0	0	0
Свердловская область	Частные; Очно-заочная	"    переведено из других образовательных организаций 
    с программ того же уровня / 3.0"	0	0	0	0	0	0	0	0	0	0	0	0	0	0	0	0	0	0	66	66
Свердловская область	Частные; Очно-заочная	    по болезни / 9.0	0	0	0	0	0	0	0	0	0	0	0	0	0	0	0	0	0	0	3	3
Свердловская область	Частные; Очно-заочная	    прибыло по другим причинам / 5.0	0	0	0	0	0	0	0	0	0	0	0	0	0	0	0	0	0	0	0	0
Свердловская область	Частные; Очно-заочная	Выбыло студентов - всего (сумма стр. 07-11, 13-15) / 6.0	0	0	0	0	0	0	0	0	0	0	0	0	0	4	4	0	0	0	54	54
Свердловская область	Частные; Очно-заочная	Прибыло студентов - всего (сумма стр. 02-05) / 1.0	0	0	0	0	0	0	0	0	0	0	0	0	0	7	7	0	0	0	75	75
Свердловская область	Частные; Очно-заочная	"Численность студентов на начало прошлого учебного года
(на 1 октября) / 17.0"	0	0	0	0	0	0	0	0	0	0	0	0	0	0	0	0	0	0	231	231
Смоленская область	Государственные, муниципальные (без учета организаций в ведении ФСИН); Заочная	            из стр. 11 - не прошли итоговую аттестацию / 12.0	0	0	0	0	0	0	0	0	0	0	0	0	0	0	0	5	0	0	1	6
Смоленская область	Государственные, муниципальные (без учета организаций в ведении ФСИН); Заочная	"            из стр. 11 – лица с ограниченными возможностями здоровья,
            инвалиды, дети-инвалиды / 13.0"	0	0	0	0	0	0	0	0	0	0	0	0	0	0	0	0	0	0	0	0
Смоленская область	Государственные, муниципальные (без учета организаций в ведении ФСИН); Заочная	         отчислено в виде меры дисциплинарного взыскания / 14.0	0	0	0	0	0	0	0	0	0	0	0	0	0	0	0	0	0	0	0	0
Смоленская область	Государственные, муниципальные (без учета организаций в ведении ФСИН); Заочная	         отчислено из-за просрочки оплаты обучения / 15.0	0	0	0	0	0	0	0	0	0	0	0	0	0	9	9	0	0	0	3	3
Смоленская область	Государственные, муниципальные (без учета организаций в ведении ФСИН); Заочная	"    в том числе:
    переведено на другие формы обучения данной
    организации на программы того же уровня / 7.0"	0	0	0	0	0	0	0	0	0	0	0	0	0	0	0	7	0	0	4	11
Смоленская область	Государственные, муниципальные (без учета организаций в ведении ФСИН); Заочная	"    в том числе:
    переведено с других форм обучения данной
    образовательной организации с программ того же уровня / 2.0"	0	0	0	0	0	0	0	0	0	0	0	0	0	13	13	29	0	2	10	41
Смоленская область	Государственные, муниципальные (без учета организаций в ведении ФСИН); Заочная	    восстановлены из числа ранее отчисленных / 4.0	0	0	0	0	0	0	0	0	0	0	0	0	0	8	8	8	0	0	8	16
Смоленская область	Государственные, муниципальные (без учета организаций в ведении ФСИН); Заочная	    выбыло по другим причинам / 16.0	0	0	0	0	0	0	0	0	0	0	0	0	0	14	14	34	0	0	14	48
Смоленская область	Государственные, муниципальные (без учета организаций в ведении ФСИН); Заочная	"    добровольно прекратили образовательные отношения
    (бросили учебу) / 10.0"	0	0	0	0	0	0	0	0	0	0	0	0	1	31	32	93	0	11	18	122
Смоленская область	Государственные, муниципальные (без учета организаций в ведении ФСИН); Заочная	"    отчислено:
         по неуспеваемости / 11.0"	0	0	0	0	0	0	0	0	0	0	0	0	2	22	24	65	0	3	19	87
Смоленская область	Государственные, муниципальные (без учета организаций в ведении ФСИН); Заочная	"    переведено в другие образовательные организации
    на программы того же уровня / 8.0"	0	0	0	0	0	0	0	0	0	0	0	0	13	18	31	1	0	1	8	10
Смоленская область	Государственные, муниципальные (без учета организаций в ведении ФСИН); Заочная	"    переведено из других образовательных организаций 
    с программ того же уровня / 3.0"	0	0	0	0	0	0	0	0	0	0	0	0	0	4	4	1	0	1	1	3
Смоленская область	Государственные, муниципальные (без учета организаций в ведении ФСИН); Заочная	    по болезни / 9.0	0	0	0	0	0	0	0	0	0	0	0	0	0	0	0	5	0	0	0	5
Смоленская область	Государственные, муниципальные (без учета организаций в ведении ФСИН); Заочная	    прибыло по другим причинам / 5.0	0	0	0	0	0	0	0	0	0	0	0	0	0	7	7	11	0	3	8	22
Смоленская область	Государственные, муниципальные (без учета организаций в ведении ФСИН); Заочная	Выбыло студентов - всего (сумма стр. 07-11, 13-15) / 6.0	0	0	0	0	0	0	0	0	0	0	0	0	16	94	110	205	0	15	66	286
Смоленская область	Государственные, муниципальные (без учета организаций в ведении ФСИН); Заочная	Прибыло студентов - всего (сумма стр. 02-05) / 1.0	0	0	0	0	0	0	0	0	0	0	0	0	0	32	32	49	0	6	27	82
Смоленская область	Государственные, муниципальные (без учета организаций в ведении ФСИН); Заочная	"Численность студентов на начало прошлого учебного года
(на 1 октября) / 17.0"	0	0	0	0	0	0	0	0	0	0	0	0	63	402	465	1434	0	112	387	1933
Смоленская область	Государственные, муниципальные (без учета организаций в ведении ФСИН); Очная	            из стр. 11 - не прошли итоговую аттестацию / 12.0	5	0	0	0	5	0	0	0	0	0	8	0	0	3	11	2	0	0	0	2
Смоленская область	Государственные, муниципальные (без учета организаций в ведении ФСИН); Очная	"            из стр. 11 – лица с ограниченными возможностями здоровья,
            инвалиды, дети-инвалиды / 13.0"	0	0	0	0	0	0	0	0	0	0	0	0	0	0	0	0	0	0	0	0
Смоленская область	Государственные, муниципальные (без учета организаций в ведении ФСИН); Очная	         отчислено в виде меры дисциплинарного взыскания / 14.0	0	0	0	0	0	0	0	0	0	0	2	0	0	0	2	0	0	0	0	0
Смоленская область	Государственные, муниципальные (без учета организаций в ведении ФСИН); Очная	         отчислено из-за просрочки оплаты обучения / 15.0	0	0	0	2	2	0	0	0	0	0	0	0	0	19	19	0	0	0	0	0
Смоленская область	Государственные, муниципальные (без учета организаций в ведении ФСИН); Очная	"    в том числе:
    переведено на другие формы обучения данной
    организации на программы того же уровня / 7.0"	6	0	0	10	16	0	0	0	0	0	68	0	4	41	113	11	0	0	9	20
Смоленская область	Государственные, муниципальные (без учета организаций в ведении ФСИН); Очная	"    в том числе:
    переведено с других форм обучения данной
    образовательной организации с программ того же уровня / 2.0"	35	0	0	0	35	0	0	0	0	0	47	0	8	14	69	10	0	0	0	10
Смоленская область	Государственные, муниципальные (без учета организаций в ведении ФСИН); Очная	    восстановлены из числа ранее отчисленных / 4.0	8	0	0	5	13	0	0	0	0	0	38	0	2	26	66	8	0	0	31	39
Смоленская область	Государственные, муниципальные (без учета организаций в ведении ФСИН); Очная	    выбыло по другим причинам / 16.0	73	0	0	6	79	1	0	0	0	1	97	0	7	40	144	16	0	1	1	18
Смоленская область	Государственные, муниципальные (без учета организаций в ведении ФСИН); Очная	"    добровольно прекратили образовательные отношения
    (бросили учебу) / 10.0"	160	0	0	19	179	6	0	0	2	8	373	0	42	163	578	102	0	1	32	135
Смоленская область	Государственные, муниципальные (без учета организаций в ведении ФСИН); Очная	"    отчислено:
         по неуспеваемости / 11.0"	121	0	0	9	130	1	0	0	0	1	193	0	12	49	254	23	0	3	9	35
Смоленская область	Государственные, муниципальные (без учета организаций в ведении ФСИН); Очная	"    переведено в другие образовательные организации
    на программы того же уровня / 8.0"	36	0	0	0	36	0	0	0	0	0	117	0	7	40	164	5	0	1	2	8
Смоленская область	Государственные, муниципальные (без учета организаций в ведении ФСИН); Очная	"    переведено из других образовательных организаций 
    с программ того же уровня / 3.0"	25	0	0	3	28	0	0	0	0	0	82	0	3	24	109	6	0	0	6	12
Смоленская область	Государственные, муниципальные (без учета организаций в ведении ФСИН); Очная	    по болезни / 9.0	2	0	0	0	2	0	0	0	0	0	8	0	0	0	8	0	0	0	0	0
Смоленская область	Государственные, муниципальные (без учета организаций в ведении ФСИН); Очная	    прибыло по другим причинам / 5.0	11	0	0	6	17	1	0	0	5	6	46	0	6	25	77	1	0	0	0	1
Смоленская область	Государственные, муниципальные (без учета организаций в ведении ФСИН); Очная	Выбыло студентов - всего (сумма стр. 07-11, 13-15) / 6.0	398	0	0	46	444	8	0	0	2	10	858	0	72	352	1282	157	0	6	53	216
Смоленская область	Государственные, муниципальные (без учета организаций в ведении ФСИН); Очная	Прибыло студентов - всего (сумма стр. 02-05) / 1.0	79	0	0	14	93	1	0	0	5	6	213	0	19	89	321	25	0	0	37	62
Смоленская область	Государственные, муниципальные (без учета организаций в ведении ФСИН); Очная	"Численность студентов на начало прошлого учебного года
(на 1 октября) / 17.0"	3621	0	0	255	3876	72	0	0	16	88	7608	0	1108	2158	10874	1103	0	86	687	1876
Смоленская область	Очно-заочная; Государственные, муниципальные (без учета организаций в ведении ФСИН)	            из стр. 11 - не прошли итоговую аттестацию / 12.0	0	0	0	0	0	0	0	0	0	0	0	0	0	0	0	0	0	0	0	0
Смоленская область	Очно-заочная; Государственные, муниципальные (без учета организаций в ведении ФСИН)	"            из стр. 11 – лица с ограниченными возможностями здоровья,
            инвалиды, дети-инвалиды / 13.0"	0	0	0	0	0	0	0	0	0	0	0	0	0	0	0	0	0	0	0	0
Смоленская область	Очно-заочная; Государственные, муниципальные (без учета организаций в ведении ФСИН)	         отчислено в виде меры дисциплинарного взыскания / 14.0	0	0	0	0	0	0	0	0	0	0	0	0	0	0	0	0	0	0	0	0
Смоленская область	Очно-заочная; Государственные, муниципальные (без учета организаций в ведении ФСИН)	         отчислено из-за просрочки оплаты обучения / 15.0	0	0	0	0	0	0	0	0	0	0	0	0	0	0	0	0	0	0	0	0
Смоленская область	Очно-заочная; Государственные, муниципальные (без учета организаций в ведении ФСИН)	"    в том числе:
    переведено на другие формы обучения данной
    организации на программы того же уровня / 7.0"	0	0	0	0	0	0	0	0	0	0	0	0	0	0	0	0	0	0	3	3
Смоленская область	Очно-заочная; Государственные, муниципальные (без учета организаций в ведении ФСИН)	"    в том числе:
    переведено с других форм обучения данной
    образовательной организации с программ того же уровня / 2.0"	0	0	0	0	0	0	0	0	0	0	0	0	0	0	0	3	0	0	0	3
Смоленская область	Очно-заочная; Государственные, муниципальные (без учета организаций в ведении ФСИН)	    восстановлены из числа ранее отчисленных / 4.0	0	0	0	0	0	0	0	0	0	0	0	0	0	0	0	0	0	0	0	0
Смоленская область	Очно-заочная; Государственные, муниципальные (без учета организаций в ведении ФСИН)	    выбыло по другим причинам / 16.0	0	0	0	0	0	0	0	0	0	0	0	0	0	0	0	0	0	0	0	0
Смоленская область	Очно-заочная; Государственные, муниципальные (без учета организаций в ведении ФСИН)	"    добровольно прекратили образовательные отношения
    (бросили учебу) / 10.0"	0	0	0	0	0	0	0	0	0	0	0	0	0	2	2	7	0	0	5	12
Смоленская область	Очно-заочная; Государственные, муниципальные (без учета организаций в ведении ФСИН)	"    отчислено:
         по неуспеваемости / 11.0"	0	0	0	0	0	0	0	0	0	0	0	0	0	0	0	11	0	0	2	13
Смоленская область	Очно-заочная; Государственные, муниципальные (без учета организаций в ведении ФСИН)	"    переведено в другие образовательные организации
    на программы того же уровня / 8.0"	0	0	0	0	0	0	0	0	0	0	0	0	0	0	0	0	0	0	0	0
Смоленская область	Очно-заочная; Государственные, муниципальные (без учета организаций в ведении ФСИН)	"    переведено из других образовательных организаций 
    с программ того же уровня / 3.0"	0	0	0	0	0	0	0	0	0	0	0	0	0	0	0	0	0	0	0	0
Смоленская область	Очно-заочная; Государственные, муниципальные (без учета организаций в ведении ФСИН)	    по болезни / 9.0	0	0	0	0	0	0	0	0	0	0	0	0	0	0	0	0	0	0	0	0
Смоленская область	Очно-заочная; Государственные, муниципальные (без учета организаций в ведении ФСИН)	    прибыло по другим причинам / 5.0	0	0	0	0	0	0	0	0	0	0	0	0	0	0	0	0	0	0	0	0
Смоленская область	Очно-заочная; Государственные, муниципальные (без учета организаций в ведении ФСИН)	Выбыло студентов - всего (сумма стр. 07-11, 13-15) / 6.0	0	0	0	0	0	0	0	0	0	0	0	0	0	2	2	18	0	0	10	28
Смоленская область	Очно-заочная; Государственные, муниципальные (без учета организаций в ведении ФСИН)	Прибыло студентов - всего (сумма стр. 02-05) / 1.0	0	0	0	0	0	0	0	0	0	0	0	0	0	0	0	3	0	0	0	3
Смоленская область	Очно-заочная; Государственные, муниципальные (без учета организаций в ведении ФСИН)	"Численность студентов на начало прошлого учебного года
(на 1 октября) / 17.0"	0	0	0	0	0	0	0	0	0	0	0	0	0	45	45	92	0	0	125	217
Смоленская область	Частные; Заочная	            из стр. 11 - не прошли итоговую аттестацию / 12.0	0	0	0	0	0	0	0	0	0	0	0	0	0	0	0	0	0	0	0	0
Смоленская область	Частные; Заочная	"            из стр. 11 – лица с ограниченными возможностями здоровья,
            инвалиды, дети-инвалиды / 13.0"	0	0	0	0	0	0	0	0	0	0	0	0	0	0	0	0	0	0	0	0
Смоленская область	Частные; Заочная	         отчислено в виде меры дисциплинарного взыскания / 14.0	0	0	0	0	0	0	0	0	0	0	0	0	0	0	0	0	0	0	0	0
Смоленская область	Частные; Заочная	         отчислено из-за просрочки оплаты обучения / 15.0	0	0	0	0	0	0	0	0	0	0	0	0	0	0	0	0	0	0	0	0
Смоленская область	Частные; Заочная	"    в том числе:
    переведено на другие формы обучения данной
    организации на программы того же уровня / 7.0"	0	0	0	0	0	0	0	0	0	0	0	0	0	0	0	0	0	0	0	0
Смоленская область	Частные; Заочная	"    в том числе:
    переведено с других форм обучения данной
    образовательной организации с программ того же уровня / 2.0"	0	0	0	0	0	0	0	0	0	0	0	0	0	17	17	0	0	0	25	25
Смоленская область	Частные; Заочная	    восстановлены из числа ранее отчисленных / 4.0	0	0	0	0	0	0	0	0	0	0	0	0	0	6	6	0	0	0	0	0
Смоленская область	Частные; Заочная	    выбыло по другим причинам / 16.0	0	0	0	0	0	0	0	0	0	0	0	0	0	0	0	0	0	0	0	0
Смоленская область	Частные; Заочная	"    добровольно прекратили образовательные отношения
    (бросили учебу) / 10.0"	0	0	0	0	0	0	0	0	0	0	0	0	0	0	0	0	0	0	7	7
Смоленская область	Частные; Заочная	"    отчислено:
         по неуспеваемости / 11.0"	0	0	0	0	0	0	0	0	0	0	0	0	0	24	24	0	0	0	22	22
Смоленская область	Частные; Заочная	"    переведено в другие образовательные организации
    на программы того же уровня / 8.0"	0	0	0	0	0	0	0	0	0	0	0	0	0	0	0	0	0	0	0	0
Смоленская область	Частные; Заочная	"    переведено из других образовательных организаций 
    с программ того же уровня / 3.0"	0	0	0	0	0	0	0	0	0	0	0	0	0	3	3	0	0	0	12	12
Смоленская область	Частные; Заочная	    по болезни / 9.0	0	0	0	0	0	0	0	0	0	0	0	0	0	0	0	0	0	0	0	0
Смоленская область	Частные; Заочная	    прибыло по другим причинам / 5.0	0	0	0	0	0	0	0	0	0	0	0	0	0	7	7	0	0	0	0	0
Смоленская область	Частные; Заочная	Выбыло студентов - всего (сумма стр. 07-11, 13-15) / 6.0	0	0	0	0	0	0	0	0	0	0	0	0	0	24	24	0	0	0	29	29
Смоленская область	Частные; Заочная	Прибыло студентов - всего (сумма стр. 02-05) / 1.0	0	0	0	0	0	0	0	0	0	0	0	0	0	33	33	0	0	0	37	37
Смоленская область	Частные; Заочная	"Численность студентов на начало прошлого учебного года
(на 1 октября) / 17.0"	0	0	0	0	0	0	0	0	0	0	0	0	0	355	355	0	0	0	236	236
Смоленская область	Частные; Очная	            из стр. 11 - не прошли итоговую аттестацию / 12.0	0	0	0	0	0	0	0	0	0	0	0	0	0	0	0	0	0	0	0	0
Смоленская область	Частные; Очная	"            из стр. 11 – лица с ограниченными возможностями здоровья,
            инвалиды, дети-инвалиды / 13.0"	0	0	0	0	0	0	0	0	0	0	0	0	0	0	0	0	0	0	0	0
Смоленская область	Частные; Очная	         отчислено в виде меры дисциплинарного взыскания / 14.0	0	0	0	0	0	0	0	0	0	0	0	0	0	0	0	0	0	0	0	0
Смоленская область	Частные; Очная	         отчислено из-за просрочки оплаты обучения / 15.0	0	0	0	0	0	0	0	0	0	0	0	0	0	26	26	0	0	0	0	0
Смоленская область	Частные; Очная	"    в том числе:
    переведено на другие формы обучения данной
    организации на программы того же уровня / 7.0"	0	0	0	0	0	0	0	0	0	0	0	0	0	32	32	0	0	0	27	27
Смоленская область	Частные; Очная	"    в том числе:
    переведено с других форм обучения данной
    образовательной организации с программ того же уровня / 2.0"	0	0	0	0	0	0	0	0	0	0	0	0	0	10	10	0	0	0	1	1
Смоленская область	Частные; Очная	    восстановлены из числа ранее отчисленных / 4.0	0	0	0	0	0	0	0	0	0	0	0	0	0	5	5	0	0	0	4	4
Смоленская область	Частные; Очная	    выбыло по другим причинам / 16.0	0	0	0	0	0	0	0	0	0	0	0	0	0	17	17	0	0	0	2	2
Смоленская область	Частные; Очная	"    добровольно прекратили образовательные отношения
    (бросили учебу) / 10.0"	0	0	0	0	0	0	0	0	0	0	0	0	0	33	33	0	0	0	0	0
Смоленская область	Частные; Очная	"    отчислено:
         по неуспеваемости / 11.0"	0	0	0	0	0	0	0	0	0	0	0	0	0	65	65	0	0	0	11	11
Смоленская область	Частные; Очная	"    переведено в другие образовательные организации
    на программы того же уровня / 8.0"	0	0	0	0	0	0	0	0	0	0	0	0	0	23	23	0	0	0	0	0
Смоленская область	Частные; Очная	"    переведено из других образовательных организаций 
    с программ того же уровня / 3.0"	0	0	0	0	0	0	0	0	0	0	0	0	0	38	38	0	0	0	9	9
Смоленская область	Частные; Очная	    по болезни / 9.0	0	0	0	0	0	0	0	0	0	0	0	0	0	1	1	0	0	0	0	0
Смоленская область	Частные; Очная	    прибыло по другим причинам / 5.0	0	0	0	0	0	0	0	0	0	0	0	0	0	0	0	0	0	0	0	0
Смоленская область	Частные; Очная	Выбыло студентов - всего (сумма стр. 07-11, 13-15) / 6.0	0	0	0	0	0	0	0	0	0	0	0	0	0	197	197	0	0	0	40	40
Смоленская область	Частные; Очная	Прибыло студентов - всего (сумма стр. 02-05) / 1.0	0	0	0	0	0	0	0	0	0	0	0	0	0	53	53	0	0	0	14	14
Смоленская область	Частные; Очная	"Численность студентов на начало прошлого учебного года
(на 1 октября) / 17.0"	0	0	0	0	0	0	0	0	0	0	0	74	0	1737	1811	0	0	0	384	384
Смоленская область	Частные; Очно-заочная	            из стр. 11 - не прошли итоговую аттестацию / 12.0	0	0	0	0	0	0	0	0	0	0	0	0	0	0	0	0	0	0	0	0
Смоленская область	Частные; Очно-заочная	"            из стр. 11 – лица с ограниченными возможностями здоровья,
            инвалиды, дети-инвалиды / 13.0"	0	0	0	0	0	0	0	0	0	0	0	0	0	0	0	0	0	0	0	0
Смоленская область	Частные; Очно-заочная	         отчислено в виде меры дисциплинарного взыскания / 14.0	0	0	0	0	0	0	0	0	0	0	0	0	0	0	0	0	0	0	0	0
Смоленская область	Частные; Очно-заочная	         отчислено из-за просрочки оплаты обучения / 15.0	0	0	0	0	0	0	0	0	0	0	0	0	0	0	0	0	0	0	0	0
Смоленская область	Частные; Очно-заочная	"    в том числе:
    переведено на другие формы обучения данной
    организации на программы того же уровня / 7.0"	0	0	0	0	0	0	0	0	0	0	0	0	0	0	0	0	0	0	0	0
Смоленская область	Частные; Очно-заочная	"    в том числе:
    переведено с других форм обучения данной
    образовательной организации с программ того же уровня / 2.0"	0	0	0	0	0	0	0	0	0	0	0	0	0	12	12	0	0	0	2	2
Смоленская область	Частные; Очно-заочная	    восстановлены из числа ранее отчисленных / 4.0	0	0	0	0	0	0	0	0	0	0	0	0	0	0	0	0	0	0	0	0
Смоленская область	Частные; Очно-заочная	    выбыло по другим причинам / 16.0	0	0	0	0	0	0	0	0	0	0	0	0	0	0	0	0	0	0	0	0
Смоленская область	Частные; Очно-заочная	"    добровольно прекратили образовательные отношения
    (бросили учебу) / 10.0"	0	0	0	0	0	0	0	0	0	0	0	0	0	1	1	0	0	0	0	0
Смоленская область	Частные; Очно-заочная	"    отчислено:
         по неуспеваемости / 11.0"	0	0	0	0	0	0	0	0	0	0	0	0	0	1	1	0	0	0	0	0
Смоленская область	Частные; Очно-заочная	"    переведено в другие образовательные организации
    на программы того же уровня / 8.0"	0	0	0	0	0	0	0	0	0	0	0	0	0	0	0	0	0	0	0	0
Смоленская область	Частные; Очно-заочная	"    переведено из других образовательных организаций 
    с программ того же уровня / 3.0"	0	0	0	0	0	0	0	0	0	0	0	0	0	0	0	0	0	0	0	0
Смоленская область	Частные; Очно-заочная	    по болезни / 9.0	0	0	0	0	0	0	0	0	0	0	0	0	0	0	0	0	0	0	0	0
Смоленская область	Частные; Очно-заочная	    прибыло по другим причинам / 5.0	0	0	0	0	0	0	0	0	0	0	0	0	0	0	0	0	0	0	0	0
Смоленская область	Частные; Очно-заочная	Выбыло студентов - всего (сумма стр. 07-11, 13-15) / 6.0	0	0	0	0	0	0	0	0	0	0	0	0	0	2	2	0	0	0	0	0
Смоленская область	Частные; Очно-заочная	Прибыло студентов - всего (сумма стр. 02-05) / 1.0	0	0	0	0	0	0	0	0	0	0	0	0	0	12	12	0	0	0	2	2
Смоленская область	Частные; Очно-заочная	"Численность студентов на начало прошлого учебного года
(на 1 октября) / 17.0"	0	0	0	0	0	0	0	0	0	0	0	0	0	43	43	0	0	0	20	20
Ставропольский край	Государственные, муниципальные (без учета организаций в ведении ФСИН); Заочная	            из стр. 11 - не прошли итоговую аттестацию / 12.0	0	0	0	0	0	0	0	0	0	0	0	0	0	0	0	1	0	0	2	3
Ставропольский край	Государственные, муниципальные (без учета организаций в ведении ФСИН); Заочная	"            из стр. 11 – лица с ограниченными возможностями здоровья,
            инвалиды, дети-инвалиды / 13.0"	0	0	0	0	0	0	0	0	0	0	0	0	0	0	0	0	0	0	0	0
Ставропольский край	Государственные, муниципальные (без учета организаций в ведении ФСИН); Заочная	         отчислено в виде меры дисциплинарного взыскания / 14.0	0	0	0	0	0	0	0	0	0	0	0	0	0	0	0	0	0	0	0	0
Ставропольский край	Государственные, муниципальные (без учета организаций в ведении ФСИН); Заочная	         отчислено из-за просрочки оплаты обучения / 15.0	0	0	0	0	0	0	0	0	0	0	0	0	0	28	28	0	0	0	22	22
Ставропольский край	Государственные, муниципальные (без учета организаций в ведении ФСИН); Заочная	"    в том числе:
    переведено на другие формы обучения данной
    организации на программы того же уровня / 7.0"	0	0	0	0	0	0	0	0	0	0	0	0	0	6	6	11	0	0	11	22
Ставропольский край	Государственные, муниципальные (без учета организаций в ведении ФСИН); Заочная	"    в том числе:
    переведено с других форм обучения данной
    образовательной организации с программ того же уровня / 2.0"	0	0	0	0	0	0	0	0	0	0	1	0	0	71	72	13	0	0	29	42
Ставропольский край	Государственные, муниципальные (без учета организаций в ведении ФСИН); Заочная	    восстановлены из числа ранее отчисленных / 4.0	0	0	0	0	0	0	0	0	0	0	2	0	0	12	14	10	0	0	34	44
Ставропольский край	Государственные, муниципальные (без учета организаций в ведении ФСИН); Заочная	    выбыло по другим причинам / 16.0	0	0	0	0	0	0	0	0	0	0	4	0	0	8	12	41	0	0	30	71
Ставропольский край	Государственные, муниципальные (без учета организаций в ведении ФСИН); Заочная	"    добровольно прекратили образовательные отношения
    (бросили учебу) / 10.0"	0	0	0	0	0	0	0	0	0	0	0	0	0	27	27	26	0	0	15	41
Ставропольский край	Государственные, муниципальные (без учета организаций в ведении ФСИН); Заочная	"    отчислено:
         по неуспеваемости / 11.0"	0	0	0	0	0	0	0	0	0	0	0	0	0	25	25	52	0	0	22	74
Ставропольский край	Государственные, муниципальные (без учета организаций в ведении ФСИН); Заочная	"    переведено в другие образовательные организации
    на программы того же уровня / 8.0"	0	0	0	0	0	0	0	0	0	0	0	0	0	4	4	5	0	0	1	6
Ставропольский край	Государственные, муниципальные (без учета организаций в ведении ФСИН); Заочная	"    переведено из других образовательных организаций 
    с программ того же уровня / 3.0"	0	0	0	0	0	0	0	0	0	0	0	0	0	8	8	0	0	0	1	1
Ставропольский край	Государственные, муниципальные (без учета организаций в ведении ФСИН); Заочная	    по болезни / 9.0	0	0	0	0	0	0	0	0	0	0	0	0	0	0	0	2	0	0	0	2
Ставропольский край	Государственные, муниципальные (без учета организаций в ведении ФСИН); Заочная	    прибыло по другим причинам / 5.0	0	0	0	0	0	0	0	0	0	0	0	0	0	21	21	7	0	0	14	21
Ставропольский край	Государственные, муниципальные (без учета организаций в ведении ФСИН); Заочная	Выбыло студентов - всего (сумма стр. 07-11, 13-15) / 6.0	0	0	0	0	0	0	0	0	0	0	4	0	0	98	102	137	0	0	101	238
Ставропольский край	Государственные, муниципальные (без учета организаций в ведении ФСИН); Заочная	Прибыло студентов - всего (сумма стр. 02-05) / 1.0	0	0	0	0	0	0	0	0	0	0	3	0	0	112	115	30	0	0	78	108
Ставропольский край	Государственные, муниципальные (без учета организаций в ведении ФСИН); Заочная	"Численность студентов на начало прошлого учебного года
(на 1 октября) / 17.0"	0	0	0	0	0	0	0	0	0	0	119	0	0	793	912	1084	0	0	874	1958
Ставропольский край	Государственные, муниципальные (без учета организаций в ведении ФСИН); Очная	            из стр. 11 - не прошли итоговую аттестацию / 12.0	7	0	0	0	7	0	0	0	0	0	2	0	1	4	7	0	0	4	2	6
Ставропольский край	Государственные, муниципальные (без учета организаций в ведении ФСИН); Очная	"            из стр. 11 – лица с ограниченными возможностями здоровья,
            инвалиды, дети-инвалиды / 13.0"	1	0	0	0	1	0	0	0	0	0	0	0	2	2	4	0	0	4	0	4
Ставропольский край	Государственные, муниципальные (без учета организаций в ведении ФСИН); Очная	         отчислено в виде меры дисциплинарного взыскания / 14.0	3	0	0	0	3	0	0	0	1	1	9	0	0	11	20	0	0	0	0	0
Ставропольский край	Государственные, муниципальные (без учета организаций в ведении ФСИН); Очная	         отчислено из-за просрочки оплаты обучения / 15.0	0	0	0	1	1	0	0	0	1	1	0	0	0	13	13	0	0	0	4	4
Ставропольский край	Государственные, муниципальные (без учета организаций в ведении ФСИН); Очная	"    в том числе:
    переведено на другие формы обучения данной
    организации на программы того же уровня / 7.0"	13	0	0	0	13	0	0	0	0	0	202	0	0	150	352	2	0	1	22	25
Ставропольский край	Государственные, муниципальные (без учета организаций в ведении ФСИН); Очная	"    в том числе:
    переведено с других форм обучения данной
    образовательной организации с программ того же уровня / 2.0"	19	0	0	0	19	0	0	0	0	0	186	0	0	34	220	18	0	0	4	22
Ставропольский край	Государственные, муниципальные (без учета организаций в ведении ФСИН); Очная	    восстановлены из числа ранее отчисленных / 4.0	40	0	0	1	41	0	0	0	0	0	126	0	0	62	188	5	0	7	18	30
Ставропольский край	Государственные, муниципальные (без учета организаций в ведении ФСИН); Очная	    выбыло по другим причинам / 16.0	150	0	0	2	152	0	0	0	0	0	430	0	45	266	741	18	0	1	106	125
Ставропольский край	Государственные, муниципальные (без учета организаций в ведении ФСИН); Очная	"    добровольно прекратили образовательные отношения
    (бросили учебу) / 10.0"	196	0	0	6	202	0	0	0	3	3	435	0	31	323	789	80	0	20	85	185
Ставропольский край	Государственные, муниципальные (без учета организаций в ведении ФСИН); Очная	"    отчислено:
         по неуспеваемости / 11.0"	208	0	0	3	211	0	0	0	4	4	333	0	4	162	499	10	0	4	48	62
Ставропольский край	Государственные, муниципальные (без учета организаций в ведении ФСИН); Очная	"    переведено в другие образовательные организации
    на программы того же уровня / 8.0"	87	0	0	3	90	0	0	0	0	0	296	0	9	276	581	20	0	5	38	63
Ставропольский край	Государственные, муниципальные (без учета организаций в ведении ФСИН); Очная	"    переведено из других образовательных организаций 
    с программ того же уровня / 3.0"	81	0	0	0	81	0	0	0	0	0	247	0	2	445	694	5	0	4	37	46
Ставропольский край	Государственные, муниципальные (без учета организаций в ведении ФСИН); Очная	    по болезни / 9.0	8	0	0	0	8	0	0	0	0	0	10	0	0	3	13	0	0	0	1	1
Ставропольский край	Государственные, муниципальные (без учета организаций в ведении ФСИН); Очная	    прибыло по другим причинам / 5.0	65	0	0	1	66	0	0	0	0	0	154	0	0	79	233	23	0	0	28	51
Ставропольский край	Государственные, муниципальные (без учета организаций в ведении ФСИН); Очная	Выбыло студентов - всего (сумма стр. 07-11, 13-15) / 6.0	665	0	0	15	680	0	0	0	9	9	1715	0	89	1204	3008	130	0	31	304	465
Ставропольский край	Государственные, муниципальные (без учета организаций в ведении ФСИН); Очная	Прибыло студентов - всего (сумма стр. 02-05) / 1.0	205	0	0	2	207	0	0	0	0	0	713	0	2	620	1335	51	0	11	87	149
Ставропольский край	Государственные, муниципальные (без учета организаций в ведении ФСИН); Очная	"Численность студентов на начало прошлого учебного года
(на 1 октября) / 17.0"	7332	0	15	174	7521	0	0	0	151	151	23770	594	1639	12282	38285	1836	0	614	2449	4899
Ставропольский край	Очно-заочная; Государственные, муниципальные (без учета организаций в ведении ФСИН)	            из стр. 11 - не прошли итоговую аттестацию / 12.0	0	0	0	0	0	0	0	0	0	0	0	0	0	0	0	0	0	0	2	2
Ставропольский край	Очно-заочная; Государственные, муниципальные (без учета организаций в ведении ФСИН)	"            из стр. 11 – лица с ограниченными возможностями здоровья,
            инвалиды, дети-инвалиды / 13.0"	0	0	0	0	0	0	0	0	0	0	0	0	0	0	0	0	0	0	0	0
Ставропольский край	Очно-заочная; Государственные, муниципальные (без учета организаций в ведении ФСИН)	         отчислено в виде меры дисциплинарного взыскания / 14.0	0	0	0	0	0	0	0	0	0	0	0	0	0	0	0	0	0	0	0	0
Ставропольский край	Очно-заочная; Государственные, муниципальные (без учета организаций в ведении ФСИН)	         отчислено из-за просрочки оплаты обучения / 15.0	0	0	0	0	0	0	0	0	0	0	0	0	0	0	0	0	0	0	0	0
Ставропольский край	Очно-заочная; Государственные, муниципальные (без учета организаций в ведении ФСИН)	"    в том числе:
    переведено на другие формы обучения данной
    организации на программы того же уровня / 7.0"	0	0	0	0	0	0	0	0	0	0	0	0	0	11	11	0	0	0	0	0
Ставропольский край	Очно-заочная; Государственные, муниципальные (без учета организаций в ведении ФСИН)	"    в том числе:
    переведено с других форм обучения данной
    образовательной организации с программ того же уровня / 2.0"	0	0	0	0	0	0	0	0	0	0	0	0	0	56	56	0	0	0	1	1
Ставропольский край	Очно-заочная; Государственные, муниципальные (без учета организаций в ведении ФСИН)	    восстановлены из числа ранее отчисленных / 4.0	0	0	0	0	0	0	0	0	0	0	0	0	0	12	12	0	0	0	3	3
Ставропольский край	Очно-заочная; Государственные, муниципальные (без учета организаций в ведении ФСИН)	    выбыло по другим причинам / 16.0	0	0	0	0	0	0	0	0	0	0	0	0	0	3	3	0	0	0	2	2
Ставропольский край	Очно-заочная; Государственные, муниципальные (без учета организаций в ведении ФСИН)	"    добровольно прекратили образовательные отношения
    (бросили учебу) / 10.0"	0	0	0	0	0	0	0	0	0	0	0	0	0	0	0	0	0	0	12	12
Ставропольский край	Очно-заочная; Государственные, муниципальные (без учета организаций в ведении ФСИН)	"    отчислено:
         по неуспеваемости / 11.0"	0	0	0	0	0	0	0	0	0	0	0	0	0	5	5	0	0	0	3	3
Ставропольский край	Очно-заочная; Государственные, муниципальные (без учета организаций в ведении ФСИН)	"    переведено в другие образовательные организации
    на программы того же уровня / 8.0"	0	0	0	0	0	0	0	0	0	0	0	0	0	0	0	0	0	0	4	4
Ставропольский край	Очно-заочная; Государственные, муниципальные (без учета организаций в ведении ФСИН)	"    переведено из других образовательных организаций 
    с программ того же уровня / 3.0"	0	0	0	0	0	0	0	0	0	0	0	0	0	9	9	0	0	0	1	1
Ставропольский край	Очно-заочная; Государственные, муниципальные (без учета организаций в ведении ФСИН)	    по болезни / 9.0	0	0	0	0	0	0	0	0	0	0	0	0	0	0	0	0	0	0	0	0
Ставропольский край	Очно-заочная; Государственные, муниципальные (без учета организаций в ведении ФСИН)	    прибыло по другим причинам / 5.0	0	0	0	0	0	0	0	0	0	0	0	0	0	0	0	0	0	0	0	0
Ставропольский край	Очно-заочная; Государственные, муниципальные (без учета организаций в ведении ФСИН)	Выбыло студентов - всего (сумма стр. 07-11, 13-15) / 6.0	0	0	0	0	0	0	0	0	0	0	0	0	0	19	19	0	0	0	21	21
Ставропольский край	Очно-заочная; Государственные, муниципальные (без учета организаций в ведении ФСИН)	Прибыло студентов - всего (сумма стр. 02-05) / 1.0	0	0	0	0	0	0	0	0	0	0	0	0	0	77	77	0	0	0	5	5
Ставропольский край	Очно-заочная; Государственные, муниципальные (без учета организаций в ведении ФСИН)	"Численность студентов на начало прошлого учебного года
(на 1 октября) / 17.0"	0	0	0	0	0	0	0	0	0	0	0	0	0	105	105	0	0	0	268	268
Ставропольский край	Частные; Заочная	            из стр. 11 - не прошли итоговую аттестацию / 12.0	0	0	0	0	0	0	0	0	0	0	0	0	0	1	1	0	0	0	1	1
Ставропольский край	Частные; Заочная	"            из стр. 11 – лица с ограниченными возможностями здоровья,
            инвалиды, дети-инвалиды / 13.0"	0	0	0	0	0	0	0	0	0	0	0	0	0	0	0	0	0	0	0	0
Ставропольский край	Частные; Заочная	         отчислено в виде меры дисциплинарного взыскания / 14.0	0	0	0	0	0	0	0	0	0	0	0	0	0	0	0	0	0	0	0	0
Ставропольский край	Частные; Заочная	         отчислено из-за просрочки оплаты обучения / 15.0	0	0	0	1	1	0	0	0	0	0	0	0	0	67	67	0	0	0	22	22
Ставропольский край	Частные; Заочная	"    в том числе:
    переведено на другие формы обучения данной
    организации на программы того же уровня / 7.0"	0	0	0	2	2	0	0	0	0	0	0	0	0	195	195	0	0	0	51	51
Ставропольский край	Частные; Заочная	"    в том числе:
    переведено с других форм обучения данной
    образовательной организации с программ того же уровня / 2.0"	0	0	0	2	2	0	0	0	0	0	0	0	0	294	294	0	0	0	28	28
Ставропольский край	Частные; Заочная	    восстановлены из числа ранее отчисленных / 4.0	0	0	0	0	0	0	0	0	1	1	0	0	0	37	37	0	0	0	23	23
Ставропольский край	Частные; Заочная	    выбыло по другим причинам / 16.0	0	0	0	0	0	0	0	0	0	0	0	0	0	21	21	0	0	0	3	3
Ставропольский край	Частные; Заочная	"    добровольно прекратили образовательные отношения
    (бросили учебу) / 10.0"	0	0	0	0	0	0	0	0	1	1	0	0	0	75	75	0	0	0	34	34
Ставропольский край	Частные; Заочная	"    отчислено:
         по неуспеваемости / 11.0"	0	0	0	0	0	0	0	0	0	0	0	0	0	52	52	0	0	0	29	29
Ставропольский край	Частные; Заочная	"    переведено в другие образовательные организации
    на программы того же уровня / 8.0"	0	0	0	1	1	0	0	0	0	0	0	0	0	9	9	0	0	0	1	1
Ставропольский край	Частные; Заочная	"    переведено из других образовательных организаций 
    с программ того же уровня / 3.0"	0	0	0	2	2	0	0	0	0	0	0	0	0	152	152	0	0	0	46	46
Ставропольский край	Частные; Заочная	    по болезни / 9.0	0	0	0	0	0	0	0	0	0	0	0	0	0	0	0	0	0	0	0	0
Ставропольский край	Частные; Заочная	    прибыло по другим причинам / 5.0	0	0	0	0	0	0	0	0	0	0	0	0	0	95	95	0	0	0	35	35
Ставропольский край	Частные; Заочная	Выбыло студентов - всего (сумма стр. 07-11, 13-15) / 6.0	0	0	0	4	4	0	0	0	1	1	0	0	0	419	419	0	0	0	140	140
Ставропольский край	Частные; Заочная	Прибыло студентов - всего (сумма стр. 02-05) / 1.0	0	0	0	4	4	0	0	0	1	1	0	0	0	578	578	0	0	0	132	132
Ставропольский край	Частные; Заочная	"Численность студентов на начало прошлого учебного года
(на 1 октября) / 17.0"	0	0	0	0	0	0	0	0	0	0	0	0	0	1618	1618	0	0	0	615	615
Ставропольский край	Частные; Очная	            из стр. 11 - не прошли итоговую аттестацию / 12.0	0	0	0	0	0	0	0	0	0	0	0	0	0	49	49	0	0	0	40	40
Ставропольский край	Частные; Очная	"            из стр. 11 – лица с ограниченными возможностями здоровья,
            инвалиды, дети-инвалиды / 13.0"	0	0	0	0	0	0	0	0	0	0	0	0	0	0	0	0	0	0	0	0
Ставропольский край	Частные; Очная	         отчислено в виде меры дисциплинарного взыскания / 14.0	0	0	0	0	0	0	0	0	0	0	0	0	0	0	0	0	0	0	1	1
Ставропольский край	Частные; Очная	         отчислено из-за просрочки оплаты обучения / 15.0	0	0	0	0	0	0	0	0	0	0	0	0	0	106	106	0	0	0	36	36
Ставропольский край	Частные; Очная	"    в том числе:
    переведено на другие формы обучения данной
    организации на программы того же уровня / 7.0"	0	0	0	0	0	0	0	0	0	0	0	0	0	349	349	0	0	0	56	56
Ставропольский край	Частные; Очная	"    в том числе:
    переведено с других форм обучения данной
    образовательной организации с программ того же уровня / 2.0"	0	0	0	1	1	0	0	0	0	0	0	0	0	142	142	0	0	0	80	80
Ставропольский край	Частные; Очная	    восстановлены из числа ранее отчисленных / 4.0	0	0	0	0	0	0	0	0	3	3	0	0	0	114	114	0	0	0	74	74
Ставропольский край	Частные; Очная	    выбыло по другим причинам / 16.0	0	0	0	8	8	0	0	0	0	0	0	0	0	204	204	0	0	0	130	130
Ставропольский край	Частные; Очная	"    добровольно прекратили образовательные отношения
    (бросили учебу) / 10.0"	0	0	0	3	3	0	0	0	3	3	4	0	0	330	334	0	0	0	136	136
Ставропольский край	Частные; Очная	"    отчислено:
         по неуспеваемости / 11.0"	0	0	0	0	0	0	0	0	0	0	2	0	0	309	311	0	1	0	169	170
Ставропольский край	Частные; Очная	"    переведено в другие образовательные организации
    на программы того же уровня / 8.0"	0	0	0	0	0	0	0	0	0	0	0	0	0	244	244	0	0	0	71	71
Ставропольский край	Частные; Очная	"    переведено из других образовательных организаций 
    с программ того же уровня / 3.0"	0	0	0	9	9	0	0	0	0	0	0	0	0	650	650	0	0	0	210	210
Ставропольский край	Частные; Очная	    по болезни / 9.0	0	0	0	0	0	0	0	0	0	0	0	0	0	5	5	0	0	0	0	0
Ставропольский край	Частные; Очная	    прибыло по другим причинам / 5.0	0	0	0	8	8	0	0	0	6	6	8	0	0	353	361	0	0	0	117	117
Ставропольский край	Частные; Очная	Выбыло студентов - всего (сумма стр. 07-11, 13-15) / 6.0	0	0	0	11	11	0	0	0	3	3	6	0	0	1547	1553	0	1	0	599	600
Ставропольский край	Частные; Очная	Прибыло студентов - всего (сумма стр. 02-05) / 1.0	0	0	0	18	18	0	0	0	9	9	8	0	0	1259	1267	0	0	0	481	481
Ставропольский край	Частные; Очная	"Численность студентов на начало прошлого учебного года
(на 1 октября) / 17.0"	0	0	0	45	45	0	0	0	19	19	0	102	0	11818	11920	0	0	0	3061	3061
Ставропольский край	Частные; Очно-заочная	            из стр. 11 - не прошли итоговую аттестацию / 12.0	0	0	0	0	0	0	0	0	0	0	0	0	0	0	0	0	0	0	0	0
Ставропольский край	Частные; Очно-заочная	"            из стр. 11 – лица с ограниченными возможностями здоровья,
            инвалиды, дети-инвалиды / 13.0"	0	0	0	0	0	0	0	0	0	0	0	0	0	0	0	0	0	0	0	0
Ставропольский край	Частные; Очно-заочная	         отчислено в виде меры дисциплинарного взыскания / 14.0	0	0	0	0	0	0	0	0	0	0	0	0	0	0	0	0	0	0	0	0
Ставропольский край	Частные; Очно-заочная	         отчислено из-за просрочки оплаты обучения / 15.0	0	0	0	0	0	0	0	0	0	0	0	0	0	1	1	0	0	0	5	5
Ставропольский край	Частные; Очно-заочная	"    в том числе:
    переведено на другие формы обучения данной
    организации на программы того же уровня / 7.0"	0	0	0	0	0	0	0	0	0	0	0	0	0	11	11	0	0	0	5	5
Ставропольский край	Частные; Очно-заочная	"    в том числе:
    переведено с других форм обучения данной
    образовательной организации с программ того же уровня / 2.0"	0	0	0	0	0	0	0	0	0	0	0	0	0	35	35	0	0	0	35	35
Ставропольский край	Частные; Очно-заочная	    восстановлены из числа ранее отчисленных / 4.0	0	0	0	0	0	0	0	0	0	0	0	0	0	1	1	0	0	0	1	1
Ставропольский край	Частные; Очно-заочная	    выбыло по другим причинам / 16.0	0	0	0	0	0	0	0	0	0	0	0	0	0	0	0	0	0	0	3	3
Ставропольский край	Частные; Очно-заочная	"    добровольно прекратили образовательные отношения
    (бросили учебу) / 10.0"	0	0	0	0	0	0	0	0	0	0	0	0	0	2	2	0	0	0	15	15
Ставропольский край	Частные; Очно-заочная	"    отчислено:
         по неуспеваемости / 11.0"	0	0	0	0	0	0	0	0	0	0	0	0	0	3	3	0	0	0	8	8
Ставропольский край	Частные; Очно-заочная	"    переведено в другие образовательные организации
    на программы того же уровня / 8.0"	0	0	0	0	0	0	0	0	0	0	0	0	0	0	0	0	0	0	9	9
Ставропольский край	Частные; Очно-заочная	"    переведено из других образовательных организаций 
    с программ того же уровня / 3.0"	0	0	0	0	0	0	0	0	0	0	0	0	0	28	28	0	0	0	48	48
Ставропольский край	Частные; Очно-заочная	    по болезни / 9.0	0	0	0	0	0	0	0	0	0	0	0	0	0	0	0	0	0	0	0	0
Ставропольский край	Частные; Очно-заочная	    прибыло по другим причинам / 5.0	0	0	0	0	0	0	0	0	0	0	0	0	0	51	51	0	0	0	74	74
Ставропольский край	Частные; Очно-заочная	Выбыло студентов - всего (сумма стр. 07-11, 13-15) / 6.0	0	0	0	0	0	0	0	0	0	0	0	0	0	17	17	0	0	0	45	45
Ставропольский край	Частные; Очно-заочная	Прибыло студентов - всего (сумма стр. 02-05) / 1.0	0	0	0	0	0	0	0	0	0	0	0	0	0	115	115	0	0	0	158	158
Ставропольский край	Частные; Очно-заочная	"Численность студентов на начало прошлого учебного года
(на 1 октября) / 17.0"	0	0	0	0	0	0	0	0	0	0	0	0	0	58	58	0	0	0	893	893
Тамбовская область	Государственные, муниципальные (без учета организаций в ведении ФСИН); Заочная	            из стр. 11 - не прошли итоговую аттестацию / 12.0	0	0	0	0	0	0	0	0	0	0	0	0	0	0	0	0	0	0	0	0
Тамбовская область	Государственные, муниципальные (без учета организаций в ведении ФСИН); Заочная	"            из стр. 11 – лица с ограниченными возможностями здоровья,
            инвалиды, дети-инвалиды / 13.0"	0	0	0	0	0	0	0	0	0	0	0	0	0	0	0	0	0	0	0	0
Тамбовская область	Государственные, муниципальные (без учета организаций в ведении ФСИН); Заочная	         отчислено в виде меры дисциплинарного взыскания / 14.0	0	0	0	0	0	0	0	0	0	0	0	0	0	0	0	0	0	0	0	0
Тамбовская область	Государственные, муниципальные (без учета организаций в ведении ФСИН); Заочная	         отчислено из-за просрочки оплаты обучения / 15.0	0	0	0	0	0	0	0	0	0	0	0	0	0	1	1	0	0	0	1	1
Тамбовская область	Государственные, муниципальные (без учета организаций в ведении ФСИН); Заочная	"    в том числе:
    переведено на другие формы обучения данной
    организации на программы того же уровня / 7.0"	0	0	0	0	0	0	0	0	0	0	0	0	0	0	0	0	0	0	0	0
Тамбовская область	Государственные, муниципальные (без учета организаций в ведении ФСИН); Заочная	"    в том числе:
    переведено с других форм обучения данной
    образовательной организации с программ того же уровня / 2.0"	0	0	0	0	0	0	0	0	0	0	0	0	0	5	5	23	0	0	12	35
Тамбовская область	Государственные, муниципальные (без учета организаций в ведении ФСИН); Заочная	    восстановлены из числа ранее отчисленных / 4.0	0	0	0	0	0	0	0	0	0	0	0	0	0	1	1	8	0	0	2	10
Тамбовская область	Государственные, муниципальные (без учета организаций в ведении ФСИН); Заочная	    выбыло по другим причинам / 16.0	0	0	0	0	0	0	0	0	0	0	5	0	0	1	6	27	0	0	5	32
Тамбовская область	Государственные, муниципальные (без учета организаций в ведении ФСИН); Заочная	"    добровольно прекратили образовательные отношения
    (бросили учебу) / 10.0"	0	0	0	0	0	0	0	0	0	0	0	0	0	9	9	24	0	6	10	40
Тамбовская область	Государственные, муниципальные (без учета организаций в ведении ФСИН); Заочная	"    отчислено:
         по неуспеваемости / 11.0"	0	0	0	0	0	0	0	0	0	0	0	0	0	0	0	29	0	2	21	52
Тамбовская область	Государственные, муниципальные (без учета организаций в ведении ФСИН); Заочная	"    переведено в другие образовательные организации
    на программы того же уровня / 8.0"	0	0	0	0	0	0	0	0	0	0	0	0	0	0	0	0	0	0	0	0
Тамбовская область	Государственные, муниципальные (без учета организаций в ведении ФСИН); Заочная	"    переведено из других образовательных организаций 
    с программ того же уровня / 3.0"	0	0	0	0	0	0	0	0	0	0	0	0	0	0	0	0	0	0	0	0
Тамбовская область	Государственные, муниципальные (без учета организаций в ведении ФСИН); Заочная	    по болезни / 9.0	0	0	0	0	0	0	0	0	0	0	0	0	0	0	0	1	0	0	0	1
Тамбовская область	Государственные, муниципальные (без учета организаций в ведении ФСИН); Заочная	    прибыло по другим причинам / 5.0	0	0	0	0	0	0	0	0	0	0	0	0	0	0	0	0	0	1	11	12
Тамбовская область	Государственные, муниципальные (без учета организаций в ведении ФСИН); Заочная	Выбыло студентов - всего (сумма стр. 07-11, 13-15) / 6.0	0	0	0	0	0	0	0	0	0	0	5	0	0	11	16	81	0	8	37	126
Тамбовская область	Государственные, муниципальные (без учета организаций в ведении ФСИН); Заочная	Прибыло студентов - всего (сумма стр. 02-05) / 1.0	0	0	0	0	0	0	0	0	0	0	0	0	0	6	6	31	0	1	25	57
Тамбовская область	Государственные, муниципальные (без учета организаций в ведении ФСИН); Заочная	"Численность студентов на начало прошлого учебного года
(на 1 октября) / 17.0"	0	0	0	0	0	0	0	0	0	0	120	0	1	179	300	1083	0	197	479	1759
Тамбовская область	Государственные, муниципальные (без учета организаций в ведении ФСИН); Очная	            из стр. 11 - не прошли итоговую аттестацию / 12.0	0	0	0	0	0	0	0	0	0	0	3	0	0	0	3	0	0	0	0	0
Тамбовская область	Государственные, муниципальные (без учета организаций в ведении ФСИН); Очная	"            из стр. 11 – лица с ограниченными возможностями здоровья,
            инвалиды, дети-инвалиды / 13.0"	0	0	0	0	0	0	0	0	0	0	0	0	0	0	0	0	0	0	0	0
Тамбовская область	Государственные, муниципальные (без учета организаций в ведении ФСИН); Очная	         отчислено в виде меры дисциплинарного взыскания / 14.0	3	0	0	0	3	0	0	0	0	0	2	0	0	1	3	0	0	0	0	0
Тамбовская область	Государственные, муниципальные (без учета организаций в ведении ФСИН); Очная	         отчислено из-за просрочки оплаты обучения / 15.0	0	0	0	0	0	0	0	0	0	0	0	0	0	2	2	0	0	0	0	0
Тамбовская область	Государственные, муниципальные (без учета организаций в ведении ФСИН); Очная	"    в том числе:
    переведено на другие формы обучения данной
    организации на программы того же уровня / 7.0"	5	0	0	0	5	0	0	0	0	0	56	0	6	11	73	2	0	0	2	4
Тамбовская область	Государственные, муниципальные (без учета организаций в ведении ФСИН); Очная	"    в том числе:
    переведено с других форм обучения данной
    образовательной организации с программ того же уровня / 2.0"	10	0	0	0	10	0	0	0	0	0	2	0	0	0	2	0	0	0	4	4
Тамбовская область	Государственные, муниципальные (без учета организаций в ведении ФСИН); Очная	    восстановлены из числа ранее отчисленных / 4.0	3	0	0	0	3	0	0	0	0	0	21	0	13	18	52	2	0	0	0	2
Тамбовская область	Государственные, муниципальные (без учета организаций в ведении ФСИН); Очная	    выбыло по другим причинам / 16.0	59	0	0	3	62	0	0	0	0	0	138	0	1	61	200	1	0	3	7	11
Тамбовская область	Государственные, муниципальные (без учета организаций в ведении ФСИН); Очная	"    добровольно прекратили образовательные отношения
    (бросили учебу) / 10.0"	93	0	0	2	95	3	0	0	0	3	230	0	62	85	377	34	0	13	27	74
Тамбовская область	Государственные, муниципальные (без учета организаций в ведении ФСИН); Очная	"    отчислено:
         по неуспеваемости / 11.0"	34	0	0	0	34	0	0	0	0	0	82	0	8	31	121	7	0	0	7	14
Тамбовская область	Государственные, муниципальные (без учета организаций в ведении ФСИН); Очная	"    переведено в другие образовательные организации
    на программы того же уровня / 8.0"	56	0	0	2	58	0	0	0	0	0	96	0	33	46	175	1	0	0	3	4
Тамбовская область	Государственные, муниципальные (без учета организаций в ведении ФСИН); Очная	"    переведено из других образовательных организаций 
    с программ того же уровня / 3.0"	16	0	0	0	16	0	0	0	0	0	46	0	2	43	91	0	0	0	0	0
Тамбовская область	Государственные, муниципальные (без учета организаций в ведении ФСИН); Очная	    по болезни / 9.0	1	0	0	0	1	0	0	0	0	0	0	0	0	0	0	0	0	0	0	0
Тамбовская область	Государственные, муниципальные (без учета организаций в ведении ФСИН); Очная	    прибыло по другим причинам / 5.0	12	0	0	2	14	0	0	0	0	0	39	0	11	28	78	4	0	3	2	9
Тамбовская область	Государственные, муниципальные (без учета организаций в ведении ФСИН); Очная	Выбыло студентов - всего (сумма стр. 07-11, 13-15) / 6.0	251	0	0	7	258	3	0	0	0	3	604	0	110	237	951	45	0	16	46	107
Тамбовская область	Государственные, муниципальные (без учета организаций в ведении ФСИН); Очная	Прибыло студентов - всего (сумма стр. 02-05) / 1.0	41	0	0	2	43	0	0	0	0	0	108	0	26	89	223	6	0	3	6	15
Тамбовская область	Государственные, муниципальные (без учета организаций в ведении ФСИН); Очная	"Численность студентов на начало прошлого учебного года
(на 1 октября) / 17.0"	3980	0	0	67	4047	36	0	0	0	36	8756	0	2917	4187	15860	472	0	177	513	1162
Тамбовская область	Очно-заочная; Государственные, муниципальные (без учета организаций в ведении ФСИН)	            из стр. 11 - не прошли итоговую аттестацию / 12.0	0	0	0	0	0	0	0	0	0	0	0	0	0	0	0	0	0	0	0	0
Тамбовская область	Очно-заочная; Государственные, муниципальные (без учета организаций в ведении ФСИН)	"            из стр. 11 – лица с ограниченными возможностями здоровья,
            инвалиды, дети-инвалиды / 13.0"	0	0	0	0	0	0	0	0	0	0	0	0	0	0	0	0	0	0	0	0
Тамбовская область	Очно-заочная; Государственные, муниципальные (без учета организаций в ведении ФСИН)	         отчислено в виде меры дисциплинарного взыскания / 14.0	0	0	0	0	0	0	0	0	0	0	0	0	0	0	0	0	0	0	0	0
Тамбовская область	Очно-заочная; Государственные, муниципальные (без учета организаций в ведении ФСИН)	         отчислено из-за просрочки оплаты обучения / 15.0	0	0	0	0	0	0	0	0	0	0	0	0	0	0	0	0	0	0	0	0
Тамбовская область	Очно-заочная; Государственные, муниципальные (без учета организаций в ведении ФСИН)	"    в том числе:
    переведено на другие формы обучения данной
    организации на программы того же уровня / 7.0"	0	0	0	0	0	0	0	0	0	0	0	0	0	0	0	0	0	0	0	0
Тамбовская область	Очно-заочная; Государственные, муниципальные (без учета организаций в ведении ФСИН)	"    в том числе:
    переведено с других форм обучения данной
    образовательной организации с программ того же уровня / 2.0"	0	0	0	0	0	0	0	0	0	0	0	0	0	0	0	2	0	0	0	2
Тамбовская область	Очно-заочная; Государственные, муниципальные (без учета организаций в ведении ФСИН)	    восстановлены из числа ранее отчисленных / 4.0	0	0	0	0	0	0	0	0	0	0	0	0	0	0	0	0	0	0	0	0
Тамбовская область	Очно-заочная; Государственные, муниципальные (без учета организаций в ведении ФСИН)	    выбыло по другим причинам / 16.0	0	0	0	0	0	20	0	0	0	20	0	0	0	11	11	6	0	0	1	7
Тамбовская область	Очно-заочная; Государственные, муниципальные (без учета организаций в ведении ФСИН)	"    добровольно прекратили образовательные отношения
    (бросили учебу) / 10.0"	0	0	0	0	0	22	0	0	0	22	0	0	0	0	0	7	0	0	5	12
Тамбовская область	Очно-заочная; Государственные, муниципальные (без учета организаций в ведении ФСИН)	"    отчислено:
         по неуспеваемости / 11.0"	0	0	0	0	0	0	0	0	0	0	0	0	0	0	0	0	0	0	1	1
Тамбовская область	Очно-заочная; Государственные, муниципальные (без учета организаций в ведении ФСИН)	"    переведено в другие образовательные организации
    на программы того же уровня / 8.0"	0	0	0	0	0	0	0	0	0	0	0	0	0	0	0	0	0	0	0	0
Тамбовская область	Очно-заочная; Государственные, муниципальные (без учета организаций в ведении ФСИН)	"    переведено из других образовательных организаций 
    с программ того же уровня / 3.0"	0	0	0	0	0	0	0	0	0	0	0	0	0	0	0	0	0	0	1	1
Тамбовская область	Очно-заочная; Государственные, муниципальные (без учета организаций в ведении ФСИН)	    по болезни / 9.0	0	0	0	0	0	2	0	0	0	2	0	0	0	0	0	0	0	0	0	0
Тамбовская область	Очно-заочная; Государственные, муниципальные (без учета организаций в ведении ФСИН)	    прибыло по другим причинам / 5.0	0	0	0	0	0	0	0	0	0	0	0	0	0	3	3	0	0	0	3	3
Тамбовская область	Очно-заочная; Государственные, муниципальные (без учета организаций в ведении ФСИН)	Выбыло студентов - всего (сумма стр. 07-11, 13-15) / 6.0	0	0	0	0	0	44	0	0	0	44	0	0	0	11	11	13	0	0	7	20
Тамбовская область	Очно-заочная; Государственные, муниципальные (без учета организаций в ведении ФСИН)	Прибыло студентов - всего (сумма стр. 02-05) / 1.0	0	0	0	0	0	0	0	0	0	0	0	0	0	3	3	2	0	0	4	6
Тамбовская область	Очно-заочная; Государственные, муниципальные (без учета организаций в ведении ФСИН)	"Численность студентов на начало прошлого учебного года
(на 1 октября) / 17.0"	0	0	0	0	0	328	0	0	0	328	0	0	0	140	140	220	0	0	120	340
Тамбовская область	Частные; Заочная	            из стр. 11 - не прошли итоговую аттестацию / 12.0	0	0	0	0	0	0	0	0	0	0	0	0	0	3	3	0	0	0	0	0
Тамбовская область	Частные; Заочная	"            из стр. 11 – лица с ограниченными возможностями здоровья,
            инвалиды, дети-инвалиды / 13.0"	0	0	0	0	0	0	0	0	0	0	0	0	0	0	0	0	0	0	0	0
Тамбовская область	Частные; Заочная	         отчислено в виде меры дисциплинарного взыскания / 14.0	0	0	0	0	0	0	0	0	0	0	0	0	0	0	0	0	0	0	0	0
Тамбовская область	Частные; Заочная	         отчислено из-за просрочки оплаты обучения / 15.0	0	0	0	0	0	0	0	0	0	0	0	0	0	0	0	0	0	0	0	0
Тамбовская область	Частные; Заочная	"    в том числе:
    переведено на другие формы обучения данной
    организации на программы того же уровня / 7.0"	0	0	0	0	0	0	0	0	0	0	0	0	0	0	0	0	0	0	0	0
Тамбовская область	Частные; Заочная	"    в том числе:
    переведено с других форм обучения данной
    образовательной организации с программ того же уровня / 2.0"	0	0	0	0	0	0	0	0	0	0	0	0	0	1	1	0	0	0	0	0
Тамбовская область	Частные; Заочная	    восстановлены из числа ранее отчисленных / 4.0	0	0	0	0	0	0	0	0	0	0	0	0	0	9	9	0	0	0	4	4
Тамбовская область	Частные; Заочная	    выбыло по другим причинам / 16.0	0	0	0	0	0	0	0	0	0	0	0	0	0	3	3	0	0	0	0	0
Тамбовская область	Частные; Заочная	"    добровольно прекратили образовательные отношения
    (бросили учебу) / 10.0"	0	0	0	0	0	0	0	0	0	0	0	0	0	2	2	0	0	0	0	0
Тамбовская область	Частные; Заочная	"    отчислено:
         по неуспеваемости / 11.0"	0	0	0	0	0	0	0	0	0	0	0	0	0	15	15	0	0	0	10	10
Тамбовская область	Частные; Заочная	"    переведено в другие образовательные организации
    на программы того же уровня / 8.0"	0	0	0	0	0	0	0	0	0	0	0	0	0	5	5	0	0	0	2	2
Тамбовская область	Частные; Заочная	"    переведено из других образовательных организаций 
    с программ того же уровня / 3.0"	0	0	0	0	0	0	0	0	0	0	0	0	0	0	0	0	0	0	0	0
Тамбовская область	Частные; Заочная	    по болезни / 9.0	0	0	0	0	0	0	0	0	0	0	0	0	0	0	0	0	0	0	0	0
Тамбовская область	Частные; Заочная	    прибыло по другим причинам / 5.0	0	0	0	0	0	0	0	0	0	0	0	0	0	0	0	0	0	0	0	0
Тамбовская область	Частные; Заочная	Выбыло студентов - всего (сумма стр. 07-11, 13-15) / 6.0	0	0	0	0	0	0	0	0	0	0	0	0	0	25	25	0	0	0	12	12
Тамбовская область	Частные; Заочная	Прибыло студентов - всего (сумма стр. 02-05) / 1.0	0	0	0	0	0	0	0	0	0	0	0	0	0	10	10	0	0	0	4	4
Тамбовская область	Частные; Заочная	"Численность студентов на начало прошлого учебного года
(на 1 октября) / 17.0"	0	0	0	0	0	0	0	0	0	0	0	0	0	111	111	0	0	0	55	55
Тамбовская область	Частные; Очная	            из стр. 11 - не прошли итоговую аттестацию / 12.0	0	0	0	0	0	0	0	0	0	0	0	0	0	0	0	0	0	0	0	0
Тамбовская область	Частные; Очная	"            из стр. 11 – лица с ограниченными возможностями здоровья,
            инвалиды, дети-инвалиды / 13.0"	0	0	0	0	0	0	0	0	0	0	0	0	0	0	0	0	0	0	0	0
Тамбовская область	Частные; Очная	         отчислено в виде меры дисциплинарного взыскания / 14.0	0	0	0	0	0	0	0	0	0	0	0	0	0	0	0	0	0	0	0	0
Тамбовская область	Частные; Очная	         отчислено из-за просрочки оплаты обучения / 15.0	0	0	0	0	0	0	0	0	0	0	0	0	0	11	11	0	0	0	7	7
Тамбовская область	Частные; Очная	"    в том числе:
    переведено на другие формы обучения данной
    организации на программы того же уровня / 7.0"	0	0	0	0	0	0	0	0	0	0	0	0	0	0	0	0	0	0	0	0
Тамбовская область	Частные; Очная	"    в том числе:
    переведено с других форм обучения данной
    образовательной организации с программ того же уровня / 2.0"	0	0	0	0	0	0	0	0	0	0	0	0	0	5	5	0	0	0	0	0
Тамбовская область	Частные; Очная	    восстановлены из числа ранее отчисленных / 4.0	0	0	0	0	0	0	0	0	0	0	0	0	0	13	13	0	0	0	6	6
Тамбовская область	Частные; Очная	    выбыло по другим причинам / 16.0	0	0	0	0	0	0	0	0	0	0	0	0	0	1	1	0	0	0	0	0
Тамбовская область	Частные; Очная	"    добровольно прекратили образовательные отношения
    (бросили учебу) / 10.0"	0	0	0	0	0	0	0	0	0	0	0	0	0	32	32	0	0	0	12	12
Тамбовская область	Частные; Очная	"    отчислено:
         по неуспеваемости / 11.0"	0	0	0	0	0	0	0	0	0	0	0	0	0	40	40	0	0	0	31	31
Тамбовская область	Частные; Очная	"    переведено в другие образовательные организации
    на программы того же уровня / 8.0"	0	0	0	0	0	0	0	0	0	0	0	0	0	26	26	0	0	0	1	1
Тамбовская область	Частные; Очная	"    переведено из других образовательных организаций 
    с программ того же уровня / 3.0"	0	0	0	0	0	0	0	0	0	0	0	0	0	54	54	0	0	0	2	2
Тамбовская область	Частные; Очная	    по болезни / 9.0	0	0	0	0	0	0	0	0	0	0	0	0	0	0	0	0	0	0	0	0
Тамбовская область	Частные; Очная	    прибыло по другим причинам / 5.0	0	0	0	0	0	0	0	0	0	0	0	0	0	0	0	0	0	0	0	0
Тамбовская область	Частные; Очная	Выбыло студентов - всего (сумма стр. 07-11, 13-15) / 6.0	0	0	0	0	0	0	0	0	0	0	0	0	0	110	110	0	0	0	51	51
Тамбовская область	Частные; Очная	Прибыло студентов - всего (сумма стр. 02-05) / 1.0	0	0	0	0	0	0	0	0	0	0	0	0	0	72	72	0	0	0	8	8
Тамбовская область	Частные; Очная	"Численность студентов на начало прошлого учебного года
(на 1 октября) / 17.0"	0	0	0	0	0	0	0	0	0	0	0	0	0	1097	1097	0	0	0	236	236
Тверская область	Государственные, муниципальные (без учета организаций в ведении ФСИН); Заочная	            из стр. 11 - не прошли итоговую аттестацию / 12.0	0	0	0	0	0	0	0	0	0	0	0	0	0	0	0	0	0	0	0	0
Тверская область	Государственные, муниципальные (без учета организаций в ведении ФСИН); Заочная	"            из стр. 11 – лица с ограниченными возможностями здоровья,
            инвалиды, дети-инвалиды / 13.0"	0	0	0	0	0	0	0	0	0	0	0	0	0	0	0	0	0	0	0	0
Тверская область	Государственные, муниципальные (без учета организаций в ведении ФСИН); Заочная	         отчислено в виде меры дисциплинарного взыскания / 14.0	0	0	0	0	0	0	0	0	0	0	0	0	0	0	0	0	0	0	0	0
Тверская область	Государственные, муниципальные (без учета организаций в ведении ФСИН); Заочная	         отчислено из-за просрочки оплаты обучения / 15.0	0	0	0	0	0	0	0	0	0	0	0	0	0	3	3	0	0	0	7	7
Тверская область	Государственные, муниципальные (без учета организаций в ведении ФСИН); Заочная	"    в том числе:
    переведено на другие формы обучения данной
    организации на программы того же уровня / 7.0"	0	0	0	0	0	0	0	0	0	0	0	0	0	0	0	0	0	0	1	1
Тверская область	Государственные, муниципальные (без учета организаций в ведении ФСИН); Заочная	"    в том числе:
    переведено с других форм обучения данной
    образовательной организации с программ того же уровня / 2.0"	0	0	0	0	0	0	0	0	0	0	0	0	0	4	4	25	0	1	15	41
Тверская область	Государственные, муниципальные (без учета организаций в ведении ФСИН); Заочная	    восстановлены из числа ранее отчисленных / 4.0	0	0	0	0	0	0	0	0	0	0	0	0	0	5	5	15	0	1	15	31
Тверская область	Государственные, муниципальные (без учета организаций в ведении ФСИН); Заочная	    выбыло по другим причинам / 16.0	0	0	0	0	0	0	0	0	0	0	0	0	0	2	2	9	0	0	10	19
Тверская область	Государственные, муниципальные (без учета организаций в ведении ФСИН); Заочная	"    добровольно прекратили образовательные отношения
    (бросили учебу) / 10.0"	0	0	0	0	0	0	0	0	0	0	0	0	0	7	7	50	0	24	45	119
Тверская область	Государственные, муниципальные (без учета организаций в ведении ФСИН); Заочная	"    отчислено:
         по неуспеваемости / 11.0"	0	0	0	0	0	0	0	0	0	0	0	0	0	11	11	50	0	26	66	142
Тверская область	Государственные, муниципальные (без учета организаций в ведении ФСИН); Заочная	"    переведено в другие образовательные организации
    на программы того же уровня / 8.0"	0	0	0	0	0	0	0	0	0	0	0	0	0	2	2	3	0	0	2	5
Тверская область	Государственные, муниципальные (без учета организаций в ведении ФСИН); Заочная	"    переведено из других образовательных организаций 
    с программ того же уровня / 3.0"	0	0	0	0	0	0	0	0	0	0	0	0	0	2	2	2	0	0	2	4
Тверская область	Государственные, муниципальные (без учета организаций в ведении ФСИН); Заочная	    по болезни / 9.0	0	0	0	0	0	0	0	0	0	0	0	0	0	0	0	1	0	0	0	1
Тверская область	Государственные, муниципальные (без учета организаций в ведении ФСИН); Заочная	    прибыло по другим причинам / 5.0	0	0	0	0	0	0	0	0	0	0	0	0	0	5	5	4	0	28	16	48
Тверская область	Государственные, муниципальные (без учета организаций в ведении ФСИН); Заочная	Выбыло студентов - всего (сумма стр. 07-11, 13-15) / 6.0	0	0	0	0	0	0	0	0	0	0	0	0	0	25	25	113	0	50	131	294
Тверская область	Государственные, муниципальные (без учета организаций в ведении ФСИН); Заочная	Прибыло студентов - всего (сумма стр. 02-05) / 1.0	0	0	0	0	0	0	0	0	0	0	0	0	0	16	16	46	0	30	48	124
Тверская область	Государственные, муниципальные (без учета организаций в ведении ФСИН); Заочная	"Численность студентов на начало прошлого учебного года
(на 1 октября) / 17.0"	0	0	0	0	0	0	0	0	0	0	0	0	0	161	161	574	0	366	984	1924
Тверская область	Государственные, муниципальные (без учета организаций в ведении ФСИН); Очная	            из стр. 11 - не прошли итоговую аттестацию / 12.0	12	0	0	0	12	0	0	0	0	0	21	0	0	9	30	0	0	0	2	2
Тверская область	Государственные, муниципальные (без учета организаций в ведении ФСИН); Очная	"            из стр. 11 – лица с ограниченными возможностями здоровья,
            инвалиды, дети-инвалиды / 13.0"	0	0	0	0	0	0	0	0	0	0	1	0	0	0	1	0	0	0	0	0
Тверская область	Государственные, муниципальные (без учета организаций в ведении ФСИН); Очная	         отчислено в виде меры дисциплинарного взыскания / 14.0	4	0	0	0	4	0	0	0	0	0	4	0	1	0	5	0	0	0	0	0
Тверская область	Государственные, муниципальные (без учета организаций в ведении ФСИН); Очная	         отчислено из-за просрочки оплаты обучения / 15.0	0	0	0	2	2	0	0	0	0	0	0	0	0	4	4	0	0	0	2	2
Тверская область	Государственные, муниципальные (без учета организаций в ведении ФСИН); Очная	"    в том числе:
    переведено на другие формы обучения данной
    организации на программы того же уровня / 7.0"	59	0	0	1	60	0	0	0	0	0	56	0	1	64	121	13	1	0	8	22
Тверская область	Государственные, муниципальные (без учета организаций в ведении ФСИН); Очная	"    в том числе:
    переведено с других форм обучения данной
    образовательной организации с программ того же уровня / 2.0"	20	0	0	3	23	0	0	0	0	0	29	0	0	11	40	0	1	0	0	1
Тверская область	Государственные, муниципальные (без учета организаций в ведении ФСИН); Очная	    восстановлены из числа ранее отчисленных / 4.0	26	0	0	2	28	0	0	0	0	0	52	0	7	15	74	5	0	0	8	13
Тверская область	Государственные, муниципальные (без учета организаций в ведении ФСИН); Очная	    выбыло по другим причинам / 16.0	72	0	0	18	90	0	0	0	0	0	110	0	74	94	278	46	50	0	22	118
Тверская область	Государственные, муниципальные (без учета организаций в ведении ФСИН); Очная	"    добровольно прекратили образовательные отношения
    (бросили учебу) / 10.0"	232	0	0	16	248	0	0	0	0	0	509	0	9	169	687	27	0	0	28	55
Тверская область	Государственные, муниципальные (без учета организаций в ведении ФСИН); Очная	"    отчислено:
         по неуспеваемости / 11.0"	115	0	4	1	120	0	0	0	1	1	247	0	2	99	348	13	0	0	41	54
Тверская область	Государственные, муниципальные (без учета организаций в ведении ФСИН); Очная	"    переведено в другие образовательные организации
    на программы того же уровня / 8.0"	27	0	0	0	27	0	0	0	0	0	125	0	17	128	270	1	1	0	20	22
Тверская область	Государственные, муниципальные (без учета организаций в ведении ФСИН); Очная	"    переведено из других образовательных организаций 
    с программ того же уровня / 3.0"	42	0	0	5	47	0	0	0	0	0	104	0	3	58	165	15	2	0	6	23
Тверская область	Государственные, муниципальные (без учета организаций в ведении ФСИН); Очная	    по болезни / 9.0	2	0	0	0	2	0	0	0	0	0	4	0	0	5	9	0	0	0	0	0
Тверская область	Государственные, муниципальные (без учета организаций в ведении ФСИН); Очная	    прибыло по другим причинам / 5.0	108	0	0	4	112	0	0	0	2	2	77	0	24	62	163	19	19	0	15	53
Тверская область	Государственные, муниципальные (без учета организаций в ведении ФСИН); Очная	Выбыло студентов - всего (сумма стр. 07-11, 13-15) / 6.0	511	0	4	38	553	0	0	0	1	1	1055	0	104	563	1722	100	52	0	121	273
Тверская область	Государственные, муниципальные (без учета организаций в ведении ФСИН); Очная	Прибыло студентов - всего (сумма стр. 02-05) / 1.0	196	0	0	14	210	0	0	0	2	2	262	0	34	146	442	39	22	0	29	90
Тверская область	Государственные, муниципальные (без учета организаций в ведении ФСИН); Очная	"Численность студентов на начало прошлого учебного года
(на 1 октября) / 17.0"	4482	0	50	291	4823	0	0	0	18	18	12334	0	819	4864	18017	1240	379	0	547	2166
Тверская область	Очно-заочная; Государственные, муниципальные (без учета организаций в ведении ФСИН)	            из стр. 11 - не прошли итоговую аттестацию / 12.0	0	0	0	0	0	0	0	0	0	0	0	0	0	0	0	0	0	0	3	3
Тверская область	Очно-заочная; Государственные, муниципальные (без учета организаций в ведении ФСИН)	"            из стр. 11 – лица с ограниченными возможностями здоровья,
            инвалиды, дети-инвалиды / 13.0"	0	0	0	0	0	0	0	0	0	0	0	0	0	0	0	0	0	0	0	0
Тверская область	Очно-заочная; Государственные, муниципальные (без учета организаций в ведении ФСИН)	         отчислено в виде меры дисциплинарного взыскания / 14.0	0	0	0	0	0	0	0	0	0	0	0	0	0	0	0	0	0	0	0	0
Тверская область	Очно-заочная; Государственные, муниципальные (без учета организаций в ведении ФСИН)	         отчислено из-за просрочки оплаты обучения / 15.0	0	0	0	0	0	0	0	0	0	0	0	0	0	0	0	0	0	0	0	0
Тверская область	Очно-заочная; Государственные, муниципальные (без учета организаций в ведении ФСИН)	"    в том числе:
    переведено на другие формы обучения данной
    организации на программы того же уровня / 7.0"	0	0	0	0	0	0	0	0	0	0	0	0	0	0	0	0	0	0	0	0
Тверская область	Очно-заочная; Государственные, муниципальные (без учета организаций в ведении ФСИН)	"    в том числе:
    переведено с других форм обучения данной
    образовательной организации с программ того же уровня / 2.0"	0	0	0	0	0	0	0	0	0	0	0	0	0	0	0	0	0	0	25	25
Тверская область	Очно-заочная; Государственные, муниципальные (без учета организаций в ведении ФСИН)	    восстановлены из числа ранее отчисленных / 4.0	0	0	0	0	0	0	0	0	0	0	0	0	0	0	0	0	0	0	16	16
Тверская область	Очно-заочная; Государственные, муниципальные (без учета организаций в ведении ФСИН)	    выбыло по другим причинам / 16.0	0	0	0	0	0	0	0	0	0	0	0	0	0	0	0	0	0	0	0	0
Тверская область	Очно-заочная; Государственные, муниципальные (без учета организаций в ведении ФСИН)	"    добровольно прекратили образовательные отношения
    (бросили учебу) / 10.0"	0	0	0	0	0	0	0	0	0	0	0	0	0	0	0	0	0	0	20	20
Тверская область	Очно-заочная; Государственные, муниципальные (без учета организаций в ведении ФСИН)	"    отчислено:
         по неуспеваемости / 11.0"	0	0	0	0	0	0	0	0	0	0	0	0	0	0	0	0	0	0	11	11
Тверская область	Очно-заочная; Государственные, муниципальные (без учета организаций в ведении ФСИН)	"    переведено в другие образовательные организации
    на программы того же уровня / 8.0"	0	0	0	0	0	0	0	0	0	0	0	0	0	0	0	0	0	0	0	0
Тверская область	Очно-заочная; Государственные, муниципальные (без учета организаций в ведении ФСИН)	"    переведено из других образовательных организаций 
    с программ того же уровня / 3.0"	0	0	0	0	0	0	0	0	0	0	0	0	0	0	0	0	0	0	3	3
Тверская область	Очно-заочная; Государственные, муниципальные (без учета организаций в ведении ФСИН)	    по болезни / 9.0	0	0	0	0	0	0	0	0	0	0	0	0	0	0	0	0	0	0	0	0
Тверская область	Очно-заочная; Государственные, муниципальные (без учета организаций в ведении ФСИН)	    прибыло по другим причинам / 5.0	0	0	0	0	0	0	0	0	0	0	0	0	0	0	0	0	0	0	0	0
Тверская область	Очно-заочная; Государственные, муниципальные (без учета организаций в ведении ФСИН)	Выбыло студентов - всего (сумма стр. 07-11, 13-15) / 6.0	0	0	0	0	0	0	0	0	0	0	0	0	0	0	0	0	0	0	31	31
Тверская область	Очно-заочная; Государственные, муниципальные (без учета организаций в ведении ФСИН)	Прибыло студентов - всего (сумма стр. 02-05) / 1.0	0	0	0	0	0	0	0	0	0	0	0	0	0	0	0	0	0	0	44	44
Тверская область	Очно-заочная; Государственные, муниципальные (без учета организаций в ведении ФСИН)	"Численность студентов на начало прошлого учебного года
(на 1 октября) / 17.0"	0	0	0	0	0	0	0	0	0	0	0	0	0	0	0	0	0	0	103	103
Тверская область	Частные; Заочная	            из стр. 11 - не прошли итоговую аттестацию / 12.0	0	0	0	0	0	0	0	0	0	0	0	0	0	0	0	0	0	0	0	0
Тверская область	Частные; Заочная	"            из стр. 11 – лица с ограниченными возможностями здоровья,
            инвалиды, дети-инвалиды / 13.0"	0	0	0	0	0	0	0	0	0	0	0	0	0	0	0	0	0	0	0	0
Тверская область	Частные; Заочная	         отчислено в виде меры дисциплинарного взыскания / 14.0	0	0	0	0	0	0	0	0	0	0	0	0	0	6	6	0	0	0	5	5
Тверская область	Частные; Заочная	         отчислено из-за просрочки оплаты обучения / 15.0	0	0	0	0	0	0	0	0	0	0	0	0	0	0	0	0	0	0	5	5
Тверская область	Частные; Заочная	"    в том числе:
    переведено на другие формы обучения данной
    организации на программы того же уровня / 7.0"	0	0	0	0	0	0	0	0	0	0	0	0	0	2	2	0	0	0	1	1
Тверская область	Частные; Заочная	"    в том числе:
    переведено с других форм обучения данной
    образовательной организации с программ того же уровня / 2.0"	0	0	0	0	0	0	0	0	0	0	0	0	0	5	5	0	0	0	3	3
Тверская область	Частные; Заочная	    восстановлены из числа ранее отчисленных / 4.0	0	0	0	0	0	0	0	0	0	0	0	0	0	6	6	0	0	0	5	5
Тверская область	Частные; Заочная	    выбыло по другим причинам / 16.0	0	0	0	0	0	0	0	0	0	0	0	0	0	9	9	0	0	0	5	5
Тверская область	Частные; Заочная	"    добровольно прекратили образовательные отношения
    (бросили учебу) / 10.0"	0	0	0	0	0	0	0	0	0	0	0	0	0	5	5	0	0	0	12	12
Тверская область	Частные; Заочная	"    отчислено:
         по неуспеваемости / 11.0"	0	0	0	0	0	0	0	0	0	0	0	0	0	0	0	0	0	0	0	0
Тверская область	Частные; Заочная	"    переведено в другие образовательные организации
    на программы того же уровня / 8.0"	0	0	0	0	0	0	0	0	0	0	0	0	0	3	3	0	0	0	2	2
Тверская область	Частные; Заочная	"    переведено из других образовательных организаций 
    с программ того же уровня / 3.0"	0	0	0	0	0	0	0	0	0	0	0	0	0	10	10	0	0	0	7	7
Тверская область	Частные; Заочная	    по болезни / 9.0	0	0	0	0	0	0	0	0	0	0	0	0	0	0	0	0	0	0	0	0
Тверская область	Частные; Заочная	    прибыло по другим причинам / 5.0	0	0	0	0	0	0	0	0	0	0	0	0	0	5	5	0	0	0	4	4
Тверская область	Частные; Заочная	Выбыло студентов - всего (сумма стр. 07-11, 13-15) / 6.0	0	0	0	0	0	0	0	0	0	0	0	0	0	25	25	0	0	0	30	30
Тверская область	Частные; Заочная	Прибыло студентов - всего (сумма стр. 02-05) / 1.0	0	0	0	0	0	0	0	0	0	0	0	0	0	26	26	0	0	0	19	19
Тверская область	Частные; Заочная	"Численность студентов на начало прошлого учебного года
(на 1 октября) / 17.0"	0	0	0	0	0	0	0	0	0	0	0	0	0	220	220	0	0	0	118	118
Тверская область	Частные; Очная	            из стр. 11 - не прошли итоговую аттестацию / 12.0	0	0	0	0	0	0	0	0	0	0	0	0	0	0	0	0	0	0	0	0
Тверская область	Частные; Очная	"            из стр. 11 – лица с ограниченными возможностями здоровья,
            инвалиды, дети-инвалиды / 13.0"	0	0	0	0	0	0	0	0	0	0	0	0	0	0	0	0	0	0	0	0
Тверская область	Частные; Очная	         отчислено в виде меры дисциплинарного взыскания / 14.0	0	0	0	0	0	0	0	0	0	0	0	0	0	1	1	0	0	0	1	1
Тверская область	Частные; Очная	         отчислено из-за просрочки оплаты обучения / 15.0	0	0	0	0	0	0	0	0	0	0	0	0	0	18	18	0	0	0	0	0
Тверская область	Частные; Очная	"    в том числе:
    переведено на другие формы обучения данной
    организации на программы того же уровня / 7.0"	0	0	0	0	0	0	0	0	0	0	0	0	0	0	0	0	0	0	0	0
Тверская область	Частные; Очная	"    в том числе:
    переведено с других форм обучения данной
    образовательной организации с программ того же уровня / 2.0"	0	0	0	0	0	0	0	0	0	0	0	0	0	3	3	0	0	0	1	1
Тверская область	Частные; Очная	    восстановлены из числа ранее отчисленных / 4.0	0	0	0	0	0	0	0	0	0	0	0	0	0	11	11	0	0	0	0	0
Тверская область	Частные; Очная	    выбыло по другим причинам / 16.0	0	0	0	0	0	0	0	0	0	0	0	0	0	0	0	0	0	0	0	0
Тверская область	Частные; Очная	"    добровольно прекратили образовательные отношения
    (бросили учебу) / 10.0"	0	0	0	0	0	0	0	0	0	0	0	0	0	65	65	0	0	0	10	10
Тверская область	Частные; Очная	"    отчислено:
         по неуспеваемости / 11.0"	0	0	0	0	0	0	0	0	0	0	0	0	0	4	4	0	0	0	1	1
Тверская область	Частные; Очная	"    переведено в другие образовательные организации
    на программы того же уровня / 8.0"	0	0	0	0	0	0	0	0	0	0	0	0	0	19	19	0	0	0	5	5
Тверская область	Частные; Очная	"    переведено из других образовательных организаций 
    с программ того же уровня / 3.0"	0	0	0	0	0	0	0	0	0	0	0	0	0	11	11	0	0	0	2	2
Тверская область	Частные; Очная	    по болезни / 9.0	0	0	0	0	0	0	0	0	0	0	0	0	0	0	0	0	0	0	0	0
Тверская область	Частные; Очная	    прибыло по другим причинам / 5.0	0	0	0	0	0	0	0	0	0	0	0	0	0	6	6	0	0	0	3	3
Тверская область	Частные; Очная	Выбыло студентов - всего (сумма стр. 07-11, 13-15) / 6.0	0	0	0	0	0	0	0	0	0	0	0	0	0	107	107	0	0	0	17	17
Тверская область	Частные; Очная	Прибыло студентов - всего (сумма стр. 02-05) / 1.0	0	0	0	0	0	0	0	0	0	0	0	0	0	31	31	0	0	0	6	6
Тверская область	Частные; Очная	"Численность студентов на начало прошлого учебного года
(на 1 октября) / 17.0"	0	0	0	0	0	0	0	0	0	0	0	0	0	762	762	0	0	0	228	228
Тверская область	Частные; Очно-заочная	            из стр. 11 - не прошли итоговую аттестацию / 12.0	0	0	0	0	0	0	0	0	0	0	0	0	0	0	0	0	0	0	0	0
Тверская область	Частные; Очно-заочная	"            из стр. 11 – лица с ограниченными возможностями здоровья,
            инвалиды, дети-инвалиды / 13.0"	0	0	0	0	0	0	0	0	0	0	0	0	0	0	0	0	0	0	0	0
Тверская область	Частные; Очно-заочная	         отчислено в виде меры дисциплинарного взыскания / 14.0	0	0	0	0	0	0	0	0	0	0	0	0	0	4	4	0	0	0	1	1
Тверская область	Частные; Очно-заочная	         отчислено из-за просрочки оплаты обучения / 15.0	0	0	0	0	0	0	0	0	0	0	0	0	0	5	5	0	0	0	3	3
Тверская область	Частные; Очно-заочная	"    в том числе:
    переведено на другие формы обучения данной
    организации на программы того же уровня / 7.0"	0	0	0	0	0	0	0	0	0	0	0	0	0	2	2	0	0	0	0	0
Тверская область	Частные; Очно-заочная	"    в том числе:
    переведено с других форм обучения данной
    образовательной организации с программ того же уровня / 2.0"	0	0	0	0	0	0	0	0	0	0	0	0	0	5	5	0	0	0	2	2
Тверская область	Частные; Очно-заочная	    восстановлены из числа ранее отчисленных / 4.0	0	0	0	0	0	0	0	0	0	0	0	0	0	0	0	0	0	0	0	0
Тверская область	Частные; Очно-заочная	    выбыло по другим причинам / 16.0	0	0	0	0	0	0	0	0	0	0	0	0	0	0	0	0	0	0	0	0
Тверская область	Частные; Очно-заочная	"    добровольно прекратили образовательные отношения
    (бросили учебу) / 10.0"	0	0	0	0	0	0	0	0	0	0	0	0	0	2	2	0	0	0	0	0
Тверская область	Частные; Очно-заочная	"    отчислено:
         по неуспеваемости / 11.0"	0	0	0	0	0	0	0	0	0	0	0	0	0	3	3	0	0	0	1	1
Тверская область	Частные; Очно-заочная	"    переведено в другие образовательные организации
    на программы того же уровня / 8.0"	0	0	0	0	0	0	0	0	0	0	0	0	0	1	1	0	0	0	0	0
Тверская область	Частные; Очно-заочная	"    переведено из других образовательных организаций 
    с программ того же уровня / 3.0"	0	0	0	0	0	0	0	0	0	0	0	0	0	4	4	0	0	0	2	2
Тверская область	Частные; Очно-заочная	    по болезни / 9.0	0	0	0	0	0	0	0	0	0	0	0	0	0	0	0	0	0	0	0	0
Тверская область	Частные; Очно-заочная	    прибыло по другим причинам / 5.0	0	0	0	0	0	0	0	0	0	0	0	0	0	4	4	0	0	0	2	2
Тверская область	Частные; Очно-заочная	Выбыло студентов - всего (сумма стр. 07-11, 13-15) / 6.0	0	0	0	0	0	0	0	0	0	0	0	0	0	17	17	0	0	0	5	5
Тверская область	Частные; Очно-заочная	Прибыло студентов - всего (сумма стр. 02-05) / 1.0	0	0	0	0	0	0	0	0	0	0	0	0	0	13	13	0	0	0	6	6
Тверская область	Частные; Очно-заочная	"Численность студентов на начало прошлого учебного года
(на 1 октября) / 17.0"	0	0	0	0	0	0	0	0	0	0	0	0	0	90	90	0	0	0	85	85
Томская область	Государственные, муниципальные (без учета организаций в ведении ФСИН); Заочная	            из стр. 11 - не прошли итоговую аттестацию / 12.0	0	0	0	0	0	0	0	0	0	0	0	0	0	0	0	1	0	0	2	3
Томская область	Государственные, муниципальные (без учета организаций в ведении ФСИН); Заочная	"            из стр. 11 – лица с ограниченными возможностями здоровья,
            инвалиды, дети-инвалиды / 13.0"	0	0	0	0	0	0	0	0	0	0	0	0	0	0	0	0	0	0	0	0
Томская область	Государственные, муниципальные (без учета организаций в ведении ФСИН); Заочная	         отчислено в виде меры дисциплинарного взыскания / 14.0	0	0	0	0	0	0	0	0	0	0	0	0	0	0	0	0	0	0	0	0
Томская область	Государственные, муниципальные (без учета организаций в ведении ФСИН); Заочная	         отчислено из-за просрочки оплаты обучения / 15.0	0	0	0	0	0	0	0	0	0	0	0	0	0	7	7	0	0	0	22	22
Томская область	Государственные, муниципальные (без учета организаций в ведении ФСИН); Заочная	"    в том числе:
    переведено на другие формы обучения данной
    организации на программы того же уровня / 7.0"	0	0	0	0	0	0	0	0	0	0	0	0	0	0	0	0	0	0	2	2
Томская область	Государственные, муниципальные (без учета организаций в ведении ФСИН); Заочная	"    в том числе:
    переведено с других форм обучения данной
    образовательной организации с программ того же уровня / 2.0"	0	0	0	0	0	0	0	0	0	0	0	0	0	5	5	2	0	0	29	31
Томская область	Государственные, муниципальные (без учета организаций в ведении ФСИН); Заочная	    восстановлены из числа ранее отчисленных / 4.0	0	0	0	0	0	0	0	0	0	0	0	0	0	13	13	2	0	0	47	49
Томская область	Государственные, муниципальные (без учета организаций в ведении ФСИН); Заочная	    выбыло по другим причинам / 16.0	0	0	0	0	0	0	0	0	0	0	0	0	0	9	9	4	0	1	44	49
Томская область	Государственные, муниципальные (без учета организаций в ведении ФСИН); Заочная	"    добровольно прекратили образовательные отношения
    (бросили учебу) / 10.0"	0	0	0	0	0	0	0	0	0	0	0	0	0	22	22	45	0	6	72	123
Томская область	Государственные, муниципальные (без учета организаций в ведении ФСИН); Заочная	"    отчислено:
         по неуспеваемости / 11.0"	0	0	0	0	0	0	0	0	0	0	0	0	0	7	7	57	0	16	46	119
Томская область	Государственные, муниципальные (без учета организаций в ведении ФСИН); Заочная	"    переведено в другие образовательные организации
    на программы того же уровня / 8.0"	0	0	0	0	0	0	0	0	0	0	0	0	0	5	5	0	0	0	3	3
Томская область	Государственные, муниципальные (без учета организаций в ведении ФСИН); Заочная	"    переведено из других образовательных организаций 
    с программ того же уровня / 3.0"	0	0	0	0	0	0	0	0	0	0	0	0	0	3	3	1	0	0	1	2
Томская область	Государственные, муниципальные (без учета организаций в ведении ФСИН); Заочная	    по болезни / 9.0	0	0	0	0	0	0	0	0	0	0	0	0	0	0	0	0	0	0	1	1
Томская область	Государственные, муниципальные (без учета организаций в ведении ФСИН); Заочная	    прибыло по другим причинам / 5.0	0	0	0	0	0	0	0	0	0	0	0	0	0	12	12	6	0	0	42	48
Томская область	Государственные, муниципальные (без учета организаций в ведении ФСИН); Заочная	Выбыло студентов - всего (сумма стр. 07-11, 13-15) / 6.0	0	0	0	0	0	0	0	0	0	0	0	0	0	50	50	106	0	23	190	319
Томская область	Государственные, муниципальные (без учета организаций в ведении ФСИН); Заочная	Прибыло студентов - всего (сумма стр. 02-05) / 1.0	0	0	0	0	0	0	0	0	0	0	0	0	0	33	33	11	0	0	119	130
Томская область	Государственные, муниципальные (без учета организаций в ведении ФСИН); Заочная	"Численность студентов на начало прошлого учебного года
(на 1 октября) / 17.0"	0	0	0	0	0	0	0	0	0	0	0	0	5	286	291	754	0	194	1141	2089
Томская область	Государственные, муниципальные (без учета организаций в ведении ФСИН); Очная	            из стр. 11 - не прошли итоговую аттестацию / 12.0	1	0	0	0	1	0	0	0	0	0	7	0	0	1	8	0	0	1	3	4
Томская область	Государственные, муниципальные (без учета организаций в ведении ФСИН); Очная	"            из стр. 11 – лица с ограниченными возможностями здоровья,
            инвалиды, дети-инвалиды / 13.0"	3	0	0	0	3	0	0	0	0	0	5	0	0	0	5	0	0	1	1	2
Томская область	Государственные, муниципальные (без учета организаций в ведении ФСИН); Очная	         отчислено в виде меры дисциплинарного взыскания / 14.0	0	0	0	0	0	0	0	0	0	0	3	0	0	4	7	10	0	0	0	10
Томская область	Государственные, муниципальные (без учета организаций в ведении ФСИН); Очная	         отчислено из-за просрочки оплаты обучения / 15.0	0	0	0	0	0	0	0	0	0	0	0	0	0	32	32	0	0	0	11	11
Томская область	Государственные, муниципальные (без учета организаций в ведении ФСИН); Очная	"    в том числе:
    переведено на другие формы обучения данной
    организации на программы того же уровня / 7.0"	8	0	0	4	12	0	0	0	0	0	34	0	0	52	86	7	0	0	32	39
Томская область	Государственные, муниципальные (без учета организаций в ведении ФСИН); Очная	"    в том числе:
    переведено с других форм обучения данной
    образовательной организации с программ того же уровня / 2.0"	19	0	0	1	20	2	0	0	0	2	46	0	0	10	56	20	0	5	2	27
Томская область	Государственные, муниципальные (без учета организаций в ведении ФСИН); Очная	    восстановлены из числа ранее отчисленных / 4.0	21	0	0	0	21	0	0	0	0	0	53	0	0	47	100	19	0	0	18	37
Томская область	Государственные, муниципальные (без учета организаций в ведении ФСИН); Очная	    выбыло по другим причинам / 16.0	100	0	0	1	101	0	0	0	0	0	163	0	0	108	271	58	0	1	75	134
Томская область	Государственные, муниципальные (без учета организаций в ведении ФСИН); Очная	"    добровольно прекратили образовательные отношения
    (бросили учебу) / 10.0"	166	0	0	6	172	36	0	0	4	40	471	8	42	306	827	211	0	39	114	364
Томская область	Государственные, муниципальные (без учета организаций в ведении ФСИН); Очная	"    отчислено:
         по неуспеваемости / 11.0"	188	0	0	4	192	24	0	0	2	26	291	1	6	69	367	94	0	22	30	146
Томская область	Государственные, муниципальные (без учета организаций в ведении ФСИН); Очная	"    переведено в другие образовательные организации
    на программы того же уровня / 8.0"	39	0	0	0	39	0	0	0	0	0	78	1	10	62	151	14	0	0	6	20
Томская область	Государственные, муниципальные (без учета организаций в ведении ФСИН); Очная	"    переведено из других образовательных организаций 
    с программ того же уровня / 3.0"	53	0	0	1	54	0	0	0	0	0	66	0	0	42	108	6	0	1	3	10
Томская область	Государственные, муниципальные (без учета организаций в ведении ФСИН); Очная	    по болезни / 9.0	17	0	0	0	17	0	0	0	0	0	4	0	0	3	7	1	0	0	0	1
Томская область	Государственные, муниципальные (без учета организаций в ведении ФСИН); Очная	    прибыло по другим причинам / 5.0	30	0	0	0	30	1	0	0	0	1	82	11	1	27	121	55	0	7	13	75
Томская область	Государственные, муниципальные (без учета организаций в ведении ФСИН); Очная	Выбыло студентов - всего (сумма стр. 07-11, 13-15) / 6.0	518	0	0	15	533	60	0	0	6	66	1044	10	58	636	1748	395	0	62	268	725
Томская область	Государственные, муниципальные (без учета организаций в ведении ФСИН); Очная	Прибыло студентов - всего (сумма стр. 02-05) / 1.0	123	0	0	2	125	3	0	0	0	3	247	11	1	126	385	100	0	13	36	149
Томская область	Государственные, муниципальные (без учета организаций в ведении ФСИН); Очная	"Численность студентов на начало прошлого учебного года
(на 1 октября) / 17.0"	3584	0	0	90	3674	155	0	0	17	172	8930	68	703	3076	12777	2599	0	572	1131	4302
Томская область	Очно-заочная; Государственные, муниципальные (без учета организаций в ведении ФСИН)	            из стр. 11 - не прошли итоговую аттестацию / 12.0	0	0	0	0	0	0	0	0	0	0	0	0	0	0	0	0	0	0	0	0
Томская область	Очно-заочная; Государственные, муниципальные (без учета организаций в ведении ФСИН)	"            из стр. 11 – лица с ограниченными возможностями здоровья,
            инвалиды, дети-инвалиды / 13.0"	0	0	0	0	0	0	0	0	0	0	0	0	0	0	0	0	0	0	0	0
Томская область	Очно-заочная; Государственные, муниципальные (без учета организаций в ведении ФСИН)	         отчислено в виде меры дисциплинарного взыскания / 14.0	0	0	0	0	0	0	0	0	0	0	0	0	0	0	0	3	0	0	0	3
Томская область	Очно-заочная; Государственные, муниципальные (без учета организаций в ведении ФСИН)	         отчислено из-за просрочки оплаты обучения / 15.0	0	0	0	0	0	0	0	0	0	0	0	0	0	0	0	0	0	0	9	9
Томская область	Очно-заочная; Государственные, муниципальные (без учета организаций в ведении ФСИН)	"    в том числе:
    переведено на другие формы обучения данной
    организации на программы того же уровня / 7.0"	0	0	0	0	0	0	0	0	0	0	0	0	0	0	0	2	0	0	6	8
Томская область	Очно-заочная; Государственные, муниципальные (без учета организаций в ведении ФСИН)	"    в том числе:
    переведено с других форм обучения данной
    образовательной организации с программ того же уровня / 2.0"	0	0	0	0	0	0	0	0	0	0	0	0	0	0	0	7	0	0	6	13
Томская область	Очно-заочная; Государственные, муниципальные (без учета организаций в ведении ФСИН)	    восстановлены из числа ранее отчисленных / 4.0	0	0	0	0	0	0	0	0	0	0	0	0	0	0	0	1	0	0	4	5
Томская область	Очно-заочная; Государственные, муниципальные (без учета организаций в ведении ФСИН)	    выбыло по другим причинам / 16.0	0	0	0	0	0	0	0	0	0	0	0	0	0	0	0	21	0	0	10	31
Томская область	Очно-заочная; Государственные, муниципальные (без учета организаций в ведении ФСИН)	"    добровольно прекратили образовательные отношения
    (бросили учебу) / 10.0"	0	0	0	0	0	0	0	0	0	0	0	0	0	0	0	22	0	0	17	39
Томская область	Очно-заочная; Государственные, муниципальные (без учета организаций в ведении ФСИН)	"    отчислено:
         по неуспеваемости / 11.0"	0	0	0	0	0	0	0	0	0	0	0	0	0	0	0	12	0	0	0	12
Томская область	Очно-заочная; Государственные, муниципальные (без учета организаций в ведении ФСИН)	"    переведено в другие образовательные организации
    на программы того же уровня / 8.0"	0	0	0	0	0	0	0	0	0	0	0	0	0	0	0	1	0	0	0	1
Томская область	Очно-заочная; Государственные, муниципальные (без учета организаций в ведении ФСИН)	"    переведено из других образовательных организаций 
    с программ того же уровня / 3.0"	0	0	0	0	0	0	0	0	0	0	0	0	0	0	0	0	0	0	0	0
Томская область	Очно-заочная; Государственные, муниципальные (без учета организаций в ведении ФСИН)	    по болезни / 9.0	0	0	0	0	0	0	0	0	0	0	0	0	0	0	0	0	0	0	0	0
Томская область	Очно-заочная; Государственные, муниципальные (без учета организаций в ведении ФСИН)	    прибыло по другим причинам / 5.0	0	0	0	0	0	0	0	0	0	0	0	0	0	0	0	1	0	0	0	1
Томская область	Очно-заочная; Государственные, муниципальные (без учета организаций в ведении ФСИН)	Выбыло студентов - всего (сумма стр. 07-11, 13-15) / 6.0	0	0	0	0	0	0	0	0	0	0	0	0	0	0	0	61	0	0	42	103
Томская область	Очно-заочная; Государственные, муниципальные (без учета организаций в ведении ФСИН)	Прибыло студентов - всего (сумма стр. 02-05) / 1.0	0	0	0	0	0	0	0	0	0	0	0	0	0	0	0	9	0	0	10	19
Томская область	Очно-заочная; Государственные, муниципальные (без учета организаций в ведении ФСИН)	"Численность студентов на начало прошлого учебного года
(на 1 октября) / 17.0"	0	0	0	0	0	0	0	0	0	0	0	0	0	0	0	331	0	0	224	555
Томская область	Частные; Заочная	            из стр. 11 - не прошли итоговую аттестацию / 12.0	0	0	0	0	0	0	0	0	0	0	0	0	0	0	0	0	0	0	0	0
Томская область	Частные; Заочная	"            из стр. 11 – лица с ограниченными возможностями здоровья,
            инвалиды, дети-инвалиды / 13.0"	0	0	0	0	0	0	0	0	0	0	0	0	0	0	0	0	0	0	0	0
Томская область	Частные; Заочная	         отчислено в виде меры дисциплинарного взыскания / 14.0	0	0	0	0	0	0	0	0	0	0	0	0	0	0	0	0	0	0	0	0
Томская область	Частные; Заочная	         отчислено из-за просрочки оплаты обучения / 15.0	0	0	0	0	0	0	0	0	0	0	0	0	0	10	10	0	0	0	20	20
Томская область	Частные; Заочная	"    в том числе:
    переведено на другие формы обучения данной
    организации на программы того же уровня / 7.0"	0	0	0	0	0	0	0	0	0	0	0	0	0	22	22	0	0	0	11	11
Томская область	Частные; Заочная	"    в том числе:
    переведено с других форм обучения данной
    образовательной организации с программ того же уровня / 2.0"	0	0	0	0	0	0	0	0	0	0	0	0	0	29	29	0	0	0	28	28
Томская область	Частные; Заочная	    восстановлены из числа ранее отчисленных / 4.0	0	0	0	0	0	0	0	0	0	0	0	0	0	11	11	0	0	0	5	5
Томская область	Частные; Заочная	    выбыло по другим причинам / 16.0	0	0	0	0	0	0	0	0	0	0	0	0	0	2	2	0	0	0	3	3
Томская область	Частные; Заочная	"    добровольно прекратили образовательные отношения
    (бросили учебу) / 10.0"	0	0	0	0	0	0	0	0	0	0	0	0	0	26	26	0	0	0	15	15
Томская область	Частные; Заочная	"    отчислено:
         по неуспеваемости / 11.0"	0	0	0	0	0	0	0	0	0	0	0	0	0	17	17	0	0	0	17	17
Томская область	Частные; Заочная	"    переведено в другие образовательные организации
    на программы того же уровня / 8.0"	0	0	0	0	0	0	0	0	0	0	0	0	0	2	2	0	0	0	1	1
Томская область	Частные; Заочная	"    переведено из других образовательных организаций 
    с программ того же уровня / 3.0"	0	0	0	0	0	0	0	0	0	0	0	0	0	3	3	0	0	0	22	22
Томская область	Частные; Заочная	    по болезни / 9.0	0	0	0	0	0	0	0	0	0	0	0	0	0	0	0	0	0	0	0	0
Томская область	Частные; Заочная	    прибыло по другим причинам / 5.0	0	0	0	0	0	0	0	0	0	0	0	0	0	0	0	0	0	0	0	0
Томская область	Частные; Заочная	Выбыло студентов - всего (сумма стр. 07-11, 13-15) / 6.0	0	0	0	0	0	0	0	0	0	0	0	0	0	79	79	0	0	0	67	67
Томская область	Частные; Заочная	Прибыло студентов - всего (сумма стр. 02-05) / 1.0	0	0	0	0	0	0	0	0	0	0	0	0	0	43	43	0	0	0	55	55
Томская область	Частные; Заочная	"Численность студентов на начало прошлого учебного года
(на 1 октября) / 17.0"	0	0	0	0	0	0	0	0	0	0	0	0	0	223	223	0	0	0	241	241
Томская область	Частные; Очная	            из стр. 11 - не прошли итоговую аттестацию / 12.0	0	0	0	0	0	0	0	0	0	0	0	0	0	0	0	0	0	0	0	0
Томская область	Частные; Очная	"            из стр. 11 – лица с ограниченными возможностями здоровья,
            инвалиды, дети-инвалиды / 13.0"	0	0	0	0	0	0	0	0	0	0	0	0	0	0	0	0	0	0	0	0
Томская область	Частные; Очная	         отчислено в виде меры дисциплинарного взыскания / 14.0	0	0	0	0	0	0	0	0	0	0	0	0	0	4	4	0	0	0	0	0
Томская область	Частные; Очная	         отчислено из-за просрочки оплаты обучения / 15.0	0	0	0	0	0	0	0	0	0	0	0	0	0	21	21	0	0	0	5	5
Томская область	Частные; Очная	"    в том числе:
    переведено на другие формы обучения данной
    организации на программы того же уровня / 7.0"	0	0	0	0	0	0	0	0	0	0	0	0	0	41	41	0	0	0	7	7
Томская область	Частные; Очная	"    в том числе:
    переведено с других форм обучения данной
    образовательной организации с программ того же уровня / 2.0"	0	0	0	0	0	0	0	0	0	0	0	0	0	15	15	0	0	0	0	0
Томская область	Частные; Очная	    восстановлены из числа ранее отчисленных / 4.0	0	0	0	0	0	0	0	0	0	0	0	0	0	8	8	0	0	0	5	5
Томская область	Частные; Очная	    выбыло по другим причинам / 16.0	0	0	0	0	0	0	0	0	0	0	0	0	0	4	4	0	0	0	0	0
Томская область	Частные; Очная	"    добровольно прекратили образовательные отношения
    (бросили учебу) / 10.0"	0	0	0	0	0	0	0	0	0	0	0	0	0	44	44	0	0	0	19	19
Томская область	Частные; Очная	"    отчислено:
         по неуспеваемости / 11.0"	0	0	0	0	0	0	0	0	0	0	0	0	0	21	21	0	0	0	15	15
Томская область	Частные; Очная	"    переведено в другие образовательные организации
    на программы того же уровня / 8.0"	0	0	0	0	0	0	0	0	0	0	0	0	0	15	15	0	0	0	2	2
Томская область	Частные; Очная	"    переведено из других образовательных организаций 
    с программ того же уровня / 3.0"	0	0	0	0	0	0	0	0	0	0	0	0	0	47	47	0	0	0	8	8
Томская область	Частные; Очная	    по болезни / 9.0	0	0	0	0	0	0	0	0	0	0	0	0	0	0	0	0	0	0	0	0
Томская область	Частные; Очная	    прибыло по другим причинам / 5.0	0	0	0	0	0	0	0	0	0	0	0	0	0	0	0	0	0	0	0	0
Томская область	Частные; Очная	Выбыло студентов - всего (сумма стр. 07-11, 13-15) / 6.0	0	0	0	0	0	0	0	0	0	0	0	0	0	150	150	0	0	0	48	48
Томская область	Частные; Очная	Прибыло студентов - всего (сумма стр. 02-05) / 1.0	0	0	0	0	0	0	0	0	0	0	0	0	0	70	70	0	0	0	13	13
Томская область	Частные; Очная	"Численность студентов на начало прошлого учебного года
(на 1 октября) / 17.0"	0	0	0	0	0	0	0	0	0	0	0	0	0	981	981	0	0	0	325	325
Тульская область	Государственные, муниципальные (без учета организаций в ведении ФСИН); Заочная	            из стр. 11 - не прошли итоговую аттестацию / 12.0	0	0	0	0	0	0	0	0	0	0	0	0	0	0	0	14	0	0	0	14
Тульская область	Государственные, муниципальные (без учета организаций в ведении ФСИН); Заочная	"            из стр. 11 – лица с ограниченными возможностями здоровья,
            инвалиды, дети-инвалиды / 13.0"	0	0	0	0	0	0	0	0	0	0	0	0	0	0	0	0	0	0	0	0
Тульская область	Государственные, муниципальные (без учета организаций в ведении ФСИН); Заочная	         отчислено в виде меры дисциплинарного взыскания / 14.0	0	0	0	0	0	0	0	0	0	0	0	0	0	0	0	0	0	0	0	0
Тульская область	Государственные, муниципальные (без учета организаций в ведении ФСИН); Заочная	         отчислено из-за просрочки оплаты обучения / 15.0	0	0	0	0	0	0	0	0	0	0	0	0	0	12	12	0	0	0	11	11
Тульская область	Государственные, муниципальные (без учета организаций в ведении ФСИН); Заочная	"    в том числе:
    переведено на другие формы обучения данной
    организации на программы того же уровня / 7.0"	0	0	0	0	0	0	0	0	0	0	0	0	0	4	4	0	0	0	0	0
Тульская область	Государственные, муниципальные (без учета организаций в ведении ФСИН); Заочная	"    в том числе:
    переведено с других форм обучения данной
    образовательной организации с программ того же уровня / 2.0"	0	0	0	0	0	0	0	0	0	0	0	0	0	12	12	22	0	1	15	38
Тульская область	Государственные, муниципальные (без учета организаций в ведении ФСИН); Заочная	    восстановлены из числа ранее отчисленных / 4.0	0	0	0	0	0	0	0	0	0	0	0	0	0	5	5	19	0	0	3	22
Тульская область	Государственные, муниципальные (без учета организаций в ведении ФСИН); Заочная	    выбыло по другим причинам / 16.0	0	0	0	0	0	0	0	0	0	0	0	0	0	1	1	16	0	0	13	29
Тульская область	Государственные, муниципальные (без учета организаций в ведении ФСИН); Заочная	"    добровольно прекратили образовательные отношения
    (бросили учебу) / 10.0"	0	0	0	0	0	0	0	0	0	0	0	0	0	5	5	69	0	3	13	85
Тульская область	Государственные, муниципальные (без учета организаций в ведении ФСИН); Заочная	"    отчислено:
         по неуспеваемости / 11.0"	0	0	0	0	0	0	0	0	0	0	0	0	0	4	4	39	0	0	17	56
Тульская область	Государственные, муниципальные (без учета организаций в ведении ФСИН); Заочная	"    переведено в другие образовательные организации
    на программы того же уровня / 8.0"	0	0	0	0	0	0	0	0	0	0	0	0	0	2	2	1	0	0	3	4
Тульская область	Государственные, муниципальные (без учета организаций в ведении ФСИН); Заочная	"    переведено из других образовательных организаций 
    с программ того же уровня / 3.0"	0	0	0	0	0	0	0	0	0	0	0	0	0	9	9	38	0	0	9	47
Тульская область	Государственные, муниципальные (без учета организаций в ведении ФСИН); Заочная	    по болезни / 9.0	0	0	0	0	0	0	0	0	0	0	0	0	0	0	0	0	0	0	0	0
Тульская область	Государственные, муниципальные (без учета организаций в ведении ФСИН); Заочная	    прибыло по другим причинам / 5.0	0	0	0	0	0	0	0	0	0	0	0	0	0	11	11	4	0	0	30	34
Тульская область	Государственные, муниципальные (без учета организаций в ведении ФСИН); Заочная	Выбыло студентов - всего (сумма стр. 07-11, 13-15) / 6.0	0	0	0	0	0	0	0	0	0	0	0	0	0	28	28	125	0	3	57	185
Тульская область	Государственные, муниципальные (без учета организаций в ведении ФСИН); Заочная	Прибыло студентов - всего (сумма стр. 02-05) / 1.0	0	0	0	0	0	0	0	0	0	0	0	0	0	37	37	83	0	1	57	141
Тульская область	Государственные, муниципальные (без учета организаций в ведении ФСИН); Заочная	"Численность студентов на начало прошлого учебного года
(на 1 октября) / 17.0"	0	0	0	0	0	0	0	0	0	0	122	0	0	177	299	1116	0	31	519	1666
Тульская область	Государственные, муниципальные (без учета организаций в ведении ФСИН); Очная	            из стр. 11 - не прошли итоговую аттестацию / 12.0	13	0	0	0	13	0	0	0	0	0	11	0	0	0	11	0	0	0	0	0
Тульская область	Государственные, муниципальные (без учета организаций в ведении ФСИН); Очная	"            из стр. 11 – лица с ограниченными возможностями здоровья,
            инвалиды, дети-инвалиды / 13.0"	3	0	0	0	3	0	0	0	0	0	0	0	0	0	0	0	0	0	0	0
Тульская область	Государственные, муниципальные (без учета организаций в ведении ФСИН); Очная	         отчислено в виде меры дисциплинарного взыскания / 14.0	2	0	0	0	2	0	0	0	0	0	16	0	0	2	18	0	0	0	0	0
Тульская область	Государственные, муниципальные (без учета организаций в ведении ФСИН); Очная	         отчислено из-за просрочки оплаты обучения / 15.0	0	0	0	18	18	0	0	0	0	0	0	0	0	16	16	0	0	0	8	8
Тульская область	Государственные, муниципальные (без учета организаций в ведении ФСИН); Очная	"    в том числе:
    переведено на другие формы обучения данной
    организации на программы того же уровня / 7.0"	12	0	0	0	12	0	0	0	0	0	56	0	1	14	71	4	0	0	0	4
Тульская область	Государственные, муниципальные (без учета организаций в ведении ФСИН); Очная	"    в том числе:
    переведено с других форм обучения данной
    образовательной организации с программ того же уровня / 2.0"	4	0	0	0	4	0	0	0	0	0	26	0	0	2	28	6	0	0	0	6
Тульская область	Государственные, муниципальные (без учета организаций в ведении ФСИН); Очная	    восстановлены из числа ранее отчисленных / 4.0	17	0	0	0	17	0	0	0	0	0	37	0	2	6	45	3	0	0	0	3
Тульская область	Государственные, муниципальные (без учета организаций в ведении ФСИН); Очная	    выбыло по другим причинам / 16.0	81	0	0	0	81	8	0	0	0	8	183	0	0	19	202	26	0	0	5	31
Тульская область	Государственные, муниципальные (без учета организаций в ведении ФСИН); Очная	"    добровольно прекратили образовательные отношения
    (бросили учебу) / 10.0"	185	0	0	3	188	11	0	0	0	11	456	0	23	60	539	77	0	9	29	115
Тульская область	Государственные, муниципальные (без учета организаций в ведении ФСИН); Очная	"    отчислено:
         по неуспеваемости / 11.0"	103	0	0	0	103	1	0	0	0	1	202	0	3	14	219	13	0	0	6	19
Тульская область	Государственные, муниципальные (без учета организаций в ведении ФСИН); Очная	"    переведено в другие образовательные организации
    на программы того же уровня / 8.0"	61	0	0	0	61	0	0	0	0	0	211	0	20	28	259	16	0	1	4	21
Тульская область	Государственные, муниципальные (без учета организаций в ведении ФСИН); Очная	"    переведено из других образовательных организаций 
    с программ того же уровня / 3.0"	39	0	0	0	39	0	0	0	0	0	336	0	3	22	361	18	0	0	9	27
Тульская область	Государственные, муниципальные (без учета организаций в ведении ФСИН); Очная	    по болезни / 9.0	0	0	0	0	0	0	0	0	0	0	2	0	0	0	2	1	0	0	0	1
Тульская область	Государственные, муниципальные (без учета организаций в ведении ФСИН); Очная	    прибыло по другим причинам / 5.0	310	0	0	0	310	0	0	0	0	0	319	0	2	7	328	75	0	0	33	108
Тульская область	Государственные, муниципальные (без учета организаций в ведении ФСИН); Очная	Выбыло студентов - всего (сумма стр. 07-11, 13-15) / 6.0	444	0	0	21	465	20	0	0	0	20	1126	0	47	153	1326	137	0	10	52	199
Тульская область	Государственные, муниципальные (без учета организаций в ведении ФСИН); Очная	Прибыло студентов - всего (сумма стр. 02-05) / 1.0	370	0	0	0	370	0	0	0	0	0	718	0	7	37	762	102	0	0	42	144
Тульская область	Государственные, муниципальные (без учета организаций в ведении ФСИН); Очная	"Численность студентов на начало прошлого учебного года
(на 1 октября) / 17.0"	5522	0	0	26	5548	45	0	0	0	45	13361	0	1678	1947	16986	1199	0	119	431	1749
Тульская область	Очно-заочная; Государственные, муниципальные (без учета организаций в ведении ФСИН)	            из стр. 11 - не прошли итоговую аттестацию / 12.0	0	0	0	0	0	0	0	0	0	0	0	0	0	0	0	1	0	0	0	1
Тульская область	Очно-заочная; Государственные, муниципальные (без учета организаций в ведении ФСИН)	"            из стр. 11 – лица с ограниченными возможностями здоровья,
            инвалиды, дети-инвалиды / 13.0"	0	0	0	0	0	0	0	0	0	0	0	0	0	0	0	0	0	0	0	0
Тульская область	Очно-заочная; Государственные, муниципальные (без учета организаций в ведении ФСИН)	         отчислено в виде меры дисциплинарного взыскания / 14.0	0	0	0	0	0	0	0	0	0	0	0	0	0	0	0	0	0	0	0	0
Тульская область	Очно-заочная; Государственные, муниципальные (без учета организаций в ведении ФСИН)	         отчислено из-за просрочки оплаты обучения / 15.0	0	0	0	0	0	0	0	0	0	0	0	0	0	0	0	0	0	0	0	0
Тульская область	Очно-заочная; Государственные, муниципальные (без учета организаций в ведении ФСИН)	"    в том числе:
    переведено на другие формы обучения данной
    организации на программы того же уровня / 7.0"	0	0	0	0	0	0	0	0	0	0	0	0	0	0	0	2	0	0	0	2
Тульская область	Очно-заочная; Государственные, муниципальные (без учета организаций в ведении ФСИН)	"    в том числе:
    переведено с других форм обучения данной
    образовательной организации с программ того же уровня / 2.0"	0	0	0	0	0	0	0	0	0	0	0	0	0	0	0	0	0	0	0	0
Тульская область	Очно-заочная; Государственные, муниципальные (без учета организаций в ведении ФСИН)	    восстановлены из числа ранее отчисленных / 4.0	0	0	0	0	0	0	0	0	0	0	0	0	0	0	0	0	0	0	2	2
Тульская область	Очно-заочная; Государственные, муниципальные (без учета организаций в ведении ФСИН)	    выбыло по другим причинам / 16.0	0	0	0	0	0	0	0	0	0	0	0	0	0	0	0	7	0	0	4	11
Тульская область	Очно-заочная; Государственные, муниципальные (без учета организаций в ведении ФСИН)	"    добровольно прекратили образовательные отношения
    (бросили учебу) / 10.0"	0	0	0	0	0	0	0	0	0	0	0	0	0	0	0	9	0	0	6	15
Тульская область	Очно-заочная; Государственные, муниципальные (без учета организаций в ведении ФСИН)	"    отчислено:
         по неуспеваемости / 11.0"	0	0	0	0	0	0	0	0	0	0	0	0	0	0	0	3	0	0	0	3
Тульская область	Очно-заочная; Государственные, муниципальные (без учета организаций в ведении ФСИН)	"    переведено в другие образовательные организации
    на программы того же уровня / 8.0"	0	0	0	0	0	0	0	0	0	0	0	0	0	0	0	0	0	0	0	0
Тульская область	Очно-заочная; Государственные, муниципальные (без учета организаций в ведении ФСИН)	"    переведено из других образовательных организаций 
    с программ того же уровня / 3.0"	0	0	0	0	0	0	0	0	0	0	0	0	0	0	0	0	0	0	0	0
Тульская область	Очно-заочная; Государственные, муниципальные (без учета организаций в ведении ФСИН)	    по болезни / 9.0	0	0	0	0	0	0	0	0	0	0	0	0	0	0	0	0	0	0	0	0
Тульская область	Очно-заочная; Государственные, муниципальные (без учета организаций в ведении ФСИН)	    прибыло по другим причинам / 5.0	0	0	0	0	0	0	0	0	0	0	0	0	0	0	0	2	0	0	0	2
Тульская область	Очно-заочная; Государственные, муниципальные (без учета организаций в ведении ФСИН)	Выбыло студентов - всего (сумма стр. 07-11, 13-15) / 6.0	0	0	0	0	0	0	0	0	0	0	0	0	0	0	0	21	0	0	10	31
Тульская область	Очно-заочная; Государственные, муниципальные (без учета организаций в ведении ФСИН)	Прибыло студентов - всего (сумма стр. 02-05) / 1.0	0	0	0	0	0	0	0	0	0	0	0	0	0	0	0	2	0	0	2	4
Тульская область	Очно-заочная; Государственные, муниципальные (без учета организаций в ведении ФСИН)	"Численность студентов на начало прошлого учебного года
(на 1 октября) / 17.0"	0	0	0	0	0	0	0	0	0	0	0	0	0	0	0	462	0	0	66	528
Тульская область	Частные; Заочная	            из стр. 11 - не прошли итоговую аттестацию / 12.0	0	0	0	0	0	0	0	0	0	0	0	0	0	8	8	0	0	0	9	9
Тульская область	Частные; Заочная	"            из стр. 11 – лица с ограниченными возможностями здоровья,
            инвалиды, дети-инвалиды / 13.0"	0	0	0	0	0	0	0	0	0	0	0	0	0	0	0	0	0	0	0	0
Тульская область	Частные; Заочная	         отчислено в виде меры дисциплинарного взыскания / 14.0	0	0	0	0	0	0	0	0	0	0	0	0	0	0	0	0	0	0	0	0
Тульская область	Частные; Заочная	         отчислено из-за просрочки оплаты обучения / 15.0	0	0	0	0	0	0	0	0	0	0	0	0	0	610	610	0	0	0	802	802
Тульская область	Частные; Заочная	"    в том числе:
    переведено на другие формы обучения данной
    организации на программы того же уровня / 7.0"	0	0	0	0	0	0	0	0	0	0	0	0	0	1	1	0	0	0	0	0
Тульская область	Частные; Заочная	"    в том числе:
    переведено с других форм обучения данной
    образовательной организации с программ того же уровня / 2.0"	0	0	0	0	0	0	0	0	0	0	0	0	0	62	62	0	0	0	32	32
Тульская область	Частные; Заочная	    восстановлены из числа ранее отчисленных / 4.0	0	0	0	0	0	0	0	0	0	0	0	0	0	18	18	0	0	0	70	70
Тульская область	Частные; Заочная	    выбыло по другим причинам / 16.0	0	0	0	0	0	0	0	0	0	0	0	0	0	8	8	0	0	0	2	2
Тульская область	Частные; Заочная	"    добровольно прекратили образовательные отношения
    (бросили учебу) / 10.0"	0	0	0	0	0	0	0	0	0	0	0	0	0	64	64	0	0	0	56	56
Тульская область	Частные; Заочная	"    отчислено:
         по неуспеваемости / 11.0"	0	0	0	0	0	0	0	0	0	0	0	0	0	36	36	0	0	0	39	39
Тульская область	Частные; Заочная	"    переведено в другие образовательные организации
    на программы того же уровня / 8.0"	0	0	0	0	0	0	0	0	0	0	0	0	0	3	3	0	0	0	7	7
Тульская область	Частные; Заочная	"    переведено из других образовательных организаций 
    с программ того же уровня / 3.0"	0	0	0	0	0	0	0	0	0	0	0	0	0	192	192	0	0	0	172	172
Тульская область	Частные; Заочная	    по болезни / 9.0	0	0	0	0	0	0	0	0	0	0	0	0	0	0	0	0	0	0	0	0
Тульская область	Частные; Заочная	    прибыло по другим причинам / 5.0	0	0	0	0	0	0	0	0	0	0	0	0	0	21	21	0	0	0	5	5
Тульская область	Частные; Заочная	Выбыло студентов - всего (сумма стр. 07-11, 13-15) / 6.0	0	0	0	0	0	0	0	0	0	0	0	0	0	722	722	0	0	0	906	906
Тульская область	Частные; Заочная	Прибыло студентов - всего (сумма стр. 02-05) / 1.0	0	0	0	0	0	0	0	0	0	0	0	0	0	293	293	0	0	0	279	279
Тульская область	Частные; Заочная	"Численность студентов на начало прошлого учебного года
(на 1 октября) / 17.0"	0	0	0	0	0	0	0	0	0	0	0	0	0	1929	1929	0	0	0	3492	3492
Тульская область	Частные; Очная	            из стр. 11 - не прошли итоговую аттестацию / 12.0	0	0	0	0	0	0	0	0	0	0	0	0	0	1	1	0	0	0	2	2
Тульская область	Частные; Очная	"            из стр. 11 – лица с ограниченными возможностями здоровья,
            инвалиды, дети-инвалиды / 13.0"	0	0	0	0	0	0	0	0	0	0	0	0	0	0	0	0	0	0	0	0
Тульская область	Частные; Очная	         отчислено в виде меры дисциплинарного взыскания / 14.0	0	0	0	0	0	0	0	0	0	0	0	0	0	1	1	0	0	0	0	0
Тульская область	Частные; Очная	         отчислено из-за просрочки оплаты обучения / 15.0	0	0	0	0	0	0	0	0	0	0	0	0	0	5	5	0	0	0	4	4
Тульская область	Частные; Очная	"    в том числе:
    переведено на другие формы обучения данной
    организации на программы того же уровня / 7.0"	0	0	0	0	0	0	0	0	0	0	0	0	0	21	21	0	0	0	10	10
Тульская область	Частные; Очная	"    в том числе:
    переведено с других форм обучения данной
    образовательной организации с программ того же уровня / 2.0"	0	0	0	0	0	0	0	0	0	0	0	0	0	2	2	0	0	0	1	1
Тульская область	Частные; Очная	    восстановлены из числа ранее отчисленных / 4.0	0	0	0	0	0	0	0	0	0	0	0	0	0	14	14	0	0	0	10	10
Тульская область	Частные; Очная	    выбыло по другим причинам / 16.0	0	0	0	0	0	0	0	0	0	0	0	0	0	23	23	0	0	0	5	5
Тульская область	Частные; Очная	"    добровольно прекратили образовательные отношения
    (бросили учебу) / 10.0"	0	0	0	0	0	0	0	0	0	0	0	0	0	46	46	0	0	0	6	6
Тульская область	Частные; Очная	"    отчислено:
         по неуспеваемости / 11.0"	0	0	0	0	0	0	0	0	0	0	0	0	0	40	40	0	0	0	16	16
Тульская область	Частные; Очная	"    переведено в другие образовательные организации
    на программы того же уровня / 8.0"	0	0	0	0	0	0	0	0	0	0	0	7	0	38	45	0	0	0	11	11
Тульская область	Частные; Очная	"    переведено из других образовательных организаций 
    с программ того же уровня / 3.0"	0	0	0	0	0	0	0	0	0	0	0	0	0	121	121	0	0	0	317	317
Тульская область	Частные; Очная	    по болезни / 9.0	0	0	0	0	0	0	0	0	0	0	0	0	0	0	0	0	0	0	0	0
Тульская область	Частные; Очная	    прибыло по другим причинам / 5.0	0	0	0	0	0	0	0	0	0	0	0	0	0	306	306	0	0	0	64	64
Тульская область	Частные; Очная	Выбыло студентов - всего (сумма стр. 07-11, 13-15) / 6.0	0	0	0	0	0	0	0	0	0	0	0	7	0	174	181	0	0	0	52	52
Тульская область	Частные; Очная	Прибыло студентов - всего (сумма стр. 02-05) / 1.0	0	0	0	0	0	0	0	0	0	0	0	0	0	443	443	0	0	0	392	392
Тульская область	Частные; Очная	"Численность студентов на начало прошлого учебного года
(на 1 октября) / 17.0"	0	0	0	0	0	0	0	0	0	0	0	0	0	2320	2320	0	0	0	436	436
Тульская область	Частные; Очно-заочная	            из стр. 11 - не прошли итоговую аттестацию / 12.0	0	0	0	0	0	0	0	0	0	0	0	0	0	0	0	0	0	0	0	0
Тульская область	Частные; Очно-заочная	"            из стр. 11 – лица с ограниченными возможностями здоровья,
            инвалиды, дети-инвалиды / 13.0"	0	0	0	0	0	0	0	0	0	0	0	0	0	0	0	0	0	0	0	0
Тульская область	Частные; Очно-заочная	         отчислено в виде меры дисциплинарного взыскания / 14.0	0	0	0	0	0	0	0	0	0	0	0	0	0	0	0	0	0	0	0	0
Тульская область	Частные; Очно-заочная	         отчислено из-за просрочки оплаты обучения / 15.0	0	0	0	0	0	0	0	0	0	0	0	0	0	0	0	0	0	0	0	0
Тульская область	Частные; Очно-заочная	"    в том числе:
    переведено на другие формы обучения данной
    организации на программы того же уровня / 7.0"	0	0	0	0	0	0	0	0	0	0	0	0	0	27	27	0	0	0	20	20
Тульская область	Частные; Очно-заочная	"    в том числе:
    переведено с других форм обучения данной
    образовательной организации с программ того же уровня / 2.0"	0	0	0	0	0	0	0	0	0	0	0	0	0	0	0	0	0	0	0	0
Тульская область	Частные; Очно-заочная	    восстановлены из числа ранее отчисленных / 4.0	0	0	0	0	0	0	0	0	0	0	0	0	0	0	0	0	0	0	0	0
Тульская область	Частные; Очно-заочная	    выбыло по другим причинам / 16.0	0	0	0	0	0	0	0	0	0	0	0	0	0	0	0	0	0	0	0	0
Тульская область	Частные; Очно-заочная	"    добровольно прекратили образовательные отношения
    (бросили учебу) / 10.0"	0	0	0	0	0	0	0	0	0	0	0	0	0	2	2	0	0	0	1	1
Тульская область	Частные; Очно-заочная	"    отчислено:
         по неуспеваемости / 11.0"	0	0	0	0	0	0	0	0	0	0	0	0	0	0	0	0	0	0	0	0
Тульская область	Частные; Очно-заочная	"    переведено в другие образовательные организации
    на программы того же уровня / 8.0"	0	0	0	0	0	0	0	0	0	0	0	0	0	0	0	0	0	0	0	0
Тульская область	Частные; Очно-заочная	"    переведено из других образовательных организаций 
    с программ того же уровня / 3.0"	0	0	0	0	0	0	0	0	0	0	0	0	0	2	2	0	0	0	0	0
Тульская область	Частные; Очно-заочная	    по болезни / 9.0	0	0	0	0	0	0	0	0	0	0	0	0	0	0	0	0	0	0	0	0
Тульская область	Частные; Очно-заочная	    прибыло по другим причинам / 5.0	0	0	0	0	0	0	0	0	0	0	0	0	0	0	0	0	0	0	0	0
Тульская область	Частные; Очно-заочная	Выбыло студентов - всего (сумма стр. 07-11, 13-15) / 6.0	0	0	0	0	0	0	0	0	0	0	0	0	0	29	29	0	0	0	21	21
Тульская область	Частные; Очно-заочная	Прибыло студентов - всего (сумма стр. 02-05) / 1.0	0	0	0	0	0	0	0	0	0	0	0	0	0	2	2	0	0	0	0	0
Тульская область	Частные; Очно-заочная	"Численность студентов на начало прошлого учебного года
(на 1 октября) / 17.0"	0	0	0	0	0	0	0	0	0	0	0	0	0	29	29	0	24	0	0	24
Тюменская область	Государственные, муниципальные (без учета организаций в ведении ФСИН); Заочная	            из стр. 11 - не прошли итоговую аттестацию / 12.0	0	0	0	0	0	0	0	0	0	0	0	0	0	0	0	0	0	0	0	0
Тюменская область	Государственные, муниципальные (без учета организаций в ведении ФСИН); Заочная	"            из стр. 11 – лица с ограниченными возможностями здоровья,
            инвалиды, дети-инвалиды / 13.0"	0	0	0	0	0	0	0	0	0	0	0	0	0	0	0	0	0	0	0	0
Тюменская область	Государственные, муниципальные (без учета организаций в ведении ФСИН); Заочная	         отчислено в виде меры дисциплинарного взыскания / 14.0	0	0	0	0	0	0	0	0	0	0	0	0	0	0	0	0	0	0	0	0
Тюменская область	Государственные, муниципальные (без учета организаций в ведении ФСИН); Заочная	         отчислено из-за просрочки оплаты обучения / 15.0	0	0	0	0	0	0	0	0	0	0	0	0	0	0	0	0	0	0	11	11
Тюменская область	Государственные, муниципальные (без учета организаций в ведении ФСИН); Заочная	"    в том числе:
    переведено на другие формы обучения данной
    организации на программы того же уровня / 7.0"	0	0	0	0	0	0	0	0	0	0	0	0	0	0	0	0	0	1	0	1
Тюменская область	Государственные, муниципальные (без учета организаций в ведении ФСИН); Заочная	"    в том числе:
    переведено с других форм обучения данной
    образовательной организации с программ того же уровня / 2.0"	0	0	0	0	0	0	0	0	0	0	0	0	0	0	0	0	0	1	6	7
Тюменская область	Государственные, муниципальные (без учета организаций в ведении ФСИН); Заочная	    восстановлены из числа ранее отчисленных / 4.0	0	0	0	0	0	0	0	0	0	0	1	0	0	0	1	0	0	0	14	14
Тюменская область	Государственные, муниципальные (без учета организаций в ведении ФСИН); Заочная	    выбыло по другим причинам / 16.0	0	0	0	0	0	0	0	0	0	0	3	0	0	0	3	0	0	1	0	1
Тюменская область	Государственные, муниципальные (без учета организаций в ведении ФСИН); Заочная	"    добровольно прекратили образовательные отношения
    (бросили учебу) / 10.0"	0	0	0	0	0	0	0	0	0	0	13	0	0	0	13	0	0	22	28	50
Тюменская область	Государственные, муниципальные (без учета организаций в ведении ФСИН); Заочная	"    отчислено:
         по неуспеваемости / 11.0"	0	0	0	0	0	0	0	0	0	0	0	0	0	0	0	0	0	31	19	50
Тюменская область	Государственные, муниципальные (без учета организаций в ведении ФСИН); Заочная	"    переведено в другие образовательные организации
    на программы того же уровня / 8.0"	0	0	0	0	0	0	0	0	0	0	0	0	0	0	0	0	0	0	0	0
Тюменская область	Государственные, муниципальные (без учета организаций в ведении ФСИН); Заочная	"    переведено из других образовательных организаций 
    с программ того же уровня / 3.0"	0	0	0	0	0	0	0	0	0	0	0	0	0	0	0	0	0	0	1	1
Тюменская область	Государственные, муниципальные (без учета организаций в ведении ФСИН); Заочная	    по болезни / 9.0	0	0	0	0	0	0	0	0	0	0	0	0	0	0	0	0	0	0	0	0
Тюменская область	Государственные, муниципальные (без учета организаций в ведении ФСИН); Заочная	    прибыло по другим причинам / 5.0	0	0	0	0	0	0	0	0	0	0	4	0	0	0	4	0	0	0	0	0
Тюменская область	Государственные, муниципальные (без учета организаций в ведении ФСИН); Заочная	Выбыло студентов - всего (сумма стр. 07-11, 13-15) / 6.0	0	0	0	0	0	0	0	0	0	0	16	0	0	0	16	0	0	55	58	113
Тюменская область	Государственные, муниципальные (без учета организаций в ведении ФСИН); Заочная	Прибыло студентов - всего (сумма стр. 02-05) / 1.0	0	0	0	0	0	0	0	0	0	0	5	0	0	0	5	0	0	1	21	22
Тюменская область	Государственные, муниципальные (без учета организаций в ведении ФСИН); Заочная	"Численность студентов на начало прошлого учебного года
(на 1 октября) / 17.0"	0	0	0	0	0	0	0	0	0	0	76	0	0	18	94	63	0	132	534	729
Тюменская область	Государственные, муниципальные (без учета организаций в ведении ФСИН); Очная	            из стр. 11 - не прошли итоговую аттестацию / 12.0	1	0	0	0	1	1	0	0	0	1	2	0	0	3	5	5	0	0	3	8
Тюменская область	Государственные, муниципальные (без учета организаций в ведении ФСИН); Очная	"            из стр. 11 – лица с ограниченными возможностями здоровья,
            инвалиды, дети-инвалиды / 13.0"	0	0	0	0	0	0	0	0	0	0	0	0	0	0	0	0	0	0	0	0
Тюменская область	Государственные, муниципальные (без учета организаций в ведении ФСИН); Очная	         отчислено в виде меры дисциплинарного взыскания / 14.0	2	0	0	0	2	0	0	0	0	0	5	0	1	3	9	6	0	0	0	6
Тюменская область	Государственные, муниципальные (без учета организаций в ведении ФСИН); Очная	         отчислено из-за просрочки оплаты обучения / 15.0	0	0	0	0	0	0	0	0	0	0	0	0	0	5	5	0	0	0	5	5
Тюменская область	Государственные, муниципальные (без учета организаций в ведении ФСИН); Очная	"    в том числе:
    переведено на другие формы обучения данной
    организации на программы того же уровня / 7.0"	17	0	0	0	17	1	0	0	0	1	10	0	6	47	63	4	0	1	20	25
Тюменская область	Государственные, муниципальные (без учета организаций в ведении ФСИН); Очная	"    в том числе:
    переведено с других форм обучения данной
    образовательной организации с программ того же уровня / 2.0"	9	0	0	1	10	5	0	0	0	5	39	0	18	10	67	26	0	9	2	37
Тюменская область	Государственные, муниципальные (без учета организаций в ведении ФСИН); Очная	    восстановлены из числа ранее отчисленных / 4.0	10	0	0	0	10	1	0	0	0	1	18	0	5	12	35	32	0	1	10	43
Тюменская область	Государственные, муниципальные (без учета организаций в ведении ФСИН); Очная	    выбыло по другим причинам / 16.0	98	0	0	0	98	46	0	0	0	46	149	0	5	44	198	90	0	11	32	133
Тюменская область	Государственные, муниципальные (без учета организаций в ведении ФСИН); Очная	"    добровольно прекратили образовательные отношения
    (бросили учебу) / 10.0"	259	0	0	10	269	131	0	0	5	136	316	0	92	180	588	765	0	47	186	998
Тюменская область	Государственные, муниципальные (без учета организаций в ведении ФСИН); Очная	"    отчислено:
         по неуспеваемости / 11.0"	31	0	0	1	32	8	0	0	0	8	37	0	50	45	132	78	0	4	34	116
Тюменская область	Государственные, муниципальные (без учета организаций в ведении ФСИН); Очная	"    переведено в другие образовательные организации
    на программы того же уровня / 8.0"	39	0	0	0	39	0	0	0	0	0	43	0	4	28	75	55	0	1	6	62
Тюменская область	Государственные, муниципальные (без учета организаций в ведении ФСИН); Очная	"    переведено из других образовательных организаций 
    с программ того же уровня / 3.0"	34	0	0	0	34	3	0	0	1	4	32	0	19	25	76	28	0	1	2	31
Тюменская область	Государственные, муниципальные (без учета организаций в ведении ФСИН); Очная	    по болезни / 9.0	0	0	0	0	0	1	0	0	0	1	3	0	0	3	6	7	0	0	0	7
Тюменская область	Государственные, муниципальные (без учета организаций в ведении ФСИН); Очная	    прибыло по другим причинам / 5.0	81	0	0	1	82	24	0	0	0	24	80	0	6	4	90	68	0	2	3	73
Тюменская область	Государственные, муниципальные (без учета организаций в ведении ФСИН); Очная	Выбыло студентов - всего (сумма стр. 07-11, 13-15) / 6.0	446	0	0	11	457	187	0	0	5	192	563	0	158	355	1076	1005	0	64	283	1352
Тюменская область	Государственные, муниципальные (без учета организаций в ведении ФСИН); Очная	Прибыло студентов - всего (сумма стр. 02-05) / 1.0	134	0	0	2	136	33	0	0	1	34	169	0	48	51	268	154	0	13	17	184
Тюменская область	Государственные, муниципальные (без учета организаций в ведении ФСИН); Очная	"Численность студентов на начало прошлого учебного года
(на 1 октября) / 17.0"	5606	0	0	166	5772	1629	0	0	49	1678	7567	0	2318	3875	13760	9913	0	697	2012	12622
Тюменская область	Очно-заочная; Государственные, муниципальные (без учета организаций в ведении ФСИН)	            из стр. 11 - не прошли итоговую аттестацию / 12.0	0	0	0	0	0	0	0	0	0	0	0	0	0	0	0	0	0	0	0	0
Тюменская область	Очно-заочная; Государственные, муниципальные (без учета организаций в ведении ФСИН)	"            из стр. 11 – лица с ограниченными возможностями здоровья,
            инвалиды, дети-инвалиды / 13.0"	0	0	0	0	0	0	0	0	0	0	0	0	0	0	0	0	0	0	0	0
Тюменская область	Очно-заочная; Государственные, муниципальные (без учета организаций в ведении ФСИН)	         отчислено в виде меры дисциплинарного взыскания / 14.0	0	0	0	0	0	0	0	0	0	0	0	0	0	0	0	0	0	0	0	0
Тюменская область	Очно-заочная; Государственные, муниципальные (без учета организаций в ведении ФСИН)	         отчислено из-за просрочки оплаты обучения / 15.0	0	0	0	0	0	0	0	0	0	0	0	0	0	0	0	0	0	0	0	0
Тюменская область	Очно-заочная; Государственные, муниципальные (без учета организаций в ведении ФСИН)	"    в том числе:
    переведено на другие формы обучения данной
    организации на программы того же уровня / 7.0"	0	0	0	0	0	0	0	0	0	0	0	0	0	0	0	0	0	0	0	0
Тюменская область	Очно-заочная; Государственные, муниципальные (без учета организаций в ведении ФСИН)	"    в том числе:
    переведено с других форм обучения данной
    образовательной организации с программ того же уровня / 2.0"	0	0	0	0	0	0	0	0	0	0	0	0	0	0	0	1	0	0	0	1
Тюменская область	Очно-заочная; Государственные, муниципальные (без учета организаций в ведении ФСИН)	    восстановлены из числа ранее отчисленных / 4.0	0	0	0	0	0	0	0	0	0	0	0	0	0	0	0	2	0	0	3	5
Тюменская область	Очно-заочная; Государственные, муниципальные (без учета организаций в ведении ФСИН)	    выбыло по другим причинам / 16.0	0	0	0	0	0	0	0	0	0	0	0	0	0	0	0	0	0	0	2	2
Тюменская область	Очно-заочная; Государственные, муниципальные (без учета организаций в ведении ФСИН)	"    добровольно прекратили образовательные отношения
    (бросили учебу) / 10.0"	0	0	0	0	0	0	0	0	0	0	0	0	0	0	0	12	0	0	10	22
Тюменская область	Очно-заочная; Государственные, муниципальные (без учета организаций в ведении ФСИН)	"    отчислено:
         по неуспеваемости / 11.0"	0	0	0	0	0	0	0	0	0	0	0	0	0	0	0	2	0	0	2	4
Тюменская область	Очно-заочная; Государственные, муниципальные (без учета организаций в ведении ФСИН)	"    переведено в другие образовательные организации
    на программы того же уровня / 8.0"	0	0	0	0	0	0	0	0	0	0	0	0	0	0	0	1	0	0	0	1
Тюменская область	Очно-заочная; Государственные, муниципальные (без учета организаций в ведении ФСИН)	"    переведено из других образовательных организаций 
    с программ того же уровня / 3.0"	0	0	0	0	0	0	0	0	0	0	0	0	0	0	0	0	0	0	1	1
Тюменская область	Очно-заочная; Государственные, муниципальные (без учета организаций в ведении ФСИН)	    по болезни / 9.0	0	0	0	0	0	0	0	0	0	0	0	0	0	0	0	0	0	0	0	0
Тюменская область	Очно-заочная; Государственные, муниципальные (без учета организаций в ведении ФСИН)	    прибыло по другим причинам / 5.0	0	0	0	0	0	0	0	0	0	0	0	0	0	0	0	2	0	0	0	2
Тюменская область	Очно-заочная; Государственные, муниципальные (без учета организаций в ведении ФСИН)	Выбыло студентов - всего (сумма стр. 07-11, 13-15) / 6.0	0	0	0	0	0	0	0	0	0	0	0	0	0	0	0	15	0	0	14	29
Тюменская область	Очно-заочная; Государственные, муниципальные (без учета организаций в ведении ФСИН)	Прибыло студентов - всего (сумма стр. 02-05) / 1.0	0	0	0	0	0	0	0	0	0	0	0	0	0	0	0	5	0	0	4	9
Тюменская область	Очно-заочная; Государственные, муниципальные (без учета организаций в ведении ФСИН)	"Численность студентов на начало прошлого учебного года
(на 1 октября) / 17.0"	0	0	0	0	0	0	0	0	0	0	0	0	0	0	0	78	0	0	209	287
Тюменская область	Частные; Заочная	            из стр. 11 - не прошли итоговую аттестацию / 12.0	0	0	0	0	0	0	0	0	0	0	0	0	0	0	0	0	0	0	0	0
Тюменская область	Частные; Заочная	"            из стр. 11 – лица с ограниченными возможностями здоровья,
            инвалиды, дети-инвалиды / 13.0"	0	0	0	0	0	0	0	0	0	0	0	0	0	0	0	0	0	0	0	0
Тюменская область	Частные; Заочная	         отчислено в виде меры дисциплинарного взыскания / 14.0	0	0	0	0	0	0	0	0	0	0	0	0	0	0	0	0	0	0	0	0
Тюменская область	Частные; Заочная	         отчислено из-за просрочки оплаты обучения / 15.0	0	0	0	0	0	0	0	0	0	0	0	0	0	0	0	0	0	0	5	5
Тюменская область	Частные; Заочная	"    в том числе:
    переведено на другие формы обучения данной
    организации на программы того же уровня / 7.0"	0	0	0	0	0	0	0	0	0	0	0	0	0	0	0	0	0	0	0	0
Тюменская область	Частные; Заочная	"    в том числе:
    переведено с других форм обучения данной
    образовательной организации с программ того же уровня / 2.0"	0	0	0	0	0	0	0	0	0	0	0	0	0	0	0	0	0	0	11	11
Тюменская область	Частные; Заочная	    восстановлены из числа ранее отчисленных / 4.0	0	0	0	0	0	0	0	0	0	0	0	0	0	0	0	0	0	0	1	1
Тюменская область	Частные; Заочная	    выбыло по другим причинам / 16.0	0	0	0	0	0	0	0	0	0	0	0	0	0	0	0	0	0	0	6	6
Тюменская область	Частные; Заочная	"    добровольно прекратили образовательные отношения
    (бросили учебу) / 10.0"	0	0	0	0	0	0	0	0	0	0	0	0	0	0	0	0	0	0	15	15
Тюменская область	Частные; Заочная	"    отчислено:
         по неуспеваемости / 11.0"	0	0	0	0	0	0	0	0	0	0	0	0	0	0	0	0	0	0	1	1
Тюменская область	Частные; Заочная	"    переведено в другие образовательные организации
    на программы того же уровня / 8.0"	0	0	0	0	0	0	0	0	0	0	0	0	0	0	0	0	0	0	2	2
Тюменская область	Частные; Заочная	"    переведено из других образовательных организаций 
    с программ того же уровня / 3.0"	0	0	0	0	0	0	0	0	0	0	0	0	0	0	0	0	0	0	0	0
Тюменская область	Частные; Заочная	    по болезни / 9.0	0	0	0	0	0	0	0	0	0	0	0	0	0	0	0	0	0	0	0	0
Тюменская область	Частные; Заочная	    прибыло по другим причинам / 5.0	0	0	0	0	0	0	0	0	0	0	0	0	0	0	0	0	0	0	0	0
Тюменская область	Частные; Заочная	Выбыло студентов - всего (сумма стр. 07-11, 13-15) / 6.0	0	0	0	0	0	0	0	0	0	0	0	0	0	0	0	0	0	0	29	29
Тюменская область	Частные; Заочная	Прибыло студентов - всего (сумма стр. 02-05) / 1.0	0	0	0	0	0	0	0	0	0	0	0	0	0	0	0	0	0	0	12	12
Тюменская область	Частные; Заочная	"Численность студентов на начало прошлого учебного года
(на 1 октября) / 17.0"	0	0	0	0	0	0	0	0	0	0	0	0	0	0	0	0	0	0	278	278
Тюменская область	Частные; Очная	            из стр. 11 - не прошли итоговую аттестацию / 12.0	0	0	0	0	0	0	0	0	0	0	0	0	0	1	1	0	0	0	0	0
Тюменская область	Частные; Очная	"            из стр. 11 – лица с ограниченными возможностями здоровья,
            инвалиды, дети-инвалиды / 13.0"	0	0	0	0	0	0	0	0	0	0	0	0	0	0	0	0	0	0	0	0
Тюменская область	Частные; Очная	         отчислено в виде меры дисциплинарного взыскания / 14.0	0	0	0	0	0	0	0	0	0	0	0	0	0	0	0	0	0	0	0	0
Тюменская область	Частные; Очная	         отчислено из-за просрочки оплаты обучения / 15.0	0	0	0	0	0	0	0	0	0	0	0	0	0	0	0	0	0	0	0	0
Тюменская область	Частные; Очная	"    в том числе:
    переведено на другие формы обучения данной
    организации на программы того же уровня / 7.0"	0	0	0	0	0	0	0	0	0	0	0	0	0	0	0	1	0	0	10	11
Тюменская область	Частные; Очная	"    в том числе:
    переведено с других форм обучения данной
    образовательной организации с программ того же уровня / 2.0"	0	0	0	0	0	0	0	0	0	0	0	0	0	0	0	0	0	0	0	0
Тюменская область	Частные; Очная	    восстановлены из числа ранее отчисленных / 4.0	0	0	0	0	0	0	0	0	0	0	0	0	0	0	0	0	0	0	0	0
Тюменская область	Частные; Очная	    выбыло по другим причинам / 16.0	0	0	0	0	0	0	0	0	0	0	0	0	0	3	3	0	0	0	2	2
Тюменская область	Частные; Очная	"    добровольно прекратили образовательные отношения
    (бросили учебу) / 10.0"	0	0	0	0	0	0	0	0	0	0	3	0	0	29	32	16	0	0	12	28
Тюменская область	Частные; Очная	"    отчислено:
         по неуспеваемости / 11.0"	0	0	0	0	0	0	0	0	0	0	0	0	0	1	1	2	0	0	1	3
Тюменская область	Частные; Очная	"    переведено в другие образовательные организации
    на программы того же уровня / 8.0"	0	0	0	0	0	0	0	0	0	0	1	0	0	8	9	0	0	0	0	0
Тюменская область	Частные; Очная	"    переведено из других образовательных организаций 
    с программ того же уровня / 3.0"	0	0	0	0	0	0	0	0	0	0	0	0	0	3	3	0	0	0	0	0
Тюменская область	Частные; Очная	    по болезни / 9.0	0	0	0	0	0	0	0	0	0	0	0	0	0	0	0	0	0	0	0	0
Тюменская область	Частные; Очная	    прибыло по другим причинам / 5.0	0	0	0	0	0	0	0	0	0	0	0	0	0	0	0	0	0	0	0	0
Тюменская область	Частные; Очная	Выбыло студентов - всего (сумма стр. 07-11, 13-15) / 6.0	0	0	0	0	0	0	0	0	0	0	4	0	0	41	45	19	0	0	25	44
Тюменская область	Частные; Очная	Прибыло студентов - всего (сумма стр. 02-05) / 1.0	0	0	0	0	0	0	0	0	0	0	0	0	0	3	3	0	0	0	0	0
Тюменская область	Частные; Очная	"Численность студентов на начало прошлого учебного года
(на 1 октября) / 17.0"	0	0	0	0	0	75	0	0	0	75	75	0	0	971	1046	183	0	0	408	591
Удмуртская Республика	Государственные, муниципальные (без учета организаций в ведении ФСИН); Заочная	            из стр. 11 - не прошли итоговую аттестацию / 12.0	0	0	0	0	0	0	0	0	0	0	0	0	0	0	0	0	0	0	1	1
Удмуртская Республика	Государственные, муниципальные (без учета организаций в ведении ФСИН); Заочная	"            из стр. 11 – лица с ограниченными возможностями здоровья,
            инвалиды, дети-инвалиды / 13.0"	0	0	0	0	0	0	0	0	0	0	0	0	0	0	0	0	0	0	0	0
Удмуртская Республика	Государственные, муниципальные (без учета организаций в ведении ФСИН); Заочная	         отчислено в виде меры дисциплинарного взыскания / 14.0	0	0	0	0	0	0	0	0	0	0	0	0	0	0	0	0	0	0	6	6
Удмуртская Республика	Государственные, муниципальные (без учета организаций в ведении ФСИН); Заочная	         отчислено из-за просрочки оплаты обучения / 15.0	0	0	0	0	0	0	0	0	0	0	0	0	0	0	0	0	0	0	8	8
Удмуртская Республика	Государственные, муниципальные (без учета организаций в ведении ФСИН); Заочная	"    в том числе:
    переведено на другие формы обучения данной
    организации на программы того же уровня / 7.0"	0	0	0	0	0	0	0	0	0	0	0	0	0	3	3	1	0	0	2	3
Удмуртская Республика	Государственные, муниципальные (без учета организаций в ведении ФСИН); Заочная	"    в том числе:
    переведено с других форм обучения данной
    образовательной организации с программ того же уровня / 2.0"	0	0	0	0	0	0	0	0	0	0	0	0	0	4	4	39	0	0	10	49
Удмуртская Республика	Государственные, муниципальные (без учета организаций в ведении ФСИН); Заочная	    восстановлены из числа ранее отчисленных / 4.0	0	0	0	0	0	0	0	0	0	0	0	0	0	3	3	15	0	0	18	33
Удмуртская Республика	Государственные, муниципальные (без учета организаций в ведении ФСИН); Заочная	    выбыло по другим причинам / 16.0	0	0	0	0	0	0	0	0	0	0	0	0	0	3	3	15	0	0	13	28
Удмуртская Республика	Государственные, муниципальные (без учета организаций в ведении ФСИН); Заочная	"    добровольно прекратили образовательные отношения
    (бросили учебу) / 10.0"	0	0	0	0	0	0	0	0	0	0	0	0	0	25	25	107	0	0	71	178
Удмуртская Республика	Государственные, муниципальные (без учета организаций в ведении ФСИН); Заочная	"    отчислено:
         по неуспеваемости / 11.0"	0	0	0	0	0	0	0	0	0	0	0	0	0	6	6	110	0	0	24	134
Удмуртская Республика	Государственные, муниципальные (без учета организаций в ведении ФСИН); Заочная	"    переведено в другие образовательные организации
    на программы того же уровня / 8.0"	0	0	0	0	0	0	0	0	0	0	0	0	0	0	0	1	0	0	0	1
Удмуртская Республика	Государственные, муниципальные (без учета организаций в ведении ФСИН); Заочная	"    переведено из других образовательных организаций 
    с программ того же уровня / 3.0"	0	0	0	0	0	0	0	0	0	0	0	0	0	1	1	3	0	0	3	6
Удмуртская Республика	Государственные, муниципальные (без учета организаций в ведении ФСИН); Заочная	    по болезни / 9.0	0	0	0	0	0	0	0	0	0	0	0	0	0	0	0	0	0	0	0	0
Удмуртская Республика	Государственные, муниципальные (без учета организаций в ведении ФСИН); Заочная	    прибыло по другим причинам / 5.0	0	0	0	0	0	0	0	0	0	0	0	0	0	0	0	21	0	0	19	40
Удмуртская Республика	Государственные, муниципальные (без учета организаций в ведении ФСИН); Заочная	Выбыло студентов - всего (сумма стр. 07-11, 13-15) / 6.0	0	0	0	0	0	0	0	0	0	0	0	0	0	37	37	234	0	0	124	358
Удмуртская Республика	Государственные, муниципальные (без учета организаций в ведении ФСИН); Заочная	Прибыло студентов - всего (сумма стр. 02-05) / 1.0	0	0	0	0	0	0	0	0	0	0	0	0	0	8	8	78	0	0	50	128
Удмуртская Республика	Государственные, муниципальные (без учета организаций в ведении ФСИН); Заочная	"Численность студентов на начало прошлого учебного года
(на 1 октября) / 17.0"	0	0	0	0	0	0	0	0	0	0	0	0	5	284	289	1257	0	0	683	1940
Удмуртская Республика	Государственные, муниципальные (без учета организаций в ведении ФСИН); Очная	            из стр. 11 - не прошли итоговую аттестацию / 12.0	5	0	0	0	5	0	0	0	0	0	3	0	0	2	5	0	0	0	0	0
Удмуртская Республика	Государственные, муниципальные (без учета организаций в ведении ФСИН); Очная	"            из стр. 11 – лица с ограниченными возможностями здоровья,
            инвалиды, дети-инвалиды / 13.0"	0	0	0	0	0	0	0	0	0	0	1	0	0	0	1	0	0	0	0	0
Удмуртская Республика	Государственные, муниципальные (без учета организаций в ведении ФСИН); Очная	         отчислено в виде меры дисциплинарного взыскания / 14.0	5	0	0	3	8	0	0	0	0	0	4	0	3	3	10	0	0	0	1	1
Удмуртская Республика	Государственные, муниципальные (без учета организаций в ведении ФСИН); Очная	         отчислено из-за просрочки оплаты обучения / 15.0	0	0	0	0	0	0	0	0	1	1	0	0	0	33	33	0	0	0	10	10
Удмуртская Республика	Государственные, муниципальные (без учета организаций в ведении ФСИН); Очная	"    в том числе:
    переведено на другие формы обучения данной
    организации на программы того же уровня / 7.0"	46	0	0	5	51	0	0	0	0	0	76	0	0	87	163	7	0	1	4	12
Удмуртская Республика	Государственные, муниципальные (без учета организаций в ведении ФСИН); Очная	"    в том числе:
    переведено с других форм обучения данной
    образовательной организации с программ того же уровня / 2.0"	56	0	0	0	56	0	0	0	4	4	47	0	10	70	127	0	0	0	7	7
Удмуртская Республика	Государственные, муниципальные (без учета организаций в ведении ФСИН); Очная	    восстановлены из числа ранее отчисленных / 4.0	24	0	0	2	26	0	0	0	0	0	42	0	1	75	118	5	0	0	10	15
Удмуртская Республика	Государственные, муниципальные (без учета организаций в ведении ФСИН); Очная	    выбыло по другим причинам / 16.0	150	0	0	0	150	0	0	0	0	0	138	0	6	104	248	2	0	1	13	16
Удмуртская Республика	Государственные, муниципальные (без учета организаций в ведении ФСИН); Очная	"    добровольно прекратили образовательные отношения
    (бросили учебу) / 10.0"	591	0	0	15	606	6	0	0	4	10	731	0	41	355	1127	65	0	4	71	140
Удмуртская Республика	Государственные, муниципальные (без учета организаций в ведении ФСИН); Очная	"    отчислено:
         по неуспеваемости / 11.0"	132	0	0	4	136	3	0	0	2	5	188	0	3	127	318	11	0	1	21	33
Удмуртская Республика	Государственные, муниципальные (без учета организаций в ведении ФСИН); Очная	"    переведено в другие образовательные организации
    на программы того же уровня / 8.0"	103	0	0	8	111	0	0	0	0	0	236	0	7	119	362	3	0	0	7	10
Удмуртская Республика	Государственные, муниципальные (без учета организаций в ведении ФСИН); Очная	"    переведено из других образовательных организаций 
    с программ того же уровня / 3.0"	72	0	0	0	72	0	0	0	6	6	133	0	3	84	220	3	0	0	8	11
Удмуртская Республика	Государственные, муниципальные (без учета организаций в ведении ФСИН); Очная	    по болезни / 9.0	15	0	0	0	15	2	0	0	0	2	8	0	0	1	9	0	0	0	0	0
Удмуртская Республика	Государственные, муниципальные (без учета организаций в ведении ФСИН); Очная	    прибыло по другим причинам / 5.0	82	0	0	1	83	1	0	0	0	1	106	0	20	77	203	5	0	5	9	19
Удмуртская Республика	Государственные, муниципальные (без учета организаций в ведении ФСИН); Очная	Выбыло студентов - всего (сумма стр. 07-11, 13-15) / 6.0	1042	0	0	35	1077	11	0	0	7	18	1381	0	60	829	2270	88	0	7	127	222
Удмуртская Республика	Государственные, муниципальные (без учета организаций в ведении ФСИН); Очная	Прибыло студентов - всего (сумма стр. 02-05) / 1.0	234	0	0	3	237	1	0	0	10	11	328	0	34	306	668	13	0	5	34	52
Удмуртская Республика	Государственные, муниципальные (без учета организаций в ведении ФСИН); Очная	"Численность студентов на начало прошлого учебного года
(на 1 октября) / 17.0"	8510	0	0	245	8755	34	0	0	11	45	13968	0	1222	6644	21834	752	0	154	816	1722
Удмуртская Республика	Очно-заочная; Государственные, муниципальные (без учета организаций в ведении ФСИН)	            из стр. 11 - не прошли итоговую аттестацию / 12.0	0	0	0	0	0	0	0	0	0	0	0	0	0	1	1	0	0	0	0	0
Удмуртская Республика	Очно-заочная; Государственные, муниципальные (без учета организаций в ведении ФСИН)	"            из стр. 11 – лица с ограниченными возможностями здоровья,
            инвалиды, дети-инвалиды / 13.0"	0	0	0	0	0	0	0	0	0	0	0	0	0	0	0	0	0	0	0	0
Удмуртская Республика	Очно-заочная; Государственные, муниципальные (без учета организаций в ведении ФСИН)	         отчислено в виде меры дисциплинарного взыскания / 14.0	0	0	0	0	0	0	0	0	0	0	0	0	0	0	0	0	0	0	0	0
Удмуртская Республика	Очно-заочная; Государственные, муниципальные (без учета организаций в ведении ФСИН)	         отчислено из-за просрочки оплаты обучения / 15.0	0	0	0	0	0	0	0	0	0	0	0	0	0	0	0	0	0	0	0	0
Удмуртская Республика	Очно-заочная; Государственные, муниципальные (без учета организаций в ведении ФСИН)	"    в том числе:
    переведено на другие формы обучения данной
    организации на программы того же уровня / 7.0"	0	0	0	0	0	0	0	0	0	0	0	0	0	0	0	0	0	0	0	0
Удмуртская Республика	Очно-заочная; Государственные, муниципальные (без учета организаций в ведении ФСИН)	"    в том числе:
    переведено с других форм обучения данной
    образовательной организации с программ того же уровня / 2.0"	0	0	0	0	0	0	0	0	0	0	0	0	0	0	0	0	0	0	0	0
Удмуртская Республика	Очно-заочная; Государственные, муниципальные (без учета организаций в ведении ФСИН)	    восстановлены из числа ранее отчисленных / 4.0	0	0	0	0	0	0	0	0	0	0	0	0	0	0	0	1	0	0	11	12
Удмуртская Республика	Очно-заочная; Государственные, муниципальные (без учета организаций в ведении ФСИН)	    выбыло по другим причинам / 16.0	0	0	0	0	0	0	0	0	0	0	0	0	0	0	0	1	0	0	0	1
Удмуртская Республика	Очно-заочная; Государственные, муниципальные (без учета организаций в ведении ФСИН)	"    добровольно прекратили образовательные отношения
    (бросили учебу) / 10.0"	0	0	0	0	0	0	0	0	0	0	0	0	0	3	3	10	0	0	14	24
Удмуртская Республика	Очно-заочная; Государственные, муниципальные (без учета организаций в ведении ФСИН)	"    отчислено:
         по неуспеваемости / 11.0"	0	0	0	0	0	0	0	0	0	0	0	0	0	1	1	2	0	0	1	3
Удмуртская Республика	Очно-заочная; Государственные, муниципальные (без учета организаций в ведении ФСИН)	"    переведено в другие образовательные организации
    на программы того же уровня / 8.0"	0	0	0	0	0	0	0	0	0	0	0	0	0	3	3	0	0	0	1	1
Удмуртская Республика	Очно-заочная; Государственные, муниципальные (без учета организаций в ведении ФСИН)	"    переведено из других образовательных организаций 
    с программ того же уровня / 3.0"	0	0	0	0	0	0	0	0	0	0	0	0	0	0	0	0	0	0	0	0
Удмуртская Республика	Очно-заочная; Государственные, муниципальные (без учета организаций в ведении ФСИН)	    по болезни / 9.0	0	0	0	0	0	0	0	0	0	0	0	0	0	0	0	0	0	0	0	0
Удмуртская Республика	Очно-заочная; Государственные, муниципальные (без учета организаций в ведении ФСИН)	    прибыло по другим причинам / 5.0	0	0	0	0	0	0	0	0	0	0	0	0	0	0	0	0	0	0	2	2
Удмуртская Республика	Очно-заочная; Государственные, муниципальные (без учета организаций в ведении ФСИН)	Выбыло студентов - всего (сумма стр. 07-11, 13-15) / 6.0	0	0	0	0	0	0	0	0	0	0	0	0	0	7	7	13	0	0	16	29
Удмуртская Республика	Очно-заочная; Государственные, муниципальные (без учета организаций в ведении ФСИН)	Прибыло студентов - всего (сумма стр. 02-05) / 1.0	0	0	0	0	0	0	0	0	0	0	0	0	0	0	0	1	0	0	13	14
Удмуртская Республика	Очно-заочная; Государственные, муниципальные (без учета организаций в ведении ФСИН)	"Численность студентов на начало прошлого учебного года
(на 1 октября) / 17.0"	0	0	0	0	0	0	0	0	0	0	0	0	0	83	83	165	0	0	138	303
Удмуртская Республика	Частные; Заочная	            из стр. 11 - не прошли итоговую аттестацию / 12.0	0	0	0	0	0	0	0	0	0	0	0	0	0	0	0	0	0	0	0	0
Удмуртская Республика	Частные; Заочная	"            из стр. 11 – лица с ограниченными возможностями здоровья,
            инвалиды, дети-инвалиды / 13.0"	0	0	0	0	0	0	0	0	0	0	0	0	0	0	0	0	0	0	0	0
Удмуртская Республика	Частные; Заочная	         отчислено в виде меры дисциплинарного взыскания / 14.0	0	0	0	0	0	0	0	0	0	0	0	0	0	0	0	0	0	0	0	0
Удмуртская Республика	Частные; Заочная	         отчислено из-за просрочки оплаты обучения / 15.0	0	0	0	0	0	0	0	0	0	0	0	0	0	134	134	0	0	0	100	100
Удмуртская Республика	Частные; Заочная	"    в том числе:
    переведено на другие формы обучения данной
    организации на программы того же уровня / 7.0"	0	0	0	0	0	0	0	0	0	0	0	0	0	44	44	0	0	0	13	13
Удмуртская Республика	Частные; Заочная	"    в том числе:
    переведено с других форм обучения данной
    образовательной организации с программ того же уровня / 2.0"	0	0	0	0	0	0	0	0	0	0	0	0	0	105	105	0	0	0	13	13
Удмуртская Республика	Частные; Заочная	    восстановлены из числа ранее отчисленных / 4.0	0	0	0	0	0	0	0	0	0	0	0	0	0	58	58	0	0	0	14	14
Удмуртская Республика	Частные; Заочная	    выбыло по другим причинам / 16.0	0	0	0	0	0	0	0	0	0	0	0	0	0	43	43	0	0	0	17	17
Удмуртская Республика	Частные; Заочная	"    добровольно прекратили образовательные отношения
    (бросили учебу) / 10.0"	0	0	0	0	0	0	0	0	0	0	0	0	0	82	82	0	0	0	86	86
Удмуртская Республика	Частные; Заочная	"    отчислено:
         по неуспеваемости / 11.0"	0	0	0	0	0	0	0	0	0	0	0	0	0	33	33	0	0	0	35	35
Удмуртская Республика	Частные; Заочная	"    переведено в другие образовательные организации
    на программы того же уровня / 8.0"	0	0	0	0	0	0	0	0	0	0	0	0	0	4	4	0	0	0	2	2
Удмуртская Республика	Частные; Заочная	"    переведено из других образовательных организаций 
    с программ того же уровня / 3.0"	0	0	0	0	0	0	0	0	0	0	0	0	0	40	40	0	0	0	5	5
Удмуртская Республика	Частные; Заочная	    по болезни / 9.0	0	0	0	0	0	0	0	0	0	0	0	0	0	0	0	0	0	0	0	0
Удмуртская Республика	Частные; Заочная	    прибыло по другим причинам / 5.0	0	0	0	0	0	0	0	0	0	0	0	0	0	3	3	0	0	0	18	18
Удмуртская Республика	Частные; Заочная	Выбыло студентов - всего (сумма стр. 07-11, 13-15) / 6.0	0	0	0	0	0	0	0	0	0	0	0	0	0	340	340	0	0	0	253	253
Удмуртская Республика	Частные; Заочная	Прибыло студентов - всего (сумма стр. 02-05) / 1.0	0	0	0	0	0	0	0	0	0	0	0	0	0	206	206	0	0	0	50	50
Удмуртская Республика	Частные; Заочная	"Численность студентов на начало прошлого учебного года
(на 1 октября) / 17.0"	0	0	0	0	0	0	0	0	0	0	0	0	0	2086	2086	0	0	0	1318	1318
Удмуртская Республика	Частные; Очная	            из стр. 11 - не прошли итоговую аттестацию / 12.0	0	0	0	0	0	0	0	0	0	0	0	0	0	10	10	0	0	0	1	1
Удмуртская Республика	Частные; Очная	"            из стр. 11 – лица с ограниченными возможностями здоровья,
            инвалиды, дети-инвалиды / 13.0"	0	0	0	0	0	0	0	0	0	0	0	0	0	0	0	0	0	0	0	0
Удмуртская Республика	Частные; Очная	         отчислено в виде меры дисциплинарного взыскания / 14.0	0	0	0	0	0	0	0	0	0	0	0	0	0	0	0	0	0	0	0	0
Удмуртская Республика	Частные; Очная	         отчислено из-за просрочки оплаты обучения / 15.0	0	0	0	0	0	0	0	0	0	0	0	0	0	62	62	0	0	0	19	19
Удмуртская Республика	Частные; Очная	"    в том числе:
    переведено на другие формы обучения данной
    организации на программы того же уровня / 7.0"	0	0	0	0	0	0	0	0	4	4	3	0	0	179	182	0	0	0	220	220
Удмуртская Республика	Частные; Очная	"    в том числе:
    переведено с других форм обучения данной
    образовательной организации с программ того же уровня / 2.0"	0	0	0	1	1	0	0	0	3	3	7	0	0	12	19	0	0	0	2	2
Удмуртская Республика	Частные; Очная	    восстановлены из числа ранее отчисленных / 4.0	0	0	0	0	0	0	0	0	0	0	0	0	0	48	48	0	0	0	4	4
Удмуртская Республика	Частные; Очная	    выбыло по другим причинам / 16.0	0	0	0	0	0	0	0	0	0	0	0	0	0	144	144	0	0	0	25	25
Удмуртская Республика	Частные; Очная	"    добровольно прекратили образовательные отношения
    (бросили учебу) / 10.0"	0	0	0	0	0	0	0	0	3	3	5	0	0	214	219	0	0	0	38	38
Удмуртская Республика	Частные; Очная	"    отчислено:
         по неуспеваемости / 11.0"	0	0	0	0	0	0	0	0	0	0	1	0	0	165	166	0	0	0	19	19
Удмуртская Республика	Частные; Очная	"    переведено в другие образовательные организации
    на программы того же уровня / 8.0"	0	0	0	0	0	0	0	0	0	0	0	0	0	76	76	0	0	0	1	1
Удмуртская Республика	Частные; Очная	"    переведено из других образовательных организаций 
    с программ того же уровня / 3.0"	0	0	0	0	0	0	0	0	0	0	0	0	0	81	81	0	0	0	1	1
Удмуртская Республика	Частные; Очная	    по болезни / 9.0	0	0	0	0	0	0	0	0	0	0	0	0	0	0	0	0	0	0	0	0
Удмуртская Республика	Частные; Очная	    прибыло по другим причинам / 5.0	0	0	0	0	0	0	0	0	0	0	0	0	0	170	170	0	0	0	33	33
Удмуртская Республика	Частные; Очная	Выбыло студентов - всего (сумма стр. 07-11, 13-15) / 6.0	0	0	0	0	0	0	0	0	7	7	9	0	0	840	849	0	0	0	322	322
Удмуртская Республика	Частные; Очная	Прибыло студентов - всего (сумма стр. 02-05) / 1.0	0	0	0	1	1	0	0	0	3	3	7	0	0	311	318	0	0	0	40	40
Удмуртская Республика	Частные; Очная	"Численность студентов на начало прошлого учебного года
(на 1 октября) / 17.0"	0	0	0	0	0	0	0	0	19	19	128	0	0	4571	4699	0	0	0	601	601
Удмуртская Республика	Частные; Очно-заочная	            из стр. 11 - не прошли итоговую аттестацию / 12.0	0	0	0	0	0	0	0	0	0	0	0	0	0	0	0	0	0	0	0	0
Удмуртская Республика	Частные; Очно-заочная	"            из стр. 11 – лица с ограниченными возможностями здоровья,
            инвалиды, дети-инвалиды / 13.0"	0	0	0	0	0	0	0	0	0	0	0	0	0	0	0	0	0	0	0	0
Удмуртская Республика	Частные; Очно-заочная	         отчислено в виде меры дисциплинарного взыскания / 14.0	0	0	0	0	0	0	0	0	0	0	0	0	0	0	0	0	0	0	0	0
Удмуртская Республика	Частные; Очно-заочная	         отчислено из-за просрочки оплаты обучения / 15.0	0	0	0	28	28	0	0	0	20	20	0	0	0	38	38	0	0	0	50	50
Удмуртская Республика	Частные; Очно-заочная	"    в том числе:
    переведено на другие формы обучения данной
    организации на программы того же уровня / 7.0"	0	0	0	5	5	0	0	0	2	2	0	0	0	11	11	0	0	0	2	2
Удмуртская Республика	Частные; Очно-заочная	"    в том числе:
    переведено с других форм обучения данной
    образовательной организации с программ того же уровня / 2.0"	0	0	0	44	44	0	0	0	34	34	0	0	0	62	62	0	0	0	185	185
Удмуртская Республика	Частные; Очно-заочная	    восстановлены из числа ранее отчисленных / 4.0	0	0	0	1	1	0	0	0	0	0	0	0	0	2	2	0	0	0	1	1
Удмуртская Республика	Частные; Очно-заочная	    выбыло по другим причинам / 16.0	0	0	0	0	0	0	0	0	0	0	0	0	0	0	0	0	0	0	0	0
Удмуртская Республика	Частные; Очно-заочная	"    добровольно прекратили образовательные отношения
    (бросили учебу) / 10.0"	0	0	0	18	18	0	0	0	8	8	0	0	0	20	20	0	0	0	14	14
Удмуртская Республика	Частные; Очно-заочная	"    отчислено:
         по неуспеваемости / 11.0"	0	0	0	0	0	0	0	0	0	0	0	0	0	1	1	0	0	0	0	0
Удмуртская Республика	Частные; Очно-заочная	"    переведено в другие образовательные организации
    на программы того же уровня / 8.0"	0	0	0	5	5	0	0	0	0	0	0	0	0	12	12	0	0	0	2	2
Удмуртская Республика	Частные; Очно-заочная	"    переведено из других образовательных организаций 
    с программ того же уровня / 3.0"	0	0	0	32	32	0	0	0	3	3	0	0	0	11	11	0	0	0	1	1
Удмуртская Республика	Частные; Очно-заочная	    по болезни / 9.0	0	0	0	0	0	0	0	0	0	0	0	0	0	0	0	0	0	0	0	0
Удмуртская Республика	Частные; Очно-заочная	    прибыло по другим причинам / 5.0	0	0	0	0	0	0	0	0	0	0	0	0	0	0	0	0	0	0	0	0
Удмуртская Республика	Частные; Очно-заочная	Выбыло студентов - всего (сумма стр. 07-11, 13-15) / 6.0	0	0	0	56	56	0	0	0	30	30	0	0	0	82	82	0	0	0	68	68
Удмуртская Республика	Частные; Очно-заочная	Прибыло студентов - всего (сумма стр. 02-05) / 1.0	0	0	0	77	77	0	0	0	37	37	0	0	0	75	75	0	0	0	187	187
Удмуртская Республика	Частные; Очно-заочная	"Численность студентов на начало прошлого учебного года
(на 1 октября) / 17.0"	0	0	0	362	362	0	0	0	134	134	0	0	0	309	309	0	0	0	124	124
Ульяновская область	Государственные, муниципальные (без учета организаций в ведении ФСИН); Заочная	            из стр. 11 - не прошли итоговую аттестацию / 12.0	0	0	0	0	0	0	0	0	0	0	0	0	0	0	0	0	0	0	0	0
Ульяновская область	Государственные, муниципальные (без учета организаций в ведении ФСИН); Заочная	"            из стр. 11 – лица с ограниченными возможностями здоровья,
            инвалиды, дети-инвалиды / 13.0"	0	0	0	0	0	0	0	0	0	0	0	0	0	0	0	0	0	0	0	0
Ульяновская область	Государственные, муниципальные (без учета организаций в ведении ФСИН); Заочная	         отчислено в виде меры дисциплинарного взыскания / 14.0	0	0	0	0	0	0	0	0	0	0	0	0	0	0	0	0	0	0	0	0
Ульяновская область	Государственные, муниципальные (без учета организаций в ведении ФСИН); Заочная	         отчислено из-за просрочки оплаты обучения / 15.0	0	0	0	0	0	0	0	0	0	0	0	0	0	50	50	0	0	0	17	17
Ульяновская область	Государственные, муниципальные (без учета организаций в ведении ФСИН); Заочная	"    в том числе:
    переведено на другие формы обучения данной
    организации на программы того же уровня / 7.0"	0	0	0	0	0	0	0	0	0	0	1	0	0	4	5	0	0	0	0	0
Ульяновская область	Государственные, муниципальные (без учета организаций в ведении ФСИН); Заочная	"    в том числе:
    переведено с других форм обучения данной
    образовательной организации с программ того же уровня / 2.0"	0	0	0	0	0	0	0	0	0	0	1	0	0	52	53	0	0	0	33	33
Ульяновская область	Государственные, муниципальные (без учета организаций в ведении ФСИН); Заочная	    восстановлены из числа ранее отчисленных / 4.0	0	0	0	0	0	0	0	0	0	0	1	0	0	43	44	9	0	0	29	38
Ульяновская область	Государственные, муниципальные (без учета организаций в ведении ФСИН); Заочная	    выбыло по другим причинам / 16.0	0	0	0	0	0	0	0	0	0	0	0	0	0	10	10	10	0	0	21	31
Ульяновская область	Государственные, муниципальные (без учета организаций в ведении ФСИН); Заочная	"    добровольно прекратили образовательные отношения
    (бросили учебу) / 10.0"	0	0	0	0	0	0	0	0	0	0	0	0	0	42	42	65	0	0	57	122
Ульяновская область	Государственные, муниципальные (без учета организаций в ведении ФСИН); Заочная	"    отчислено:
         по неуспеваемости / 11.0"	0	0	0	0	0	0	0	0	0	0	0	0	0	18	18	34	0	0	55	89
Ульяновская область	Государственные, муниципальные (без учета организаций в ведении ФСИН); Заочная	"    переведено в другие образовательные организации
    на программы того же уровня / 8.0"	0	0	0	0	0	0	0	0	0	0	0	0	0	2	2	0	0	0	0	0
Ульяновская область	Государственные, муниципальные (без учета организаций в ведении ФСИН); Заочная	"    переведено из других образовательных организаций 
    с программ того же уровня / 3.0"	0	0	0	0	0	0	0	0	0	0	0	0	0	6	6	1	0	0	2	3
Ульяновская область	Государственные, муниципальные (без учета организаций в ведении ФСИН); Заочная	    по болезни / 9.0	0	0	0	0	0	0	0	0	0	0	0	0	0	0	0	0	0	0	0	0
Ульяновская область	Государственные, муниципальные (без учета организаций в ведении ФСИН); Заочная	    прибыло по другим причинам / 5.0	0	0	0	0	0	0	0	0	0	0	0	0	0	39	39	18	0	0	17	35
Ульяновская область	Государственные, муниципальные (без учета организаций в ведении ФСИН); Заочная	Выбыло студентов - всего (сумма стр. 07-11, 13-15) / 6.0	0	0	0	0	0	0	0	0	0	0	1	0	0	126	127	109	0	0	150	259
Ульяновская область	Государственные, муниципальные (без учета организаций в ведении ФСИН); Заочная	Прибыло студентов - всего (сумма стр. 02-05) / 1.0	0	0	0	0	0	0	0	0	0	0	2	0	0	140	142	28	0	0	81	109
Ульяновская область	Государственные, муниципальные (без учета организаций в ведении ФСИН); Заочная	"Численность студентов на начало прошлого учебного года
(на 1 октября) / 17.0"	0	0	0	0	0	0	0	0	0	0	0	0	72	570	642	954	0	0	810	1764
Ульяновская область	Государственные, муниципальные (без учета организаций в ведении ФСИН); Очная	            из стр. 11 - не прошли итоговую аттестацию / 12.0	2	0	0	0	2	0	0	0	0	0	7	0	0	1	8	0	0	0	1	1
Ульяновская область	Государственные, муниципальные (без учета организаций в ведении ФСИН); Очная	"            из стр. 11 – лица с ограниченными возможностями здоровья,
            инвалиды, дети-инвалиды / 13.0"	0	0	0	0	0	0	0	0	0	0	3	0	0	1	4	0	0	0	0	0
Ульяновская область	Государственные, муниципальные (без учета организаций в ведении ФСИН); Очная	         отчислено в виде меры дисциплинарного взыскания / 14.0	3	0	0	0	3	1	0	0	0	1	3	0	0	1	4	2	0	0	0	2
Ульяновская область	Государственные, муниципальные (без учета организаций в ведении ФСИН); Очная	         отчислено из-за просрочки оплаты обучения / 15.0	0	0	0	0	0	0	0	0	0	0	0	0	0	34	34	0	0	0	14	14
Ульяновская область	Государственные, муниципальные (без учета организаций в ведении ФСИН); Очная	"    в том числе:
    переведено на другие формы обучения данной
    организации на программы того же уровня / 7.0"	13	0	0	1	14	0	0	0	0	0	67	0	21	59	147	1	0	0	11	12
Ульяновская область	Государственные, муниципальные (без учета организаций в ведении ФСИН); Очная	"    в том числе:
    переведено с других форм обучения данной
    образовательной организации с программ того же уровня / 2.0"	7	0	0	0	7	0	0	0	0	0	20	0	20	11	51	0	0	0	2	2
Ульяновская область	Государственные, муниципальные (без учета организаций в ведении ФСИН); Очная	    восстановлены из числа ранее отчисленных / 4.0	14	0	0	0	14	0	0	0	0	0	85	0	8	21	114	1	0	0	10	11
Ульяновская область	Государственные, муниципальные (без учета организаций в ведении ФСИН); Очная	    выбыло по другим причинам / 16.0	31	0	0	0	31	0	0	0	0	0	74	0	0	55	129	2	0	0	20	22
Ульяновская область	Государственные, муниципальные (без учета организаций в ведении ФСИН); Очная	"    добровольно прекратили образовательные отношения
    (бросили учебу) / 10.0"	236	0	0	10	246	2	0	0	3	5	504	0	58	197	759	34	0	18	26	78
Ульяновская область	Государственные, муниципальные (без учета организаций в ведении ФСИН); Очная	"    отчислено:
         по неуспеваемости / 11.0"	105	0	0	0	105	0	0	0	0	0	220	0	56	39	315	9	0	12	11	32
Ульяновская область	Государственные, муниципальные (без учета организаций в ведении ФСИН); Очная	"    переведено в другие образовательные организации
    на программы того же уровня / 8.0"	64	0	0	11	75	0	0	0	0	0	150	0	27	79	256	11	0	0	4	15
Ульяновская область	Государственные, муниципальные (без учета организаций в ведении ФСИН); Очная	"    переведено из других образовательных организаций 
    с программ того же уровня / 3.0"	41	0	0	2	43	0	0	0	0	0	184	0	11	40	235	6	0	1	2	9
Ульяновская область	Государственные, муниципальные (без учета организаций в ведении ФСИН); Очная	    по болезни / 9.0	2	0	0	0	2	0	0	0	0	0	4	0	0	1	5	0	0	0	0	0
Ульяновская область	Государственные, муниципальные (без учета организаций в ведении ФСИН); Очная	    прибыло по другим причинам / 5.0	17	0	0	0	17	0	0	0	0	0	61	0	11	62	134	2	0	3	1	6
Ульяновская область	Государственные, муниципальные (без учета организаций в ведении ФСИН); Очная	Выбыло студентов - всего (сумма стр. 07-11, 13-15) / 6.0	454	0	0	22	476	3	0	0	3	6	1022	0	162	465	1649	59	0	30	86	175
Ульяновская область	Государственные, муниципальные (без учета организаций в ведении ФСИН); Очная	Прибыло студентов - всего (сумма стр. 02-05) / 1.0	79	0	0	2	81	0	0	0	0	0	350	0	50	134	534	9	0	4	15	28
Ульяновская область	Государственные, муниципальные (без учета организаций в ведении ФСИН); Очная	"Численность студентов на начало прошлого учебного года
(на 1 октября) / 17.0"	3460	0	0	206	3666	47	0	0	26	73	9799	0	2902	4279	16980	515	0	462	1040	2017
Ульяновская область	Очно-заочная; Государственные, муниципальные (без учета организаций в ведении ФСИН)	            из стр. 11 - не прошли итоговую аттестацию / 12.0	0	0	0	0	0	0	0	0	0	0	0	0	0	0	0	0	0	0	0	0
Ульяновская область	Очно-заочная; Государственные, муниципальные (без учета организаций в ведении ФСИН)	"            из стр. 11 – лица с ограниченными возможностями здоровья,
            инвалиды, дети-инвалиды / 13.0"	0	0	0	0	0	0	0	0	0	0	0	0	0	0	0	0	0	0	0	0
Ульяновская область	Очно-заочная; Государственные, муниципальные (без учета организаций в ведении ФСИН)	         отчислено в виде меры дисциплинарного взыскания / 14.0	0	0	0	0	0	0	0	0	0	0	0	0	0	0	0	0	0	0	0	0
Ульяновская область	Очно-заочная; Государственные, муниципальные (без учета организаций в ведении ФСИН)	         отчислено из-за просрочки оплаты обучения / 15.0	0	0	0	0	0	0	0	0	0	0	0	0	0	0	0	0	0	0	0	0
Ульяновская область	Очно-заочная; Государственные, муниципальные (без учета организаций в ведении ФСИН)	"    в том числе:
    переведено на другие формы обучения данной
    организации на программы того же уровня / 7.0"	0	0	0	0	0	0	0	0	0	0	0	0	0	0	0	0	0	0	2	2
Ульяновская область	Очно-заочная; Государственные, муниципальные (без учета организаций в ведении ФСИН)	"    в том числе:
    переведено с других форм обучения данной
    образовательной организации с программ того же уровня / 2.0"	0	0	0	12	12	0	0	0	0	0	0	0	0	0	0	0	0	0	1	1
Ульяновская область	Очно-заочная; Государственные, муниципальные (без учета организаций в ведении ФСИН)	    восстановлены из числа ранее отчисленных / 4.0	0	0	0	0	0	0	0	0	0	0	0	0	0	0	0	0	0	0	3	3
Ульяновская область	Очно-заочная; Государственные, муниципальные (без учета организаций в ведении ФСИН)	    выбыло по другим причинам / 16.0	0	0	0	0	0	0	0	0	0	0	0	0	0	0	0	0	0	0	0	0
Ульяновская область	Очно-заочная; Государственные, муниципальные (без учета организаций в ведении ФСИН)	"    добровольно прекратили образовательные отношения
    (бросили учебу) / 10.0"	0	0	0	1	1	0	0	0	3	3	0	0	0	0	0	0	0	0	22	22
Ульяновская область	Очно-заочная; Государственные, муниципальные (без учета организаций в ведении ФСИН)	"    отчислено:
         по неуспеваемости / 11.0"	0	0	0	8	8	0	0	0	4	4	0	0	0	2	2	0	0	0	0	0
Ульяновская область	Очно-заочная; Государственные, муниципальные (без учета организаций в ведении ФСИН)	"    переведено в другие образовательные организации
    на программы того же уровня / 8.0"	0	0	0	0	0	0	0	0	0	0	0	0	0	0	0	0	0	0	0	0
Ульяновская область	Очно-заочная; Государственные, муниципальные (без учета организаций в ведении ФСИН)	"    переведено из других образовательных организаций 
    с программ того же уровня / 3.0"	0	0	0	2	2	0	0	0	0	0	0	0	0	0	0	0	0	0	0	0
Ульяновская область	Очно-заочная; Государственные, муниципальные (без учета организаций в ведении ФСИН)	    по болезни / 9.0	0	0	0	0	0	0	0	0	0	0	0	0	0	0	0	0	0	0	0	0
Ульяновская область	Очно-заочная; Государственные, муниципальные (без учета организаций в ведении ФСИН)	    прибыло по другим причинам / 5.0	0	0	0	0	0	0	0	0	0	0	0	0	0	0	0	0	0	0	0	0
Ульяновская область	Очно-заочная; Государственные, муниципальные (без учета организаций в ведении ФСИН)	Выбыло студентов - всего (сумма стр. 07-11, 13-15) / 6.0	0	0	0	9	9	0	0	0	7	7	0	0	0	2	2	0	0	0	24	24
Ульяновская область	Очно-заочная; Государственные, муниципальные (без учета организаций в ведении ФСИН)	Прибыло студентов - всего (сумма стр. 02-05) / 1.0	0	0	0	14	14	0	0	0	0	0	0	0	0	0	0	0	0	0	4	4
Ульяновская область	Очно-заочная; Государственные, муниципальные (без учета организаций в ведении ФСИН)	"Численность студентов на начало прошлого учебного года
(на 1 октября) / 17.0"	0	0	0	33	33	0	0	0	38	38	0	0	0	71	71	0	0	0	204	204
Ульяновская область	Частные; Заочная	            из стр. 11 - не прошли итоговую аттестацию / 12.0	0	0	0	0	0	0	0	0	0	0	0	0	0	0	0	0	0	0	0	0
Ульяновская область	Частные; Заочная	"            из стр. 11 – лица с ограниченными возможностями здоровья,
            инвалиды, дети-инвалиды / 13.0"	0	0	0	0	0	0	0	0	0	0	0	0	0	0	0	0	0	0	0	0
Ульяновская область	Частные; Заочная	         отчислено в виде меры дисциплинарного взыскания / 14.0	0	0	0	0	0	0	0	0	0	0	0	0	0	0	0	0	0	0	0	0
Ульяновская область	Частные; Заочная	         отчислено из-за просрочки оплаты обучения / 15.0	0	0	0	0	0	0	0	0	0	0	0	0	0	8	8	0	0	0	3	3
Ульяновская область	Частные; Заочная	"    в том числе:
    переведено на другие формы обучения данной
    организации на программы того же уровня / 7.0"	0	0	0	0	0	0	0	0	0	0	0	0	0	0	0	0	0	0	0	0
Ульяновская область	Частные; Заочная	"    в том числе:
    переведено с других форм обучения данной
    образовательной организации с программ того же уровня / 2.0"	0	0	0	0	0	0	0	0	0	0	0	0	0	14	14	0	0	0	2	2
Ульяновская область	Частные; Заочная	    восстановлены из числа ранее отчисленных / 4.0	0	0	0	0	0	0	0	0	0	0	0	0	0	7	7	0	0	0	3	3
Ульяновская область	Частные; Заочная	    выбыло по другим причинам / 16.0	0	0	0	0	0	0	0	0	0	0	0	0	0	3	3	0	0	0	1	1
Ульяновская область	Частные; Заочная	"    добровольно прекратили образовательные отношения
    (бросили учебу) / 10.0"	0	0	0	0	0	0	0	0	0	0	0	0	0	7	7	0	0	0	4	4
Ульяновская область	Частные; Заочная	"    отчислено:
         по неуспеваемости / 11.0"	0	0	0	0	0	0	0	0	0	0	0	0	0	0	0	0	0	0	0	0
Ульяновская область	Частные; Заочная	"    переведено в другие образовательные организации
    на программы того же уровня / 8.0"	0	0	0	0	0	0	0	0	0	0	0	0	0	0	0	0	0	0	0	0
Ульяновская область	Частные; Заочная	"    переведено из других образовательных организаций 
    с программ того же уровня / 3.0"	0	0	0	0	0	0	0	0	0	0	0	0	0	13	13	0	0	0	0	0
Ульяновская область	Частные; Заочная	    по болезни / 9.0	0	0	0	0	0	0	0	0	0	0	0	0	0	0	0	0	0	0	0	0
Ульяновская область	Частные; Заочная	    прибыло по другим причинам / 5.0	0	0	0	0	0	0	0	0	0	0	0	0	0	4	4	0	0	0	3	3
Ульяновская область	Частные; Заочная	Выбыло студентов - всего (сумма стр. 07-11, 13-15) / 6.0	0	0	0	0	0	0	0	0	0	0	0	0	0	18	18	0	0	0	8	8
Ульяновская область	Частные; Заочная	Прибыло студентов - всего (сумма стр. 02-05) / 1.0	0	0	0	0	0	0	0	0	0	0	0	0	0	38	38	0	0	0	8	8
Ульяновская область	Частные; Заочная	"Численность студентов на начало прошлого учебного года
(на 1 октября) / 17.0"	0	0	0	0	0	0	0	0	0	0	0	0	0	51	51	0	0	0	73	73
Ульяновская область	Частные; Очная	            из стр. 11 - не прошли итоговую аттестацию / 12.0	0	0	0	0	0	0	0	0	0	0	0	0	0	0	0	0	0	0	0	0
Ульяновская область	Частные; Очная	"            из стр. 11 – лица с ограниченными возможностями здоровья,
            инвалиды, дети-инвалиды / 13.0"	0	0	0	0	0	0	0	0	0	0	0	0	0	0	0	0	0	0	0	0
Ульяновская область	Частные; Очная	         отчислено в виде меры дисциплинарного взыскания / 14.0	0	0	0	0	0	0	0	0	0	0	0	0	0	0	0	0	0	0	0	0
Ульяновская область	Частные; Очная	         отчислено из-за просрочки оплаты обучения / 15.0	0	0	0	0	0	0	0	0	0	0	0	0	0	7	7	0	0	0	4	4
Ульяновская область	Частные; Очная	"    в том числе:
    переведено на другие формы обучения данной
    организации на программы того же уровня / 7.0"	0	0	0	0	0	0	0	0	0	0	0	0	0	13	13	0	0	0	4	4
Ульяновская область	Частные; Очная	"    в том числе:
    переведено с других форм обучения данной
    образовательной организации с программ того же уровня / 2.0"	0	0	0	0	0	0	0	0	0	0	0	0	0	0	0	0	0	0	0	0
Ульяновская область	Частные; Очная	    восстановлены из числа ранее отчисленных / 4.0	0	0	0	0	0	0	0	0	0	0	0	0	0	7	7	0	0	0	0	0
Ульяновская область	Частные; Очная	    выбыло по другим причинам / 16.0	0	0	0	0	0	0	0	0	0	0	0	0	0	5	5	0	0	0	0	0
Ульяновская область	Частные; Очная	"    добровольно прекратили образовательные отношения
    (бросили учебу) / 10.0"	0	0	0	0	0	0	0	0	0	0	13	0	0	42	55	0	0	0	4	4
Ульяновская область	Частные; Очная	"    отчислено:
         по неуспеваемости / 11.0"	0	0	0	0	0	0	0	0	0	0	1	0	0	6	7	0	0	0	0	0
Ульяновская область	Частные; Очная	"    переведено в другие образовательные организации
    на программы того же уровня / 8.0"	0	0	0	0	0	0	0	0	0	0	4	0	0	14	18	0	0	0	0	0
Ульяновская область	Частные; Очная	"    переведено из других образовательных организаций 
    с программ того же уровня / 3.0"	0	0	0	0	0	0	0	0	0	0	0	0	0	12	12	0	0	0	0	0
Ульяновская область	Частные; Очная	    по болезни / 9.0	0	0	0	0	0	0	0	0	0	0	0	0	0	0	0	0	0	0	0	0
Ульяновская область	Частные; Очная	    прибыло по другим причинам / 5.0	0	0	0	0	0	0	0	0	0	0	1	0	0	8	9	0	0	0	5	5
Ульяновская область	Частные; Очная	Выбыло студентов - всего (сумма стр. 07-11, 13-15) / 6.0	0	0	0	0	0	0	0	0	0	0	18	0	0	87	105	0	0	0	12	12
Ульяновская область	Частные; Очная	Прибыло студентов - всего (сумма стр. 02-05) / 1.0	0	0	0	0	0	0	0	0	0	0	1	0	0	27	28	0	0	0	5	5
Ульяновская область	Частные; Очная	"Численность студентов на начало прошлого учебного года
(на 1 октября) / 17.0"	0	0	0	0	0	0	0	0	0	0	221	0	0	1498	1719	0	0	0	232	232
Хабаровский край	Государственные, муниципальные (без учета организаций в ведении ФСИН); Заочная	            из стр. 11 - не прошли итоговую аттестацию / 12.0	0	0	0	0	0	0	0	0	0	0	0	0	0	0	0	1	0	1	0	2
Хабаровский край	Государственные, муниципальные (без учета организаций в ведении ФСИН); Заочная	"            из стр. 11 – лица с ограниченными возможностями здоровья,
            инвалиды, дети-инвалиды / 13.0"	0	0	0	0	0	0	0	0	0	0	0	0	0	0	0	0	0	0	0	0
Хабаровский край	Государственные, муниципальные (без учета организаций в ведении ФСИН); Заочная	         отчислено в виде меры дисциплинарного взыскания / 14.0	0	0	0	0	0	0	0	0	0	0	0	0	0	0	0	0	0	0	0	0
Хабаровский край	Государственные, муниципальные (без учета организаций в ведении ФСИН); Заочная	         отчислено из-за просрочки оплаты обучения / 15.0	0	0	0	0	0	0	0	0	0	0	0	0	0	138	138	0	0	0	85	85
Хабаровский край	Государственные, муниципальные (без учета организаций в ведении ФСИН); Заочная	"    в том числе:
    переведено на другие формы обучения данной
    организации на программы того же уровня / 7.0"	0	0	0	0	0	0	0	0	0	0	11	0	0	24	35	2	0	0	39	41
Хабаровский край	Государственные, муниципальные (без учета организаций в ведении ФСИН); Заочная	"    в том числе:
    переведено с других форм обучения данной
    образовательной организации с программ того же уровня / 2.0"	0	0	0	0	0	0	0	0	0	0	37	0	0	91	128	20	0	27	40	87
Хабаровский край	Государственные, муниципальные (без учета организаций в ведении ФСИН); Заочная	    восстановлены из числа ранее отчисленных / 4.0	0	0	0	0	0	0	0	0	0	0	6	0	0	40	46	7	0	0	28	35
Хабаровский край	Государственные, муниципальные (без учета организаций в ведении ФСИН); Заочная	    выбыло по другим причинам / 16.0	0	0	0	0	0	0	0	0	0	0	66	0	0	77	143	134	0	11	84	229
Хабаровский край	Государственные, муниципальные (без учета организаций в ведении ФСИН); Заочная	"    добровольно прекратили образовательные отношения
    (бросили учебу) / 10.0"	0	0	0	0	0	0	0	0	0	0	49	0	0	26	75	68	0	33	62	163
Хабаровский край	Государственные, муниципальные (без учета организаций в ведении ФСИН); Заочная	"    отчислено:
         по неуспеваемости / 11.0"	0	0	0	0	0	0	0	0	0	0	96	0	0	12	108	92	0	9	23	124
Хабаровский край	Государственные, муниципальные (без учета организаций в ведении ФСИН); Заочная	"    переведено в другие образовательные организации
    на программы того же уровня / 8.0"	0	0	0	0	0	0	0	0	0	0	6	0	0	5	11	3	0	0	3	6
Хабаровский край	Государственные, муниципальные (без учета организаций в ведении ФСИН); Заочная	"    переведено из других образовательных организаций 
    с программ того же уровня / 3.0"	0	0	0	0	0	0	0	0	0	0	2	0	0	11	13	0	0	2	7	9
Хабаровский край	Государственные, муниципальные (без учета организаций в ведении ФСИН); Заочная	    по болезни / 9.0	0	0	0	0	0	0	0	0	0	0	0	0	0	1	1	2	0	0	0	2
Хабаровский край	Государственные, муниципальные (без учета организаций в ведении ФСИН); Заочная	    прибыло по другим причинам / 5.0	0	0	0	0	0	0	0	0	0	0	4	0	0	24	28	6	0	2	14	22
Хабаровский край	Государственные, муниципальные (без учета организаций в ведении ФСИН); Заочная	Выбыло студентов - всего (сумма стр. 07-11, 13-15) / 6.0	0	0	0	0	0	0	0	0	0	0	228	0	0	283	511	301	0	53	296	650
Хабаровский край	Государственные, муниципальные (без учета организаций в ведении ФСИН); Заочная	Прибыло студентов - всего (сумма стр. 02-05) / 1.0	0	0	0	0	0	0	0	0	0	0	49	0	0	166	215	33	0	31	89	153
Хабаровский край	Государственные, муниципальные (без учета организаций в ведении ФСИН); Заочная	"Численность студентов на начало прошлого учебного года
(на 1 октября) / 17.0"	0	0	0	0	0	0	0	0	0	0	1441	0	0	1450	2891	2456	0	412	1566	4434
Хабаровский край	Государственные, муниципальные (без учета организаций в ведении ФСИН); Очная	            из стр. 11 - не прошли итоговую аттестацию / 12.0	0	0	0	0	0	0	0	0	0	0	1	0	0	1	2	0	0	0	2	2
Хабаровский край	Государственные, муниципальные (без учета организаций в ведении ФСИН); Очная	"            из стр. 11 – лица с ограниченными возможностями здоровья,
            инвалиды, дети-инвалиды / 13.0"	1	0	0	0	1	0	0	0	0	0	2	0	0	2	4	0	0	0	0	0
Хабаровский край	Государственные, муниципальные (без учета организаций в ведении ФСИН); Очная	         отчислено в виде меры дисциплинарного взыскания / 14.0	11	0	0	0	11	0	0	0	0	0	1	0	0	2	3	9	0	0	3	12
Хабаровский край	Государственные, муниципальные (без учета организаций в ведении ФСИН); Очная	         отчислено из-за просрочки оплаты обучения / 15.0	0	0	0	0	0	0	0	0	0	0	0	0	0	39	39	0	0	0	4	4
Хабаровский край	Государственные, муниципальные (без учета организаций в ведении ФСИН); Очная	"    в том числе:
    переведено на другие формы обучения данной
    организации на программы того же уровня / 7.0"	10	0	0	2	12	0	0	0	0	0	146	0	9	115	270	29	0	3	48	80
Хабаровский край	Государственные, муниципальные (без учета организаций в ведении ФСИН); Очная	"    в том числе:
    переведено с других форм обучения данной
    образовательной организации с программ того же уровня / 2.0"	59	0	0	3	62	0	0	0	1	1	65	0	17	14	96	11	0	15	1	27
Хабаровский край	Государственные, муниципальные (без учета организаций в ведении ФСИН); Очная	    восстановлены из числа ранее отчисленных / 4.0	28	0	0	0	28	1	0	0	0	1	52	0	1	31	84	10	0	3	24	37
Хабаровский край	Государственные, муниципальные (без учета организаций в ведении ФСИН); Очная	    выбыло по другим причинам / 16.0	535	0	0	11	546	5	0	0	3	8	615	0	50	268	933	34	0	16	51	101
Хабаровский край	Государственные, муниципальные (без учета организаций в ведении ФСИН); Очная	"    добровольно прекратили образовательные отношения
    (бросили учебу) / 10.0"	176	0	0	2	178	2	0	0	0	2	268	0	66	195	529	156	0	22	85	263
Хабаровский край	Государственные, муниципальные (без учета организаций в ведении ФСИН); Очная	"    отчислено:
         по неуспеваемости / 11.0"	113	0	0	0	113	0	0	0	0	0	228	0	21	84	333	41	0	10	61	112
Хабаровский край	Государственные, муниципальные (без учета организаций в ведении ФСИН); Очная	"    переведено в другие образовательные организации
    на программы того же уровня / 8.0"	40	0	0	0	40	0	0	0	2	2	121	0	15	60	196	23	0	1	8	32
Хабаровский край	Государственные, муниципальные (без учета организаций в ведении ФСИН); Очная	"    переведено из других образовательных организаций 
    с программ того же уровня / 3.0"	30	0	0	1	31	0	0	0	0	0	105	0	26	52	183	11	0	1	4	16
Хабаровский край	Государственные, муниципальные (без учета организаций в ведении ФСИН); Очная	    по болезни / 9.0	8	0	0	0	8	1	0	0	0	1	6	0	0	1	7	0	0	0	0	0
Хабаровский край	Государственные, муниципальные (без учета организаций в ведении ФСИН); Очная	    прибыло по другим причинам / 5.0	3	0	0	4	7	0	0	0	0	0	12	0	25	44	81	8	0	13	6	27
Хабаровский край	Государственные, муниципальные (без учета организаций в ведении ФСИН); Очная	Выбыло студентов - всего (сумма стр. 07-11, 13-15) / 6.0	893	0	0	15	908	8	0	0	5	13	1385	0	161	764	2310	292	0	52	260	604
Хабаровский край	Государственные, муниципальные (без учета организаций в ведении ФСИН); Очная	Прибыло студентов - всего (сумма стр. 02-05) / 1.0	120	0	0	8	128	1	0	0	1	2	234	0	69	141	444	40	0	32	35	107
Хабаровский край	Государственные, муниципальные (без учета организаций в ведении ФСИН); Очная	"Численность студентов на начало прошлого учебного года
(на 1 октября) / 17.0"	6572	0	0	132	6704	100	0	0	22	122	12607	0	1671	4222	18500	2342	0	475	1476	4293
Хабаровский край	Очно-заочная; Государственные, муниципальные (без учета организаций в ведении ФСИН)	            из стр. 11 - не прошли итоговую аттестацию / 12.0	0	0	0	0	0	0	0	0	0	0	0	0	0	0	0	0	0	0	0	0
Хабаровский край	Очно-заочная; Государственные, муниципальные (без учета организаций в ведении ФСИН)	"            из стр. 11 – лица с ограниченными возможностями здоровья,
            инвалиды, дети-инвалиды / 13.0"	0	0	0	0	0	0	0	0	0	0	0	0	0	0	0	0	0	0	0	0
Хабаровский край	Очно-заочная; Государственные, муниципальные (без учета организаций в ведении ФСИН)	         отчислено в виде меры дисциплинарного взыскания / 14.0	0	0	0	0	0	0	0	0	0	0	0	0	0	0	0	8	0	0	4	12
Хабаровский край	Очно-заочная; Государственные, муниципальные (без учета организаций в ведении ФСИН)	         отчислено из-за просрочки оплаты обучения / 15.0	0	0	0	0	0	0	0	0	0	0	0	0	0	0	0	0	0	0	0	0
Хабаровский край	Очно-заочная; Государственные, муниципальные (без учета организаций в ведении ФСИН)	"    в том числе:
    переведено на другие формы обучения данной
    организации на программы того же уровня / 7.0"	0	0	0	0	0	0	0	0	0	0	0	0	0	0	0	1	0	0	0	1
Хабаровский край	Очно-заочная; Государственные, муниципальные (без учета организаций в ведении ФСИН)	"    в том числе:
    переведено с других форм обучения данной
    образовательной организации с программ того же уровня / 2.0"	0	0	0	0	0	0	0	0	1	1	2	0	0	0	2	16	0	0	0	16
Хабаровский край	Очно-заочная; Государственные, муниципальные (без учета организаций в ведении ФСИН)	    восстановлены из числа ранее отчисленных / 4.0	0	0	0	0	0	0	0	0	0	0	0	0	0	0	0	7	0	0	1	8
Хабаровский край	Очно-заочная; Государственные, муниципальные (без учета организаций в ведении ФСИН)	    выбыло по другим причинам / 16.0	0	0	0	0	0	0	0	0	0	0	7	0	0	1	8	16	0	0	2	18
Хабаровский край	Очно-заочная; Государственные, муниципальные (без учета организаций в ведении ФСИН)	"    добровольно прекратили образовательные отношения
    (бросили учебу) / 10.0"	0	0	0	0	0	0	0	0	0	0	1	0	0	2	3	34	0	0	7	41
Хабаровский край	Очно-заочная; Государственные, муниципальные (без учета организаций в ведении ФСИН)	"    отчислено:
         по неуспеваемости / 11.0"	0	0	0	0	0	0	0	0	0	0	2	0	0	0	2	9	0	0	3	12
Хабаровский край	Очно-заочная; Государственные, муниципальные (без учета организаций в ведении ФСИН)	"    переведено в другие образовательные организации
    на программы того же уровня / 8.0"	0	0	0	0	0	0	0	0	0	0	0	0	0	0	0	3	0	0	0	3
Хабаровский край	Очно-заочная; Государственные, муниципальные (без учета организаций в ведении ФСИН)	"    переведено из других образовательных организаций 
    с программ того же уровня / 3.0"	0	0	0	0	0	0	0	0	0	0	0	0	0	0	0	1	0	0	0	1
Хабаровский край	Очно-заочная; Государственные, муниципальные (без учета организаций в ведении ФСИН)	    по болезни / 9.0	0	0	0	0	0	0	0	0	0	0	0	0	0	0	0	1	0	0	0	1
Хабаровский край	Очно-заочная; Государственные, муниципальные (без учета организаций в ведении ФСИН)	    прибыло по другим причинам / 5.0	0	0	0	0	0	0	0	0	0	0	0	0	0	0	0	2	0	0	0	2
Хабаровский край	Очно-заочная; Государственные, муниципальные (без учета организаций в ведении ФСИН)	Выбыло студентов - всего (сумма стр. 07-11, 13-15) / 6.0	0	0	0	0	0	0	0	0	0	0	10	0	0	3	13	72	0	0	16	88
Хабаровский край	Очно-заочная; Государственные, муниципальные (без учета организаций в ведении ФСИН)	Прибыло студентов - всего (сумма стр. 02-05) / 1.0	0	0	0	0	0	0	0	0	1	1	2	0	0	0	2	26	0	0	1	27
Хабаровский край	Очно-заочная; Государственные, муниципальные (без учета организаций в ведении ФСИН)	"Численность студентов на начало прошлого учебного года
(на 1 октября) / 17.0"	0	0	0	0	0	0	0	0	0	0	29	0	0	12	41	342	0	0	256	598
Хабаровский край	Частные; Заочная	            из стр. 11 - не прошли итоговую аттестацию / 12.0	0	0	0	0	0	0	0	0	0	0	0	0	0	1	1	0	0	0	0	0
Хабаровский край	Частные; Заочная	"            из стр. 11 – лица с ограниченными возможностями здоровья,
            инвалиды, дети-инвалиды / 13.0"	0	0	0	0	0	0	0	0	0	0	0	0	0	0	0	0	0	0	0	0
Хабаровский край	Частные; Заочная	         отчислено в виде меры дисциплинарного взыскания / 14.0	0	0	0	0	0	0	0	0	0	0	0	0	0	0	0	0	0	0	0	0
Хабаровский край	Частные; Заочная	         отчислено из-за просрочки оплаты обучения / 15.0	0	0	0	0	0	0	0	0	0	0	0	0	0	0	0	0	0	0	0	0
Хабаровский край	Частные; Заочная	"    в том числе:
    переведено на другие формы обучения данной
    организации на программы того же уровня / 7.0"	0	0	0	0	0	0	0	0	0	0	0	0	0	0	0	0	0	0	0	0
Хабаровский край	Частные; Заочная	"    в том числе:
    переведено с других форм обучения данной
    образовательной организации с программ того же уровня / 2.0"	0	0	0	0	0	0	0	0	0	0	0	0	0	3	3	0	0	0	3	3
Хабаровский край	Частные; Заочная	    восстановлены из числа ранее отчисленных / 4.0	0	0	0	0	0	0	0	0	0	0	0	0	0	6	6	0	0	0	5	5
Хабаровский край	Частные; Заочная	    выбыло по другим причинам / 16.0	0	0	0	0	0	0	0	0	0	0	0	0	0	10	10	0	0	0	10	10
Хабаровский край	Частные; Заочная	"    добровольно прекратили образовательные отношения
    (бросили учебу) / 10.0"	0	0	0	0	0	0	0	0	0	0	0	0	0	4	4	0	0	0	0	0
Хабаровский край	Частные; Заочная	"    отчислено:
         по неуспеваемости / 11.0"	0	0	0	0	0	0	0	0	0	0	0	0	0	1	1	0	0	0	0	0
Хабаровский край	Частные; Заочная	"    переведено в другие образовательные организации
    на программы того же уровня / 8.0"	0	0	0	0	0	0	0	0	0	0	0	0	0	0	0	0	0	0	0	0
Хабаровский край	Частные; Заочная	"    переведено из других образовательных организаций 
    с программ того же уровня / 3.0"	0	0	0	0	0	0	0	0	0	0	0	0	0	0	0	0	0	0	1	1
Хабаровский край	Частные; Заочная	    по болезни / 9.0	0	0	0	0	0	0	0	0	0	0	0	0	0	0	0	0	0	0	0	0
Хабаровский край	Частные; Заочная	    прибыло по другим причинам / 5.0	0	0	0	0	0	0	0	0	0	0	0	0	0	0	0	0	0	0	0	0
Хабаровский край	Частные; Заочная	Выбыло студентов - всего (сумма стр. 07-11, 13-15) / 6.0	0	0	0	0	0	0	0	0	0	0	0	0	0	15	15	0	0	0	10	10
Хабаровский край	Частные; Заочная	Прибыло студентов - всего (сумма стр. 02-05) / 1.0	0	0	0	0	0	0	0	0	0	0	0	0	0	9	9	0	0	0	9	9
Хабаровский край	Частные; Заочная	"Численность студентов на начало прошлого учебного года
(на 1 октября) / 17.0"	0	0	0	0	0	0	0	0	0	0	0	0	0	73	73	0	0	0	91	91
Хабаровский край	Частные; Очная	            из стр. 11 - не прошли итоговую аттестацию / 12.0	0	0	0	0	0	0	0	0	0	0	0	0	0	8	8	0	0	0	1	1
Хабаровский край	Частные; Очная	"            из стр. 11 – лица с ограниченными возможностями здоровья,
            инвалиды, дети-инвалиды / 13.0"	0	0	0	0	0	0	0	0	0	0	0	0	0	0	0	0	0	0	0	0
Хабаровский край	Частные; Очная	         отчислено в виде меры дисциплинарного взыскания / 14.0	0	0	0	0	0	0	0	0	0	0	0	0	0	0	0	0	0	0	0	0
Хабаровский край	Частные; Очная	         отчислено из-за просрочки оплаты обучения / 15.0	0	0	0	0	0	0	0	0	0	0	0	0	0	0	0	0	0	0	0	0
Хабаровский край	Частные; Очная	"    в том числе:
    переведено на другие формы обучения данной
    организации на программы того же уровня / 7.0"	0	0	0	0	0	0	0	0	0	0	0	0	0	2	2	0	0	0	2	2
Хабаровский край	Частные; Очная	"    в том числе:
    переведено с других форм обучения данной
    образовательной организации с программ того же уровня / 2.0"	0	0	0	0	0	0	0	0	0	0	0	0	0	0	0	0	0	0	0	0
Хабаровский край	Частные; Очная	    восстановлены из числа ранее отчисленных / 4.0	0	0	0	0	0	0	0	0	0	0	0	0	0	0	0	0	0	0	0	0
Хабаровский край	Частные; Очная	    выбыло по другим причинам / 16.0	0	0	0	0	0	0	0	0	0	0	0	0	0	0	0	0	0	0	0	0
Хабаровский край	Частные; Очная	"    добровольно прекратили образовательные отношения
    (бросили учебу) / 10.0"	0	0	0	0	0	0	0	0	0	0	0	0	0	16	16	0	0	0	5	5
Хабаровский край	Частные; Очная	"    отчислено:
         по неуспеваемости / 11.0"	0	0	0	0	0	0	0	0	0	0	0	0	0	8	8	0	0	0	1	1
Хабаровский край	Частные; Очная	"    переведено в другие образовательные организации
    на программы того же уровня / 8.0"	0	0	0	0	0	0	0	0	0	0	0	0	0	0	0	0	0	0	0	0
Хабаровский край	Частные; Очная	"    переведено из других образовательных организаций 
    с программ того же уровня / 3.0"	0	0	0	0	0	0	0	0	0	0	0	0	0	6	6	0	0	0	0	0
Хабаровский край	Частные; Очная	    по болезни / 9.0	0	0	0	0	0	0	0	0	0	0	0	0	0	0	0	0	0	0	0	0
Хабаровский край	Частные; Очная	    прибыло по другим причинам / 5.0	0	0	0	0	0	0	0	0	0	0	0	0	0	9	9	0	0	0	4	4
Хабаровский край	Частные; Очная	Выбыло студентов - всего (сумма стр. 07-11, 13-15) / 6.0	0	0	0	0	0	0	0	0	0	0	0	0	0	26	26	0	0	0	8	8
Хабаровский край	Частные; Очная	Прибыло студентов - всего (сумма стр. 02-05) / 1.0	0	0	0	0	0	0	0	0	0	0	0	0	0	15	15	0	0	0	4	4
Хабаровский край	Частные; Очная	"Численность студентов на начало прошлого учебного года
(на 1 октября) / 17.0"	0	0	0	0	0	0	0	0	0	0	0	0	0	119	119	0	0	0	45	45
Ханты-Мансийский автономный округ	Государственные, муниципальные (без учета организаций в ведении ФСИН); Заочная	            из стр. 11 - не прошли итоговую аттестацию / 12.0	0	0	0	0	0	0	0	0	0	0	0	0	0	8	8	0	0	0	10	10
Ханты-Мансийский автономный округ	Государственные, муниципальные (без учета организаций в ведении ФСИН); Заочная	"            из стр. 11 – лица с ограниченными возможностями здоровья,
            инвалиды, дети-инвалиды / 13.0"	0	0	0	0	0	0	0	0	0	0	0	0	0	0	0	0	0	0	0	0
Ханты-Мансийский автономный округ	Государственные, муниципальные (без учета организаций в ведении ФСИН); Заочная	         отчислено в виде меры дисциплинарного взыскания / 14.0	0	0	0	0	0	0	0	0	0	0	0	0	0	0	0	0	0	0	0	0
Ханты-Мансийский автономный округ	Государственные, муниципальные (без учета организаций в ведении ФСИН); Заочная	         отчислено из-за просрочки оплаты обучения / 15.0	0	0	0	0	0	0	0	0	0	0	0	0	0	46	46	0	0	0	73	73
Ханты-Мансийский автономный округ	Государственные, муниципальные (без учета организаций в ведении ФСИН); Заочная	"    в том числе:
    переведено на другие формы обучения данной
    организации на программы того же уровня / 7.0"	0	0	0	0	0	0	0	0	0	0	0	0	0	54	54	0	0	0	11	11
Ханты-Мансийский автономный округ	Государственные, муниципальные (без учета организаций в ведении ФСИН); Заочная	"    в том числе:
    переведено с других форм обучения данной
    образовательной организации с программ того же уровня / 2.0"	0	0	0	0	0	0	0	0	0	0	0	0	0	29	29	3	0	0	14	17
Ханты-Мансийский автономный округ	Государственные, муниципальные (без учета организаций в ведении ФСИН); Заочная	    восстановлены из числа ранее отчисленных / 4.0	0	0	0	0	0	0	0	0	0	0	0	0	0	56	56	0	0	0	54	54
Ханты-Мансийский автономный округ	Государственные, муниципальные (без учета организаций в ведении ФСИН); Заочная	    выбыло по другим причинам / 16.0	0	0	0	0	0	0	0	0	0	0	0	0	0	86	86	1	0	0	58	59
Ханты-Мансийский автономный округ	Государственные, муниципальные (без учета организаций в ведении ФСИН); Заочная	"    добровольно прекратили образовательные отношения
    (бросили учебу) / 10.0"	0	0	0	0	0	0	0	0	0	0	0	0	0	92	92	8	0	0	104	112
Ханты-Мансийский автономный округ	Государственные, муниципальные (без учета организаций в ведении ФСИН); Заочная	"    отчислено:
         по неуспеваемости / 11.0"	0	0	0	0	0	0	0	0	0	0	0	0	0	65	65	0	0	0	43	43
Ханты-Мансийский автономный округ	Государственные, муниципальные (без учета организаций в ведении ФСИН); Заочная	"    переведено в другие образовательные организации
    на программы того же уровня / 8.0"	0	0	0	0	0	0	0	0	0	0	0	0	0	36	36	0	0	0	13	13
Ханты-Мансийский автономный округ	Государственные, муниципальные (без учета организаций в ведении ФСИН); Заочная	"    переведено из других образовательных организаций 
    с программ того же уровня / 3.0"	0	0	0	0	0	0	0	0	0	0	0	0	0	24	24	1	0	0	7	8
Ханты-Мансийский автономный округ	Государственные, муниципальные (без учета организаций в ведении ФСИН); Заочная	    по болезни / 9.0	0	0	0	0	0	0	0	0	0	0	0	0	0	0	0	0	0	0	0	0
Ханты-Мансийский автономный округ	Государственные, муниципальные (без учета организаций в ведении ФСИН); Заочная	    прибыло по другим причинам / 5.0	0	0	0	0	0	0	0	0	0	0	0	0	0	64	64	0	0	0	31	31
Ханты-Мансийский автономный округ	Государственные, муниципальные (без учета организаций в ведении ФСИН); Заочная	Выбыло студентов - всего (сумма стр. 07-11, 13-15) / 6.0	0	0	0	0	0	0	0	0	0	0	0	0	0	379	379	9	0	0	302	311
Ханты-Мансийский автономный округ	Государственные, муниципальные (без учета организаций в ведении ФСИН); Заочная	Прибыло студентов - всего (сумма стр. 02-05) / 1.0	0	0	0	0	0	0	0	0	0	0	0	0	0	173	173	4	0	0	106	110
Ханты-Мансийский автономный округ	Государственные, муниципальные (без учета организаций в ведении ФСИН); Заочная	"Численность студентов на начало прошлого учебного года
(на 1 октября) / 17.0"	0	0	0	0	0	0	0	0	0	0	0	0	0	1424	1424	171	0	0	1785	1956
Ханты-Мансийский автономный округ	Государственные, муниципальные (без учета организаций в ведении ФСИН); Очная	            из стр. 11 - не прошли итоговую аттестацию / 12.0	7	0	0	0	7	1	0	0	0	1	5	0	0	1	6	0	0	0	0	0
Ханты-Мансийский автономный округ	Государственные, муниципальные (без учета организаций в ведении ФСИН); Очная	"            из стр. 11 – лица с ограниченными возможностями здоровья,
            инвалиды, дети-инвалиды / 13.0"	0	0	0	0	0	0	0	0	0	0	2	0	0	0	2	0	0	0	0	0
Ханты-Мансийский автономный округ	Государственные, муниципальные (без учета организаций в ведении ФСИН); Очная	         отчислено в виде меры дисциплинарного взыскания / 14.0	8	0	0	0	8	0	0	0	0	0	10	0	0	2	12	0	0	0	2	2
Ханты-Мансийский автономный округ	Государственные, муниципальные (без учета организаций в ведении ФСИН); Очная	         отчислено из-за просрочки оплаты обучения / 15.0	0	0	0	12	12	0	0	0	0	0	0	0	0	14	14	0	0	0	4	4
Ханты-Мансийский автономный округ	Государственные, муниципальные (без учета организаций в ведении ФСИН); Очная	"    в том числе:
    переведено на другие формы обучения данной
    организации на программы того же уровня / 7.0"	13	0	0	3	16	0	0	0	0	0	54	0	10	42	106	1	0	0	1	2
Ханты-Мансийский автономный округ	Государственные, муниципальные (без учета организаций в ведении ФСИН); Очная	"    в том числе:
    переведено с других форм обучения данной
    образовательной организации с программ того же уровня / 2.0"	12	0	0	0	12	0	0	0	0	0	85	0	8	15	108	3	0	0	1	4
Ханты-Мансийский автономный округ	Государственные, муниципальные (без учета организаций в ведении ФСИН); Очная	    восстановлены из числа ранее отчисленных / 4.0	38	0	0	1	39	1	0	0	0	1	78	0	4	38	120	26	0	0	12	38
Ханты-Мансийский автономный округ	Государственные, муниципальные (без учета организаций в ведении ФСИН); Очная	    выбыло по другим причинам / 16.0	171	0	0	15	186	17	0	0	1	18	198	0	4	76	278	10	0	2	16	28
Ханты-Мансийский автономный округ	Государственные, муниципальные (без учета организаций в ведении ФСИН); Очная	"    добровольно прекратили образовательные отношения
    (бросили учебу) / 10.0"	228	0	0	29	257	4	0	0	1	5	546	0	68	214	828	109	0	1	55	165
Ханты-Мансийский автономный округ	Государственные, муниципальные (без учета организаций в ведении ФСИН); Очная	"    отчислено:
         по неуспеваемости / 11.0"	56	0	0	1	57	5	0	0	0	5	70	0	13	27	110	23	0	0	5	28
Ханты-Мансийский автономный округ	Государственные, муниципальные (без учета организаций в ведении ФСИН); Очная	"    переведено в другие образовательные организации
    на программы того же уровня / 8.0"	51	0	0	7	58	1	0	0	1	2	150	0	13	71	234	21	0	0	8	29
Ханты-Мансийский автономный округ	Государственные, муниципальные (без учета организаций в ведении ФСИН); Очная	"    переведено из других образовательных организаций 
    с программ того же уровня / 3.0"	69	0	0	0	69	1	0	0	1	2	121	0	13	33	167	15	0	0	7	22
Ханты-Мансийский автономный округ	Государственные, муниципальные (без учета организаций в ведении ФСИН); Очная	    по болезни / 9.0	1	0	0	0	1	2	0	0	0	2	1	0	0	1	2	0	0	0	0	0
Ханты-Мансийский автономный округ	Государственные, муниципальные (без учета организаций в ведении ФСИН); Очная	    прибыло по другим причинам / 5.0	112	0	0	3	115	2	0	0	6	8	117	0	8	40	165	25	0	0	5	30
Ханты-Мансийский автономный округ	Государственные, муниципальные (без учета организаций в ведении ФСИН); Очная	Выбыло студентов - всего (сумма стр. 07-11, 13-15) / 6.0	528	0	0	67	595	29	0	0	3	32	1029	0	108	447	1584	164	0	3	91	258
Ханты-Мансийский автономный округ	Государственные, муниципальные (без учета организаций в ведении ФСИН); Очная	Прибыло студентов - всего (сумма стр. 02-05) / 1.0	231	0	0	4	235	4	0	0	7	11	401	0	33	126	560	69	0	0	25	94
Ханты-Мансийский автономный округ	Государственные, муниципальные (без учета организаций в ведении ФСИН); Очная	"Численность студентов на начало прошлого учебного года
(на 1 октября) / 17.0"	5559	0	0	255	5814	174	0	0	33	207	12991	0	1571	2890	17452	1428	0	24	446	1898
Ханты-Мансийский автономный округ	Очно-заочная; Государственные, муниципальные (без учета организаций в ведении ФСИН)	            из стр. 11 - не прошли итоговую аттестацию / 12.0	0	0	0	0	0	0	0	0	0	0	0	0	0	0	0	0	0	0	0	0
Ханты-Мансийский автономный округ	Очно-заочная; Государственные, муниципальные (без учета организаций в ведении ФСИН)	"            из стр. 11 – лица с ограниченными возможностями здоровья,
            инвалиды, дети-инвалиды / 13.0"	0	0	0	0	0	0	0	0	0	0	0	0	0	0	0	0	0	0	0	0
Ханты-Мансийский автономный округ	Очно-заочная; Государственные, муниципальные (без учета организаций в ведении ФСИН)	         отчислено в виде меры дисциплинарного взыскания / 14.0	0	0	0	2	2	0	0	0	0	0	0	0	0	0	0	0	0	0	0	0
Ханты-Мансийский автономный округ	Очно-заочная; Государственные, муниципальные (без учета организаций в ведении ФСИН)	         отчислено из-за просрочки оплаты обучения / 15.0	0	0	0	0	0	0	0	0	0	0	0	0	0	0	0	0	0	0	1	1
Ханты-Мансийский автономный округ	Очно-заочная; Государственные, муниципальные (без учета организаций в ведении ФСИН)	"    в том числе:
    переведено на другие формы обучения данной
    организации на программы того же уровня / 7.0"	0	0	0	0	0	0	0	0	0	0	0	0	0	0	0	0	0	0	0	0
Ханты-Мансийский автономный округ	Очно-заочная; Государственные, муниципальные (без учета организаций в ведении ФСИН)	"    в том числе:
    переведено с других форм обучения данной
    образовательной организации с программ того же уровня / 2.0"	0	0	0	0	0	0	0	0	0	0	0	0	0	0	0	0	0	0	2	2
Ханты-Мансийский автономный округ	Очно-заочная; Государственные, муниципальные (без учета организаций в ведении ФСИН)	    восстановлены из числа ранее отчисленных / 4.0	0	0	0	0	0	0	0	0	0	0	0	0	0	0	0	0	0	0	7	7
Ханты-Мансийский автономный округ	Очно-заочная; Государственные, муниципальные (без учета организаций в ведении ФСИН)	    выбыло по другим причинам / 16.0	0	0	0	0	0	0	0	0	0	0	0	0	0	0	0	0	0	0	2	2
Ханты-Мансийский автономный округ	Очно-заочная; Государственные, муниципальные (без учета организаций в ведении ФСИН)	"    добровольно прекратили образовательные отношения
    (бросили учебу) / 10.0"	0	0	0	2	2	0	0	0	0	0	0	0	0	0	0	0	0	0	30	30
Ханты-Мансийский автономный округ	Очно-заочная; Государственные, муниципальные (без учета организаций в ведении ФСИН)	"    отчислено:
         по неуспеваемости / 11.0"	0	0	0	0	0	0	0	0	0	0	0	0	0	0	0	0	0	0	5	5
Ханты-Мансийский автономный округ	Очно-заочная; Государственные, муниципальные (без учета организаций в ведении ФСИН)	"    переведено в другие образовательные организации
    на программы того же уровня / 8.0"	0	0	0	0	0	0	0	0	0	0	0	0	0	0	0	0	0	0	0	0
Ханты-Мансийский автономный округ	Очно-заочная; Государственные, муниципальные (без учета организаций в ведении ФСИН)	"    переведено из других образовательных организаций 
    с программ того же уровня / 3.0"	0	0	0	0	0	0	0	0	0	0	0	0	0	0	0	0	0	0	0	0
Ханты-Мансийский автономный округ	Очно-заочная; Государственные, муниципальные (без учета организаций в ведении ФСИН)	    по болезни / 9.0	0	0	0	0	0	0	0	0	0	0	0	0	0	0	0	0	0	0	0	0
Ханты-Мансийский автономный округ	Очно-заочная; Государственные, муниципальные (без учета организаций в ведении ФСИН)	    прибыло по другим причинам / 5.0	0	0	0	0	0	0	0	0	0	0	0	0	0	0	0	0	0	0	0	0
Ханты-Мансийский автономный округ	Очно-заочная; Государственные, муниципальные (без учета организаций в ведении ФСИН)	Выбыло студентов - всего (сумма стр. 07-11, 13-15) / 6.0	0	0	0	4	4	0	0	0	0	0	0	0	0	0	0	0	0	0	38	38
Ханты-Мансийский автономный округ	Очно-заочная; Государственные, муниципальные (без учета организаций в ведении ФСИН)	Прибыло студентов - всего (сумма стр. 02-05) / 1.0	0	0	0	0	0	0	0	0	0	0	0	0	0	0	0	0	0	0	9	9
Ханты-Мансийский автономный округ	Очно-заочная; Государственные, муниципальные (без учета организаций в ведении ФСИН)	"Численность студентов на начало прошлого учебного года
(на 1 октября) / 17.0"	0	0	0	29	29	0	0	0	0	0	0	0	0	0	0	0	0	0	357	357
Ханты-Мансийский автономный округ	Частные; Заочная	            из стр. 11 - не прошли итоговую аттестацию / 12.0	0	0	0	0	0	0	0	0	0	0	0	0	0	0	0	0	0	0	0	0
Ханты-Мансийский автономный округ	Частные; Заочная	"            из стр. 11 – лица с ограниченными возможностями здоровья,
            инвалиды, дети-инвалиды / 13.0"	0	0	0	0	0	0	0	0	0	0	0	0	0	0	0	0	0	0	0	0
Ханты-Мансийский автономный округ	Частные; Заочная	         отчислено в виде меры дисциплинарного взыскания / 14.0	0	0	0	0	0	0	0	0	0	0	0	0	0	0	0	0	0	0	0	0
Ханты-Мансийский автономный округ	Частные; Заочная	         отчислено из-за просрочки оплаты обучения / 15.0	0	0	0	0	0	0	0	0	0	0	0	0	0	28	28	0	0	0	13	13
Ханты-Мансийский автономный округ	Частные; Заочная	"    в том числе:
    переведено на другие формы обучения данной
    организации на программы того же уровня / 7.0"	0	0	0	0	0	0	0	0	0	0	0	0	0	11	11	0	0	0	2	2
Ханты-Мансийский автономный округ	Частные; Заочная	"    в том числе:
    переведено с других форм обучения данной
    образовательной организации с программ того же уровня / 2.0"	0	0	0	0	0	0	0	0	0	0	0	0	0	42	42	0	0	0	0	0
Ханты-Мансийский автономный округ	Частные; Заочная	    восстановлены из числа ранее отчисленных / 4.0	0	0	0	0	0	0	0	0	0	0	0	0	0	26	26	0	0	0	2	2
Ханты-Мансийский автономный округ	Частные; Заочная	    выбыло по другим причинам / 16.0	0	0	0	0	0	0	0	0	0	0	0	0	0	5	5	0	0	0	3	3
Ханты-Мансийский автономный округ	Частные; Заочная	"    добровольно прекратили образовательные отношения
    (бросили учебу) / 10.0"	0	0	0	0	0	0	0	0	0	0	0	0	0	19	19	0	0	0	11	11
Ханты-Мансийский автономный округ	Частные; Заочная	"    отчислено:
         по неуспеваемости / 11.0"	0	0	0	0	0	0	0	0	0	0	0	0	0	23	23	0	0	0	23	23
Ханты-Мансийский автономный округ	Частные; Заочная	"    переведено в другие образовательные организации
    на программы того же уровня / 8.0"	0	0	0	0	0	0	0	0	0	0	0	0	0	8	8	0	0	0	1	1
Ханты-Мансийский автономный округ	Частные; Заочная	"    переведено из других образовательных организаций 
    с программ того же уровня / 3.0"	0	0	0	0	0	0	0	0	0	0	0	0	0	2	2	0	0	0	0	0
Ханты-Мансийский автономный округ	Частные; Заочная	    по болезни / 9.0	0	0	0	0	0	0	0	0	0	0	0	0	0	0	0	0	0	0	0	0
Ханты-Мансийский автономный округ	Частные; Заочная	    прибыло по другим причинам / 5.0	0	0	0	0	0	0	0	0	0	0	0	0	0	0	0	0	0	0	0	0
Ханты-Мансийский автономный округ	Частные; Заочная	Выбыло студентов - всего (сумма стр. 07-11, 13-15) / 6.0	0	0	0	0	0	0	0	0	0	0	0	0	0	94	94	0	0	0	53	53
Ханты-Мансийский автономный округ	Частные; Заочная	Прибыло студентов - всего (сумма стр. 02-05) / 1.0	0	0	0	0	0	0	0	0	0	0	0	0	0	70	70	0	0	0	2	2
Ханты-Мансийский автономный округ	Частные; Заочная	"Численность студентов на начало прошлого учебного года
(на 1 октября) / 17.0"	0	0	0	0	0	0	0	0	0	0	0	0	0	280	280	0	0	0	174	174
Ханты-Мансийский автономный округ	Частные; Очная	            из стр. 11 - не прошли итоговую аттестацию / 12.0	0	0	0	0	0	0	0	0	0	0	0	0	0	0	0	0	0	0	0	0
Ханты-Мансийский автономный округ	Частные; Очная	"            из стр. 11 – лица с ограниченными возможностями здоровья,
            инвалиды, дети-инвалиды / 13.0"	0	0	0	0	0	0	0	0	0	0	0	0	0	0	0	0	0	0	0	0
Ханты-Мансийский автономный округ	Частные; Очная	         отчислено в виде меры дисциплинарного взыскания / 14.0	0	0	0	9	9	0	0	0	2	2	0	0	0	0	0	0	0	0	0	0
Ханты-Мансийский автономный округ	Частные; Очная	         отчислено из-за просрочки оплаты обучения / 15.0	0	0	0	0	0	0	0	0	0	0	0	0	0	79	79	0	0	0	21	21
Ханты-Мансийский автономный округ	Частные; Очная	"    в том числе:
    переведено на другие формы обучения данной
    организации на программы того же уровня / 7.0"	0	0	0	1	1	0	0	0	2	2	4	0	0	66	70	0	0	0	6	6
Ханты-Мансийский автономный округ	Частные; Очная	"    в том числе:
    переведено с других форм обучения данной
    образовательной организации с программ того же уровня / 2.0"	0	0	0	1	1	0	0	0	2	2	13	0	0	10	23	0	0	0	6	6
Ханты-Мансийский автономный округ	Частные; Очная	    восстановлены из числа ранее отчисленных / 4.0	0	0	0	10	10	0	0	0	1	1	0	0	0	70	70	0	0	0	0	0
Ханты-Мансийский автономный округ	Частные; Очная	    выбыло по другим причинам / 16.0	0	0	0	0	0	0	0	0	0	0	0	0	0	17	17	0	0	0	0	0
Ханты-Мансийский автономный округ	Частные; Очная	"    добровольно прекратили образовательные отношения
    (бросили учебу) / 10.0"	0	0	0	16	16	0	0	0	5	5	9	0	0	141	150	0	0	0	46	46
Ханты-Мансийский автономный округ	Частные; Очная	"    отчислено:
         по неуспеваемости / 11.0"	0	0	0	2	2	0	0	0	4	4	0	0	0	48	48	0	0	0	15	15
Ханты-Мансийский автономный округ	Частные; Очная	"    переведено в другие образовательные организации
    на программы того же уровня / 8.0"	0	0	0	4	4	0	0	0	0	0	0	0	0	13	13	0	0	0	3	3
Ханты-Мансийский автономный округ	Частные; Очная	"    переведено из других образовательных организаций 
    с программ того же уровня / 3.0"	0	0	0	0	0	0	0	0	1	1	0	0	0	20	20	0	0	0	23	23
Ханты-Мансийский автономный округ	Частные; Очная	    по болезни / 9.0	0	0	0	0	0	0	0	0	0	0	0	0	0	0	0	0	0	0	0	0
Ханты-Мансийский автономный округ	Частные; Очная	    прибыло по другим причинам / 5.0	0	0	0	0	0	0	0	0	0	0	0	0	0	0	0	0	0	0	0	0
Ханты-Мансийский автономный округ	Частные; Очная	Выбыло студентов - всего (сумма стр. 07-11, 13-15) / 6.0	0	0	0	32	32	0	0	0	13	13	13	0	0	364	377	0	0	0	91	91
Ханты-Мансийский автономный округ	Частные; Очная	Прибыло студентов - всего (сумма стр. 02-05) / 1.0	0	0	0	11	11	0	0	0	4	4	13	0	0	100	113	0	0	0	29	29
Ханты-Мансийский автономный округ	Частные; Очная	"Численность студентов на начало прошлого учебного года
(на 1 октября) / 17.0"	75	0	0	267	342	0	0	0	75	75	650	0	0	2305	2955	0	0	0	605	605
Ханты-Мансийский автономный округ	Частные; Очно-заочная	            из стр. 11 - не прошли итоговую аттестацию / 12.0	0	0	0	0	0	0	0	0	0	0	0	0	0	0	0	0	0	0	0	0
Ханты-Мансийский автономный округ	Частные; Очно-заочная	"            из стр. 11 – лица с ограниченными возможностями здоровья,
            инвалиды, дети-инвалиды / 13.0"	0	0	0	0	0	0	0	0	0	0	0	0	0	0	0	0	0	0	0	0
Ханты-Мансийский автономный округ	Частные; Очно-заочная	         отчислено в виде меры дисциплинарного взыскания / 14.0	0	0	0	0	0	0	0	0	0	0	0	0	0	0	0	0	0	0	0	0
Ханты-Мансийский автономный округ	Частные; Очно-заочная	         отчислено из-за просрочки оплаты обучения / 15.0	0	0	0	0	0	0	0	0	0	0	0	0	0	0	0	0	0	0	12	12
Ханты-Мансийский автономный округ	Частные; Очно-заочная	"    в том числе:
    переведено на другие формы обучения данной
    организации на программы того же уровня / 7.0"	0	0	0	0	0	0	0	0	0	0	0	0	0	0	0	0	0	0	6	6
Ханты-Мансийский автономный округ	Частные; Очно-заочная	"    в том числе:
    переведено с других форм обучения данной
    образовательной организации с программ того же уровня / 2.0"	0	0	0	0	0	0	0	0	0	0	0	0	0	0	0	0	0	0	3	3
Ханты-Мансийский автономный округ	Частные; Очно-заочная	    восстановлены из числа ранее отчисленных / 4.0	0	0	0	0	0	0	0	0	0	0	0	0	0	0	0	0	0	0	3	3
Ханты-Мансийский автономный округ	Частные; Очно-заочная	    выбыло по другим причинам / 16.0	0	0	0	0	0	0	0	0	0	0	0	0	0	0	0	0	0	0	0	0
Ханты-Мансийский автономный округ	Частные; Очно-заочная	"    добровольно прекратили образовательные отношения
    (бросили учебу) / 10.0"	0	0	0	0	0	0	0	0	0	0	0	0	0	0	0	0	0	0	3	3
Ханты-Мансийский автономный округ	Частные; Очно-заочная	"    отчислено:
         по неуспеваемости / 11.0"	0	0	0	0	0	0	0	0	0	0	0	0	0	0	0	0	0	0	0	0
Ханты-Мансийский автономный округ	Частные; Очно-заочная	"    переведено в другие образовательные организации
    на программы того же уровня / 8.0"	0	0	0	0	0	0	0	0	0	0	0	0	0	0	0	0	0	0	1	1
Ханты-Мансийский автономный округ	Частные; Очно-заочная	"    переведено из других образовательных организаций 
    с программ того же уровня / 3.0"	0	0	0	0	0	0	0	0	0	0	0	0	0	0	0	0	0	0	0	0
Ханты-Мансийский автономный округ	Частные; Очно-заочная	    по болезни / 9.0	0	0	0	0	0	0	0	0	0	0	0	0	0	0	0	0	0	0	0	0
Ханты-Мансийский автономный округ	Частные; Очно-заочная	    прибыло по другим причинам / 5.0	0	0	0	0	0	0	0	0	0	0	0	0	0	0	0	0	0	0	0	0
Ханты-Мансийский автономный округ	Частные; Очно-заочная	Выбыло студентов - всего (сумма стр. 07-11, 13-15) / 6.0	0	0	0	0	0	0	0	0	0	0	0	0	0	0	0	0	0	0	22	22
Ханты-Мансийский автономный округ	Частные; Очно-заочная	Прибыло студентов - всего (сумма стр. 02-05) / 1.0	0	0	0	0	0	0	0	0	0	0	0	0	0	0	0	0	0	0	6	6
Ханты-Мансийский автономный округ	Частные; Очно-заочная	"Численность студентов на начало прошлого учебного года
(на 1 октября) / 17.0"	0	0	0	0	0	0	0	0	0	0	0	0	0	0	0	0	0	0	107	107
Челябинская область	Государственные, муниципальные (без учета организаций в ведении ФСИН); Заочная	            из стр. 11 - не прошли итоговую аттестацию / 12.0	0	0	0	0	0	0	0	0	0	0	1	0	0	0	1	20	0	0	1	21
Челябинская область	Государственные, муниципальные (без учета организаций в ведении ФСИН); Заочная	"            из стр. 11 – лица с ограниченными возможностями здоровья,
            инвалиды, дети-инвалиды / 13.0"	0	0	0	0	0	0	0	0	0	0	0	0	0	0	0	0	0	0	0	0
Челябинская область	Государственные, муниципальные (без учета организаций в ведении ФСИН); Заочная	         отчислено в виде меры дисциплинарного взыскания / 14.0	0	0	0	0	0	0	0	0	0	0	0	0	0	0	0	0	0	0	0	0
Челябинская область	Государственные, муниципальные (без учета организаций в ведении ФСИН); Заочная	         отчислено из-за просрочки оплаты обучения / 15.0	0	0	0	0	0	0	0	0	0	0	0	0	0	18	18	0	0	0	32	32
Челябинская область	Государственные, муниципальные (без учета организаций в ведении ФСИН); Заочная	"    в том числе:
    переведено на другие формы обучения данной
    организации на программы того же уровня / 7.0"	0	0	0	0	0	0	0	0	0	0	0	0	0	6	6	0	0	0	0	0
Челябинская область	Государственные, муниципальные (без учета организаций в ведении ФСИН); Заочная	"    в том числе:
    переведено с других форм обучения данной
    образовательной организации с программ того же уровня / 2.0"	0	0	0	0	0	0	0	0	0	0	4	0	0	61	65	10	0	1	56	67
Челябинская область	Государственные, муниципальные (без учета организаций в ведении ФСИН); Заочная	    восстановлены из числа ранее отчисленных / 4.0	0	0	0	0	0	0	0	0	0	0	0	0	0	29	29	16	0	2	38	56
Челябинская область	Государственные, муниципальные (без учета организаций в ведении ФСИН); Заочная	    выбыло по другим причинам / 16.0	0	0	0	0	0	0	0	0	0	0	2	0	0	28	30	101	0	29	62	192
Челябинская область	Государственные, муниципальные (без учета организаций в ведении ФСИН); Заочная	"    добровольно прекратили образовательные отношения
    (бросили учебу) / 10.0"	0	0	0	0	0	0	0	0	0	0	2	0	2	48	52	140	0	11	76	227
Челябинская область	Государственные, муниципальные (без учета организаций в ведении ФСИН); Заочная	"    отчислено:
         по неуспеваемости / 11.0"	0	0	0	0	0	0	0	0	0	0	5	0	9	30	44	133	0	6	74	213
Челябинская область	Государственные, муниципальные (без учета организаций в ведении ФСИН); Заочная	"    переведено в другие образовательные организации
    на программы того же уровня / 8.0"	0	0	0	0	0	0	0	0	0	0	0	0	0	3	3	1	0	0	7	8
Челябинская область	Государственные, муниципальные (без учета организаций в ведении ФСИН); Заочная	"    переведено из других образовательных организаций 
    с программ того же уровня / 3.0"	0	0	0	0	0	0	0	0	0	0	0	0	0	26	26	6	0	0	12	18
Челябинская область	Государственные, муниципальные (без учета организаций в ведении ФСИН); Заочная	    по болезни / 9.0	0	0	0	0	0	0	0	0	0	0	0	0	0	0	0	1	0	0	1	2
Челябинская область	Государственные, муниципальные (без учета организаций в ведении ФСИН); Заочная	    прибыло по другим причинам / 5.0	0	0	0	0	0	0	0	0	0	0	0	0	0	26	26	61	0	0	75	136
Челябинская область	Государственные, муниципальные (без учета организаций в ведении ФСИН); Заочная	Выбыло студентов - всего (сумма стр. 07-11, 13-15) / 6.0	0	0	0	0	0	0	0	0	0	0	9	0	11	133	153	376	0	46	252	674
Челябинская область	Государственные, муниципальные (без учета организаций в ведении ФСИН); Заочная	Прибыло студентов - всего (сумма стр. 02-05) / 1.0	0	0	0	0	0	0	0	0	0	0	4	0	0	142	146	93	0	3	181	277
Челябинская область	Государственные, муниципальные (без учета организаций в ведении ФСИН); Заочная	"Численность студентов на начало прошлого учебного года
(на 1 октября) / 17.0"	0	0	0	0	0	0	0	0	0	0	170	0	116	941	1227	3185	0	267	1577	5029
Челябинская область	Государственные, муниципальные (без учета организаций в ведении ФСИН); Очная	            из стр. 11 - не прошли итоговую аттестацию / 12.0	17	0	0	2	19	0	0	0	0	0	24	0	0	0	24	2	0	0	0	2
Челябинская область	Государственные, муниципальные (без учета организаций в ведении ФСИН); Очная	"            из стр. 11 – лица с ограниченными возможностями здоровья,
            инвалиды, дети-инвалиды / 13.0"	1	0	0	0	1	0	0	0	0	0	0	0	0	0	0	0	0	0	0	0
Челябинская область	Государственные, муниципальные (без учета организаций в ведении ФСИН); Очная	         отчислено в виде меры дисциплинарного взыскания / 14.0	5	0	0	0	5	0	0	0	0	0	5	0	1	0	6	0	0	1	1	2
Челябинская область	Государственные, муниципальные (без учета организаций в ведении ФСИН); Очная	         отчислено из-за просрочки оплаты обучения / 15.0	0	0	0	12	12	0	0	0	3	3	0	0	0	80	80	0	0	0	23	23
Челябинская область	Государственные, муниципальные (без учета организаций в ведении ФСИН); Очная	"    в том числе:
    переведено на другие формы обучения данной
    организации на программы того же уровня / 7.0"	51	0	0	3	54	0	0	0	0	0	149	0	49	195	393	5	0	0	8	13
Челябинская область	Государственные, муниципальные (без учета организаций в ведении ФСИН); Очная	"    в том числе:
    переведено с других форм обучения данной
    образовательной организации с программ того же уровня / 2.0"	30	0	0	0	30	0	0	0	0	0	175	0	86	44	305	9	0	2	4	15
Челябинская область	Государственные, муниципальные (без учета организаций в ведении ФСИН); Очная	    восстановлены из числа ранее отчисленных / 4.0	29	0	0	2	31	0	0	0	0	0	113	0	18	86	217	16	0	0	21	37
Челябинская область	Государственные, муниципальные (без учета организаций в ведении ФСИН); Очная	    выбыло по другим причинам / 16.0	280	0	0	46	326	5	0	0	2	7	615	0	44	193	852	59	0	1	60	120
Челябинская область	Государственные, муниципальные (без учета организаций в ведении ФСИН); Очная	"    добровольно прекратили образовательные отношения
    (бросили учебу) / 10.0"	660	0	0	61	721	23	0	0	3	26	1620	0	273	597	2490	194	0	88	124	406
Челябинская область	Государственные, муниципальные (без учета организаций в ведении ФСИН); Очная	"    отчислено:
         по неуспеваемости / 11.0"	283	0	0	15	298	11	0	0	1	12	495	0	87	188	770	38	0	14	28	80
Челябинская область	Государственные, муниципальные (без учета организаций в ведении ФСИН); Очная	"    переведено в другие образовательные организации
    на программы того же уровня / 8.0"	108	0	0	4	112	0	0	0	0	0	470	0	73	204	747	25	0	1	13	39
Челябинская область	Государственные, муниципальные (без учета организаций в ведении ФСИН); Очная	"    переведено из других образовательных организаций 
    с программ того же уровня / 3.0"	64	0	0	12	76	0	0	0	0	0	298	0	22	125	445	9	0	1	5	15
Челябинская область	Государственные, муниципальные (без учета организаций в ведении ФСИН); Очная	    по болезни / 9.0	1	0	0	0	1	0	0	0	0	0	5	0	0	2	7	0	0	0	0	0
Челябинская область	Государственные, муниципальные (без учета организаций в ведении ФСИН); Очная	    прибыло по другим причинам / 5.0	126	0	0	89	215	2	0	0	8	10	321	0	23	178	522	50	0	3	38	91
Челябинская область	Государственные, муниципальные (без учета организаций в ведении ФСИН); Очная	Выбыло студентов - всего (сумма стр. 07-11, 13-15) / 6.0	1388	0	0	141	1529	39	0	0	9	48	3359	0	527	1459	5345	321	0	105	257	683
Челябинская область	Государственные, муниципальные (без учета организаций в ведении ФСИН); Очная	Прибыло студентов - всего (сумма стр. 02-05) / 1.0	249	0	0	103	352	2	0	0	8	10	907	0	149	433	1489	84	0	6	68	158
Челябинская область	Государственные, муниципальные (без учета организаций в ведении ФСИН); Очная	"Численность студентов на начало прошлого учебного года
(на 1 октября) / 17.0"	12864	150	0	844	13858	171	0	0	42	213	34883	125	5685	9983	50676	2854	0	992	1798	5644
Челябинская область	Очно-заочная; Государственные, муниципальные (без учета организаций в ведении ФСИН)	            из стр. 11 - не прошли итоговую аттестацию / 12.0	0	0	0	0	0	0	0	0	0	0	0	0	0	0	0	0	0	0	0	0
Челябинская область	Очно-заочная; Государственные, муниципальные (без учета организаций в ведении ФСИН)	"            из стр. 11 – лица с ограниченными возможностями здоровья,
            инвалиды, дети-инвалиды / 13.0"	0	0	0	0	0	0	0	0	0	0	0	0	0	0	0	0	0	0	0	0
Челябинская область	Очно-заочная; Государственные, муниципальные (без учета организаций в ведении ФСИН)	         отчислено в виде меры дисциплинарного взыскания / 14.0	0	0	0	0	0	0	0	0	0	0	0	0	0	0	0	0	0	0	0	0
Челябинская область	Очно-заочная; Государственные, муниципальные (без учета организаций в ведении ФСИН)	         отчислено из-за просрочки оплаты обучения / 15.0	0	0	0	0	0	0	0	0	0	0	0	0	0	0	0	0	0	0	3	3
Челябинская область	Очно-заочная; Государственные, муниципальные (без учета организаций в ведении ФСИН)	"    в том числе:
    переведено на другие формы обучения данной
    организации на программы того же уровня / 7.0"	0	0	0	0	0	0	0	0	0	0	0	0	0	0	0	0	0	0	0	0
Челябинская область	Очно-заочная; Государственные, муниципальные (без учета организаций в ведении ФСИН)	"    в том числе:
    переведено с других форм обучения данной
    образовательной организации с программ того же уровня / 2.0"	0	0	0	0	0	0	0	0	0	0	0	0	0	2	2	2	0	0	9	11
Челябинская область	Очно-заочная; Государственные, муниципальные (без учета организаций в ведении ФСИН)	    восстановлены из числа ранее отчисленных / 4.0	0	0	0	0	0	0	0	0	0	0	0	0	0	0	0	0	0	0	1	1
Челябинская область	Очно-заочная; Государственные, муниципальные (без учета организаций в ведении ФСИН)	    выбыло по другим причинам / 16.0	0	0	0	0	0	0	0	0	0	0	4	0	0	0	4	0	0	0	15	15
Челябинская область	Очно-заочная; Государственные, муниципальные (без учета организаций в ведении ФСИН)	"    добровольно прекратили образовательные отношения
    (бросили учебу) / 10.0"	0	0	0	0	0	1	0	0	0	1	5	0	0	0	5	52	0	0	30	82
Челябинская область	Очно-заочная; Государственные, муниципальные (без учета организаций в ведении ФСИН)	"    отчислено:
         по неуспеваемости / 11.0"	0	0	0	0	0	0	0	0	0	0	6	0	0	0	6	7	0	0	0	7
Челябинская область	Очно-заочная; Государственные, муниципальные (без учета организаций в ведении ФСИН)	"    переведено в другие образовательные организации
    на программы того же уровня / 8.0"	0	0	0	0	0	0	0	0	0	0	0	0	0	0	0	2	0	0	26	28
Челябинская область	Очно-заочная; Государственные, муниципальные (без учета организаций в ведении ФСИН)	"    переведено из других образовательных организаций 
    с программ того же уровня / 3.0"	0	0	0	0	0	0	0	0	0	0	0	0	0	0	0	0	0	0	0	0
Челябинская область	Очно-заочная; Государственные, муниципальные (без учета организаций в ведении ФСИН)	    по болезни / 9.0	0	0	0	0	0	0	0	0	0	0	0	0	0	0	0	0	0	0	0	0
Челябинская область	Очно-заочная; Государственные, муниципальные (без учета организаций в ведении ФСИН)	    прибыло по другим причинам / 5.0	1	0	0	0	1	0	0	0	0	0	0	0	0	0	0	8	0	0	10	18
Челябинская область	Очно-заочная; Государственные, муниципальные (без учета организаций в ведении ФСИН)	Выбыло студентов - всего (сумма стр. 07-11, 13-15) / 6.0	0	0	0	0	0	1	0	0	0	1	15	0	0	0	15	61	0	0	74	135
Челябинская область	Очно-заочная; Государственные, муниципальные (без учета организаций в ведении ФСИН)	Прибыло студентов - всего (сумма стр. 02-05) / 1.0	1	0	0	0	1	0	0	0	0	0	0	0	0	2	2	10	0	0	20	30
Челябинская область	Очно-заочная; Государственные, муниципальные (без учета организаций в ведении ФСИН)	"Численность студентов на начало прошлого учебного года
(на 1 октября) / 17.0"	24	0	0	0	24	40	0	0	1	41	61	0	0	0	61	360	0	0	335	695
Челябинская область	Частные; Заочная	            из стр. 11 - не прошли итоговую аттестацию / 12.0	0	0	0	0	0	0	0	0	0	0	0	0	0	0	0	0	0	0	2	2
Челябинская область	Частные; Заочная	"            из стр. 11 – лица с ограниченными возможностями здоровья,
            инвалиды, дети-инвалиды / 13.0"	0	0	0	0	0	0	0	0	0	0	0	0	0	0	0	0	0	0	0	0
Челябинская область	Частные; Заочная	         отчислено в виде меры дисциплинарного взыскания / 14.0	0	0	0	0	0	0	0	0	0	0	0	0	0	0	0	0	0	0	0	0
Челябинская область	Частные; Заочная	         отчислено из-за просрочки оплаты обучения / 15.0	0	0	0	0	0	0	0	0	0	0	0	0	0	26	26	0	0	0	6	6
Челябинская область	Частные; Заочная	"    в том числе:
    переведено на другие формы обучения данной
    организации на программы того же уровня / 7.0"	0	0	0	0	0	0	0	0	0	0	0	0	0	26	26	0	0	0	7	7
Челябинская область	Частные; Заочная	"    в том числе:
    переведено с других форм обучения данной
    образовательной организации с программ того же уровня / 2.0"	0	0	0	0	0	0	0	0	0	0	0	0	0	164	164	0	0	0	33	33
Челябинская область	Частные; Заочная	    восстановлены из числа ранее отчисленных / 4.0	0	0	0	0	0	0	0	0	0	0	0	0	0	66	66	0	0	0	9	9
Челябинская область	Частные; Заочная	    выбыло по другим причинам / 16.0	0	0	0	0	0	0	0	0	0	0	0	0	0	11	11	0	0	0	5	5
Челябинская область	Частные; Заочная	"    добровольно прекратили образовательные отношения
    (бросили учебу) / 10.0"	0	0	0	0	0	0	0	0	0	0	0	0	0	60	60	0	0	0	47	47
Челябинская область	Частные; Заочная	"    отчислено:
         по неуспеваемости / 11.0"	0	0	0	0	0	0	0	0	0	0	0	0	0	62	62	0	0	0	32	32
Челябинская область	Частные; Заочная	"    переведено в другие образовательные организации
    на программы того же уровня / 8.0"	0	0	0	0	0	0	0	0	0	0	0	0	0	1	1	0	0	0	4	4
Челябинская область	Частные; Заочная	"    переведено из других образовательных организаций 
    с программ того же уровня / 3.0"	0	0	0	0	0	0	0	0	0	0	0	0	0	80	80	0	0	0	2	2
Челябинская область	Частные; Заочная	    по болезни / 9.0	0	0	0	0	0	0	0	0	0	0	0	0	0	0	0	0	0	0	0	0
Челябинская область	Частные; Заочная	    прибыло по другим причинам / 5.0	0	0	0	0	0	0	0	0	0	0	0	0	0	105	105	0	0	0	0	0
Челябинская область	Частные; Заочная	Выбыло студентов - всего (сумма стр. 07-11, 13-15) / 6.0	0	0	0	0	0	0	0	0	0	0	0	0	0	186	186	0	0	0	101	101
Челябинская область	Частные; Заочная	Прибыло студентов - всего (сумма стр. 02-05) / 1.0	0	0	0	0	0	0	0	0	0	0	0	0	0	415	415	0	0	0	44	44
Челябинская область	Частные; Заочная	"Численность студентов на начало прошлого учебного года
(на 1 октября) / 17.0"	0	0	0	0	0	0	0	0	0	0	0	0	0	1321	1321	0	0	0	611	611
Челябинская область	Частные; Очная	            из стр. 11 - не прошли итоговую аттестацию / 12.0	0	0	0	0	0	0	0	0	0	0	0	0	0	10	10	0	0	0	2	2
Челябинская область	Частные; Очная	"            из стр. 11 – лица с ограниченными возможностями здоровья,
            инвалиды, дети-инвалиды / 13.0"	0	0	0	0	0	0	0	0	0	0	0	0	0	0	0	0	0	0	0	0
Челябинская область	Частные; Очная	         отчислено в виде меры дисциплинарного взыскания / 14.0	0	0	0	0	0	0	0	0	0	0	0	0	0	20	20	0	0	0	0	0
Челябинская область	Частные; Очная	         отчислено из-за просрочки оплаты обучения / 15.0	0	0	0	0	0	0	0	0	0	0	0	0	0	103	103	0	0	0	29	29
Челябинская область	Частные; Очная	"    в том числе:
    переведено на другие формы обучения данной
    организации на программы того же уровня / 7.0"	0	0	0	0	0	0	0	0	0	0	0	0	0	189	189	0	0	0	40	40
Челябинская область	Частные; Очная	"    в том числе:
    переведено с других форм обучения данной
    образовательной организации с программ того же уровня / 2.0"	0	0	0	0	0	0	0	0	0	0	0	0	0	67	67	0	0	0	11	11
Челябинская область	Частные; Очная	    восстановлены из числа ранее отчисленных / 4.0	0	0	0	0	0	0	0	0	0	0	0	0	0	82	82	0	0	0	25	25
Челябинская область	Частные; Очная	    выбыло по другим причинам / 16.0	0	0	0	0	0	0	0	0	0	0	0	0	0	35	35	0	0	0	24	24
Челябинская область	Частные; Очная	"    добровольно прекратили образовательные отношения
    (бросили учебу) / 10.0"	0	0	0	18	18	0	0	0	0	0	0	0	0	559	559	0	0	0	127	127
Челябинская область	Частные; Очная	"    отчислено:
         по неуспеваемости / 11.0"	0	0	0	0	0	0	0	0	0	0	0	0	0	201	201	0	0	0	71	71
Челябинская область	Частные; Очная	"    переведено в другие образовательные организации
    на программы того же уровня / 8.0"	0	0	0	0	0	0	0	0	0	0	0	0	0	155	155	0	0	0	24	24
Челябинская область	Частные; Очная	"    переведено из других образовательных организаций 
    с программ того же уровня / 3.0"	0	0	0	0	0	0	0	0	0	0	0	0	0	187	187	0	0	0	18	18
Челябинская область	Частные; Очная	    по болезни / 9.0	0	0	0	0	0	0	0	0	0	0	0	0	0	2	2	0	0	0	0	0
Челябинская область	Частные; Очная	    прибыло по другим причинам / 5.0	0	0	0	0	0	0	0	0	0	0	0	0	0	19	19	0	0	0	5	5
Челябинская область	Частные; Очная	Выбыло студентов - всего (сумма стр. 07-11, 13-15) / 6.0	0	0	0	18	18	0	0	0	0	0	0	0	0	1264	1264	0	0	0	315	315
Челябинская область	Частные; Очная	Прибыло студентов - всего (сумма стр. 02-05) / 1.0	0	0	0	0	0	0	0	0	0	0	0	0	0	355	355	0	0	0	59	59
Челябинская область	Частные; Очная	"Численность студентов на начало прошлого учебного года
(на 1 октября) / 17.0"	0	0	0	48	48	0	0	0	0	0	0	0	0	13204	13204	0	0	0	2224	2224
Челябинская область	Частные; Очно-заочная	            из стр. 11 - не прошли итоговую аттестацию / 12.0	0	0	0	0	0	0	0	0	0	0	0	0	0	0	0	0	0	0	0	0
Челябинская область	Частные; Очно-заочная	"            из стр. 11 – лица с ограниченными возможностями здоровья,
            инвалиды, дети-инвалиды / 13.0"	0	0	0	0	0	0	0	0	0	0	0	0	0	0	0	0	0	0	0	0
Челябинская область	Частные; Очно-заочная	         отчислено в виде меры дисциплинарного взыскания / 14.0	0	0	0	0	0	0	0	0	0	0	0	0	0	0	0	0	0	0	0	0
Челябинская область	Частные; Очно-заочная	         отчислено из-за просрочки оплаты обучения / 15.0	0	0	0	0	0	0	0	0	0	0	0	0	0	0	0	0	0	0	11	11
Челябинская область	Частные; Очно-заочная	"    в том числе:
    переведено на другие формы обучения данной
    организации на программы того же уровня / 7.0"	0	0	0	0	0	0	0	0	0	0	0	0	0	0	0	0	0	0	0	0
Челябинская область	Частные; Очно-заочная	"    в том числе:
    переведено с других форм обучения данной
    образовательной организации с программ того же уровня / 2.0"	0	0	0	0	0	0	0	0	0	0	0	0	0	0	0	0	0	0	0	0
Челябинская область	Частные; Очно-заочная	    восстановлены из числа ранее отчисленных / 4.0	0	0	0	0	0	0	0	0	0	0	0	0	0	0	0	0	0	0	0	0
Челябинская область	Частные; Очно-заочная	    выбыло по другим причинам / 16.0	0	0	0	0	0	0	0	0	0	0	0	0	0	0	0	0	0	0	1	1
Челябинская область	Частные; Очно-заочная	"    добровольно прекратили образовательные отношения
    (бросили учебу) / 10.0"	0	0	0	1	1	0	0	0	0	0	0	0	0	1	1	0	0	0	75	75
Челябинская область	Частные; Очно-заочная	"    отчислено:
         по неуспеваемости / 11.0"	0	0	0	0	0	0	0	0	0	0	0	0	0	0	0	0	0	0	6	6
Челябинская область	Частные; Очно-заочная	"    переведено в другие образовательные организации
    на программы того же уровня / 8.0"	0	0	0	0	0	0	0	0	0	0	0	0	0	0	0	0	0	0	0	0
Челябинская область	Частные; Очно-заочная	"    переведено из других образовательных организаций 
    с программ того же уровня / 3.0"	0	0	0	0	0	0	0	0	0	0	0	0	0	1	1	0	0	0	6	6
Челябинская область	Частные; Очно-заочная	    по болезни / 9.0	0	0	0	0	0	0	0	0	0	0	0	0	0	0	0	0	0	0	0	0
Челябинская область	Частные; Очно-заочная	    прибыло по другим причинам / 5.0	0	0	0	0	0	0	0	0	0	0	0	0	0	0	0	0	0	0	3	3
Челябинская область	Частные; Очно-заочная	Выбыло студентов - всего (сумма стр. 07-11, 13-15) / 6.0	0	0	0	1	1	0	0	0	0	0	0	0	0	1	1	0	0	0	93	93
Челябинская область	Частные; Очно-заочная	Прибыло студентов - всего (сумма стр. 02-05) / 1.0	0	0	0	0	0	0	0	0	0	0	0	0	0	1	1	0	0	0	9	9
Челябинская область	Частные; Очно-заочная	"Численность студентов на начало прошлого учебного года
(на 1 октября) / 17.0"	0	0	0	6	6	0	0	0	0	0	0	0	0	7	7	0	0	0	1148	1148
Чеченская Республика	Государственные, муниципальные (без учета организаций в ведении ФСИН); Заочная	            из стр. 11 - не прошли итоговую аттестацию / 12.0	0	0	0	0	0	0	0	0	0	0	23	0	0	8	31	0	0	0	0	0
Чеченская Республика	Государственные, муниципальные (без учета организаций в ведении ФСИН); Заочная	"            из стр. 11 – лица с ограниченными возможностями здоровья,
            инвалиды, дети-инвалиды / 13.0"	0	0	0	0	0	0	0	0	0	0	1	0	0	0	1	0	0	0	0	0
Чеченская Республика	Государственные, муниципальные (без учета организаций в ведении ФСИН); Заочная	         отчислено в виде меры дисциплинарного взыскания / 14.0	0	0	0	0	0	0	0	0	0	0	0	0	0	2	2	1	0	0	0	1
Чеченская Республика	Государственные, муниципальные (без учета организаций в ведении ФСИН); Заочная	         отчислено из-за просрочки оплаты обучения / 15.0	0	0	0	0	0	0	0	0	0	0	0	0	0	78	78	0	0	0	4	4
Чеченская Республика	Государственные, муниципальные (без учета организаций в ведении ФСИН); Заочная	"    в том числе:
    переведено на другие формы обучения данной
    организации на программы того же уровня / 7.0"	0	0	0	0	0	0	0	0	0	0	10	0	0	58	68	0	0	0	0	0
Чеченская Республика	Государственные, муниципальные (без учета организаций в ведении ФСИН); Заочная	"    в том числе:
    переведено с других форм обучения данной
    образовательной организации с программ того же уровня / 2.0"	0	0	0	0	0	0	0	0	0	0	63	0	0	323	386	0	0	0	4	4
Чеченская Республика	Государственные, муниципальные (без учета организаций в ведении ФСИН); Заочная	    восстановлены из числа ранее отчисленных / 4.0	0	0	0	0	0	0	0	0	0	0	10	0	0	52	62	1	0	0	9	10
Чеченская Республика	Государственные, муниципальные (без учета организаций в ведении ФСИН); Заочная	    выбыло по другим причинам / 16.0	0	0	0	0	0	0	0	0	0	0	4	0	0	36	40	1	0	0	1	2
Чеченская Республика	Государственные, муниципальные (без учета организаций в ведении ФСИН); Заочная	"    добровольно прекратили образовательные отношения
    (бросили учебу) / 10.0"	0	0	0	0	0	0	0	0	0	0	32	0	0	74	106	6	0	0	11	17
Чеченская Республика	Государственные, муниципальные (без учета организаций в ведении ФСИН); Заочная	"    отчислено:
         по неуспеваемости / 11.0"	0	0	0	0	0	0	0	0	0	0	53	0	0	200	253	0	0	1	42	43
Чеченская Республика	Государственные, муниципальные (без учета организаций в ведении ФСИН); Заочная	"    переведено в другие образовательные организации
    на программы того же уровня / 8.0"	0	0	0	0	0	0	0	0	0	0	22	0	0	51	73	0	0	0	1	1
Чеченская Республика	Государственные, муниципальные (без учета организаций в ведении ФСИН); Заочная	"    переведено из других образовательных организаций 
    с программ того же уровня / 3.0"	0	0	0	0	0	0	0	0	0	0	12	0	0	70	82	3	0	0	2	5
Чеченская Республика	Государственные, муниципальные (без учета организаций в ведении ФСИН); Заочная	    по болезни / 9.0	0	0	0	0	0	0	0	0	0	0	0	0	0	0	0	0	0	0	0	0
Чеченская Республика	Государственные, муниципальные (без учета организаций в ведении ФСИН); Заочная	    прибыло по другим причинам / 5.0	0	0	0	0	0	0	0	0	0	0	1	0	0	32	33	1	0	0	2	3
Чеченская Республика	Государственные, муниципальные (без учета организаций в ведении ФСИН); Заочная	Выбыло студентов - всего (сумма стр. 07-11, 13-15) / 6.0	0	0	0	0	0	0	0	0	0	0	121	0	0	499	620	8	0	1	59	68
Чеченская Республика	Государственные, муниципальные (без учета организаций в ведении ФСИН); Заочная	Прибыло студентов - всего (сумма стр. 02-05) / 1.0	0	0	0	0	0	0	0	0	0	0	86	0	0	477	563	5	0	0	17	22
Чеченская Республика	Государственные, муниципальные (без учета организаций в ведении ФСИН); Заочная	"Численность студентов на начало прошлого учебного года
(на 1 октября) / 17.0"	0	0	0	0	0	0	0	0	0	0	1325	0	85	4935	6345	196	0	17	1036	1249
Чеченская Республика	Государственные, муниципальные (без учета организаций в ведении ФСИН); Очная	            из стр. 11 - не прошли итоговую аттестацию / 12.0	4	0	0	1	5	1	0	0	6	7	7	0	0	8	15	0	0	0	0	0
Чеченская Республика	Государственные, муниципальные (без учета организаций в ведении ФСИН); Очная	"            из стр. 11 – лица с ограниченными возможностями здоровья,
            инвалиды, дети-инвалиды / 13.0"	2	0	0	0	2	0	0	0	0	0	0	0	0	0	0	0	0	0	0	0
Чеченская Республика	Государственные, муниципальные (без учета организаций в ведении ФСИН); Очная	         отчислено в виде меры дисциплинарного взыскания / 14.0	17	0	0	3	20	0	0	0	0	0	12	0	1	8	21	0	0	0	0	0
Чеченская Республика	Государственные, муниципальные (без учета организаций в ведении ФСИН); Очная	         отчислено из-за просрочки оплаты обучения / 15.0	0	0	0	1	1	0	0	0	2	2	0	0	0	18	18	0	0	0	0	0
Чеченская Республика	Государственные, муниципальные (без учета организаций в ведении ФСИН); Очная	"    в том числе:
    переведено на другие формы обучения данной
    организации на программы того же уровня / 7.0"	5	0	0	5	10	0	0	0	0	0	275	0	1	120	396	16	0	0	0	16
Чеченская Республика	Государственные, муниципальные (без учета организаций в ведении ФСИН); Очная	"    в том числе:
    переведено с других форм обучения данной
    образовательной организации с программ того же уровня / 2.0"	7	0	0	1	8	0	0	0	0	0	46	0	1	38	85	0	0	0	0	0
Чеченская Республика	Государственные, муниципальные (без учета организаций в ведении ФСИН); Очная	    восстановлены из числа ранее отчисленных / 4.0	29	0	0	5	34	4	0	0	2	6	19	0	0	65	84	1	0	0	8	9
Чеченская Республика	Государственные, муниципальные (без учета организаций в ведении ФСИН); Очная	    выбыло по другим причинам / 16.0	43	0	0	0	43	4	0	0	1	5	69	0	3	153	225	31	0	0	12	43
Чеченская Республика	Государственные, муниципальные (без учета организаций в ведении ФСИН); Очная	"    добровольно прекратили образовательные отношения
    (бросили учебу) / 10.0"	61	0	0	30	91	31	0	0	13	44	299	0	2	131	432	8	0	5	24	37
Чеченская Республика	Государственные, муниципальные (без учета организаций в ведении ФСИН); Очная	"    отчислено:
         по неуспеваемости / 11.0"	36	0	0	6	42	11	0	0	89	100	61	0	21	146	228	10	0	0	8	18
Чеченская Республика	Государственные, муниципальные (без учета организаций в ведении ФСИН); Очная	"    переведено в другие образовательные организации
    на программы того же уровня / 8.0"	18	0	0	4	22	0	0	0	0	0	125	0	2	181	308	34	0	3	20	57
Чеченская Республика	Государственные, муниципальные (без учета организаций в ведении ФСИН); Очная	"    переведено из других образовательных организаций 
    с программ того же уровня / 3.0"	8	0	0	15	23	1	0	0	0	1	68	0	2	100	170	1	0	0	4	5
Чеченская Республика	Государственные, муниципальные (без учета организаций в ведении ФСИН); Очная	    по болезни / 9.0	0	0	0	0	0	1	0	0	0	1	1	0	0	0	1	0	0	0	0	0
Чеченская Республика	Государственные, муниципальные (без учета организаций в ведении ФСИН); Очная	    прибыло по другим причинам / 5.0	0	0	0	0	0	0	0	0	0	0	119	0	0	48	167	3	0	0	6	9
Чеченская Республика	Государственные, муниципальные (без учета организаций в ведении ФСИН); Очная	Выбыло студентов - всего (сумма стр. 07-11, 13-15) / 6.0	180	0	0	49	229	47	0	0	105	152	842	0	30	757	1629	99	0	8	64	171
Чеченская Республика	Государственные, муниципальные (без учета организаций в ведении ФСИН); Очная	Прибыло студентов - всего (сумма стр. 02-05) / 1.0	44	0	0	21	65	5	0	0	2	7	252	0	3	251	506	5	0	0	18	23
Чеченская Республика	Государственные, муниципальные (без учета организаций в ведении ФСИН); Очная	"Численность студентов на начало прошлого учебного года
(на 1 октября) / 17.0"	2871	0	0	414	3285	561	0	0	1768	2329	8202	0	1731	5569	15502	804	0	23	566	1393
Чеченская Республика	Очно-заочная; Государственные, муниципальные (без учета организаций в ведении ФСИН)	            из стр. 11 - не прошли итоговую аттестацию / 12.0	0	0	0	0	0	0	0	0	0	0	0	0	0	3	3	0	0	0	0	0
Чеченская Республика	Очно-заочная; Государственные, муниципальные (без учета организаций в ведении ФСИН)	"            из стр. 11 – лица с ограниченными возможностями здоровья,
            инвалиды, дети-инвалиды / 13.0"	0	0	0	0	0	0	0	0	0	0	0	0	0	0	0	0	0	0	0	0
Чеченская Республика	Очно-заочная; Государственные, муниципальные (без учета организаций в ведении ФСИН)	         отчислено в виде меры дисциплинарного взыскания / 14.0	0	0	0	0	0	0	0	0	0	0	0	0	0	0	0	0	0	0	0	0
Чеченская Республика	Очно-заочная; Государственные, муниципальные (без учета организаций в ведении ФСИН)	         отчислено из-за просрочки оплаты обучения / 15.0	0	0	0	0	0	0	0	0	0	0	0	0	0	3	3	0	0	0	0	0
Чеченская Республика	Очно-заочная; Государственные, муниципальные (без учета организаций в ведении ФСИН)	"    в том числе:
    переведено на другие формы обучения данной
    организации на программы того же уровня / 7.0"	0	0	0	0	0	0	0	0	0	0	2	0	0	2	4	0	0	0	0	0
Чеченская Республика	Очно-заочная; Государственные, муниципальные (без учета организаций в ведении ФСИН)	"    в том числе:
    переведено с других форм обучения данной
    образовательной организации с программ того же уровня / 2.0"	0	0	0	0	0	0	0	0	0	0	2	0	0	3	5	0	0	0	0	0
Чеченская Республика	Очно-заочная; Государственные, муниципальные (без учета организаций в ведении ФСИН)	    восстановлены из числа ранее отчисленных / 4.0	0	0	0	0	0	0	0	0	0	0	1	0	0	3	4	0	0	0	4	4
Чеченская Республика	Очно-заочная; Государственные, муниципальные (без учета организаций в ведении ФСИН)	    выбыло по другим причинам / 16.0	0	0	0	4	4	0	0	0	0	0	0	0	0	1	1	0	0	0	1	1
Чеченская Республика	Очно-заочная; Государственные, муниципальные (без учета организаций в ведении ФСИН)	"    добровольно прекратили образовательные отношения
    (бросили учебу) / 10.0"	0	0	0	0	0	0	0	0	0	0	28	0	0	1	29	0	0	0	5	5
Чеченская Республика	Очно-заочная; Государственные, муниципальные (без учета организаций в ведении ФСИН)	"    отчислено:
         по неуспеваемости / 11.0"	0	0	0	0	0	0	0	0	11	11	6	0	0	15	21	0	0	0	3	3
Чеченская Республика	Очно-заочная; Государственные, муниципальные (без учета организаций в ведении ФСИН)	"    переведено в другие образовательные организации
    на программы того же уровня / 8.0"	0	0	0	0	0	0	0	0	0	0	0	0	0	2	2	0	0	1	1	2
Чеченская Республика	Очно-заочная; Государственные, муниципальные (без учета организаций в ведении ФСИН)	"    переведено из других образовательных организаций 
    с программ того же уровня / 3.0"	0	0	0	0	0	0	0	0	0	0	0	0	0	0	0	0	0	0	4	4
Чеченская Республика	Очно-заочная; Государственные, муниципальные (без учета организаций в ведении ФСИН)	    по болезни / 9.0	0	0	0	0	0	0	0	0	0	0	0	0	0	0	0	0	0	0	0	0
Чеченская Республика	Очно-заочная; Государственные, муниципальные (без учета организаций в ведении ФСИН)	    прибыло по другим причинам / 5.0	0	0	0	0	0	0	0	0	0	0	0	0	0	7	7	0	0	0	0	0
Чеченская Республика	Очно-заочная; Государственные, муниципальные (без учета организаций в ведении ФСИН)	Выбыло студентов - всего (сумма стр. 07-11, 13-15) / 6.0	0	0	0	4	4	0	0	0	11	11	36	0	0	24	60	0	0	1	10	11
Чеченская Республика	Очно-заочная; Государственные, муниципальные (без учета организаций в ведении ФСИН)	Прибыло студентов - всего (сумма стр. 02-05) / 1.0	0	0	0	0	0	0	0	0	0	0	3	0	0	13	16	0	0	0	8	8
Чеченская Республика	Очно-заочная; Государственные, муниципальные (без учета организаций в ведении ФСИН)	"Численность студентов на начало прошлого учебного года
(на 1 октября) / 17.0"	0	0	0	53	53	0	0	0	139	139	285	0	15	440	740	0	0	0	163	163
Чеченская Республика	Частные; Заочная	            из стр. 11 - не прошли итоговую аттестацию / 12.0	0	0	0	0	0	0	0	0	0	0	0	0	0	0	0	0	0	0	0	0
Чеченская Республика	Частные; Заочная	"            из стр. 11 – лица с ограниченными возможностями здоровья,
            инвалиды, дети-инвалиды / 13.0"	0	0	0	0	0	0	0	0	0	0	0	0	0	0	0	0	0	0	0	0
Чеченская Республика	Частные; Заочная	         отчислено в виде меры дисциплинарного взыскания / 14.0	0	0	0	0	0	0	0	0	0	0	0	0	0	0	0	0	0	0	0	0
Чеченская Республика	Частные; Заочная	         отчислено из-за просрочки оплаты обучения / 15.0	0	0	0	0	0	0	0	0	0	0	0	0	0	0	0	0	0	0	3	3
Чеченская Республика	Частные; Заочная	"    в том числе:
    переведено на другие формы обучения данной
    организации на программы того же уровня / 7.0"	0	0	0	0	0	0	0	0	0	0	0	0	0	2	2	0	0	0	0	0
Чеченская Республика	Частные; Заочная	"    в том числе:
    переведено с других форм обучения данной
    образовательной организации с программ того же уровня / 2.0"	0	0	0	0	0	0	0	0	0	0	0	0	0	1	1	0	0	0	1	1
Чеченская Республика	Частные; Заочная	    восстановлены из числа ранее отчисленных / 4.0	0	0	0	0	0	0	0	0	0	0	0	0	0	0	0	0	0	0	0	0
Чеченская Республика	Частные; Заочная	    выбыло по другим причинам / 16.0	0	0	0	0	0	0	0	0	0	0	0	0	0	3	3	0	0	0	3	3
Чеченская Республика	Частные; Заочная	"    добровольно прекратили образовательные отношения
    (бросили учебу) / 10.0"	0	0	0	0	0	0	0	0	0	0	0	0	0	3	3	0	0	0	0	0
Чеченская Республика	Частные; Заочная	"    отчислено:
         по неуспеваемости / 11.0"	0	0	0	0	0	0	0	0	0	0	0	0	0	5	5	0	0	0	0	0
Чеченская Республика	Частные; Заочная	"    переведено в другие образовательные организации
    на программы того же уровня / 8.0"	0	0	0	0	0	0	0	0	0	0	0	0	0	1	1	0	0	0	0	0
Чеченская Республика	Частные; Заочная	"    переведено из других образовательных организаций 
    с программ того же уровня / 3.0"	0	0	0	0	0	0	0	0	0	0	0	0	0	58	58	0	0	0	0	0
Чеченская Республика	Частные; Заочная	    по болезни / 9.0	0	0	0	0	0	0	0	0	0	0	0	0	0	0	0	0	0	0	0	0
Чеченская Республика	Частные; Заочная	    прибыло по другим причинам / 5.0	0	0	0	0	0	0	0	0	0	0	0	0	0	3	3	0	0	0	0	0
Чеченская Республика	Частные; Заочная	Выбыло студентов - всего (сумма стр. 07-11, 13-15) / 6.0	0	0	0	0	0	0	0	0	0	0	0	0	0	14	14	0	0	0	6	6
Чеченская Республика	Частные; Заочная	Прибыло студентов - всего (сумма стр. 02-05) / 1.0	0	0	0	0	0	0	0	0	0	0	0	0	0	62	62	0	0	0	1	1
Чеченская Республика	Частные; Заочная	"Численность студентов на начало прошлого учебного года
(на 1 октября) / 17.0"	0	0	0	0	0	0	0	0	0	0	0	0	0	291	291	0	0	0	28	28
Чеченская Республика	Частные; Очная	            из стр. 11 - не прошли итоговую аттестацию / 12.0	0	0	0	0	0	0	0	0	0	0	0	0	0	2	2	0	0	0	1	1
Чеченская Республика	Частные; Очная	"            из стр. 11 – лица с ограниченными возможностями здоровья,
            инвалиды, дети-инвалиды / 13.0"	0	0	0	0	0	0	0	0	0	0	0	0	0	0	0	0	0	0	0	0
Чеченская Республика	Частные; Очная	         отчислено в виде меры дисциплинарного взыскания / 14.0	0	0	0	2	2	0	0	0	0	0	0	0	0	1	1	0	0	0	0	0
Чеченская Республика	Частные; Очная	         отчислено из-за просрочки оплаты обучения / 15.0	0	0	0	2	2	0	0	0	5	5	0	0	0	38	38	0	0	0	2	2
Чеченская Республика	Частные; Очная	"    в том числе:
    переведено на другие формы обучения данной
    организации на программы того же уровня / 7.0"	0	0	0	0	0	0	0	0	0	0	0	0	0	39	39	0	0	0	1	1
Чеченская Республика	Частные; Очная	"    в том числе:
    переведено с других форм обучения данной
    образовательной организации с программ того же уровня / 2.0"	0	0	0	0	0	0	0	0	0	0	0	0	0	5	5	0	0	0	7	7
Чеченская Республика	Частные; Очная	    восстановлены из числа ранее отчисленных / 4.0	0	0	0	1	1	0	0	0	0	0	0	0	0	9	9	0	0	0	1	1
Чеченская Республика	Частные; Очная	    выбыло по другим причинам / 16.0	0	0	0	0	0	0	0	0	0	0	0	0	0	0	0	0	0	0	0	0
Чеченская Республика	Частные; Очная	"    добровольно прекратили образовательные отношения
    (бросили учебу) / 10.0"	0	0	0	13	13	0	0	0	4	4	0	0	0	121	121	0	0	0	10	10
Чеченская Республика	Частные; Очная	"    отчислено:
         по неуспеваемости / 11.0"	0	0	0	0	0	0	0	0	0	0	0	0	0	14	14	0	0	0	1	1
Чеченская Республика	Частные; Очная	"    переведено в другие образовательные организации
    на программы того же уровня / 8.0"	0	0	0	12	12	0	0	0	0	0	0	0	0	67	67	0	0	0	3	3
Чеченская Республика	Частные; Очная	"    переведено из других образовательных организаций 
    с программ того же уровня / 3.0"	0	0	0	14	14	0	0	0	1	1	0	0	0	65	65	0	0	0	31	31
Чеченская Республика	Частные; Очная	    по болезни / 9.0	0	0	0	3	3	0	0	0	0	0	0	0	0	0	0	0	0	0	0	0
Чеченская Республика	Частные; Очная	    прибыло по другим причинам / 5.0	0	0	0	1	1	0	0	0	0	0	0	0	0	2	2	0	0	0	10	10
Чеченская Республика	Частные; Очная	Выбыло студентов - всего (сумма стр. 07-11, 13-15) / 6.0	0	0	0	32	32	0	0	0	9	9	0	0	0	280	280	0	0	0	17	17
Чеченская Республика	Частные; Очная	Прибыло студентов - всего (сумма стр. 02-05) / 1.0	0	0	0	16	16	0	0	0	1	1	0	0	0	81	81	0	0	0	49	49
Чеченская Республика	Частные; Очная	"Численность студентов на начало прошлого учебного года
(на 1 октября) / 17.0"	0	0	0	586	586	0	0	0	171	171	0	0	0	3465	3465	0	0	0	249	249
Чеченская Республика	Частные; Очно-заочная	            из стр. 11 - не прошли итоговую аттестацию / 12.0	0	0	0	0	0	0	0	0	0	0	0	0	0	0	0	0	0	0	0	0
Чеченская Республика	Частные; Очно-заочная	"            из стр. 11 – лица с ограниченными возможностями здоровья,
            инвалиды, дети-инвалиды / 13.0"	0	0	0	0	0	0	0	0	0	0	0	0	0	0	0	0	0	0	0	0
Чеченская Республика	Частные; Очно-заочная	         отчислено в виде меры дисциплинарного взыскания / 14.0	0	0	0	0	0	0	0	0	0	0	0	0	0	0	0	0	0	0	0	0
Чеченская Республика	Частные; Очно-заочная	         отчислено из-за просрочки оплаты обучения / 15.0	0	0	0	0	0	0	0	0	0	0	0	0	0	0	0	0	0	0	3	3
Чеченская Республика	Частные; Очно-заочная	"    в том числе:
    переведено на другие формы обучения данной
    организации на программы того же уровня / 7.0"	0	0	0	0	0	0	0	0	0	0	0	0	0	0	0	0	0	0	0	0
Чеченская Республика	Частные; Очно-заочная	"    в том числе:
    переведено с других форм обучения данной
    образовательной организации с программ того же уровня / 2.0"	0	0	0	0	0	0	0	0	0	0	0	0	0	24	24	0	0	0	0	0
Чеченская Республика	Частные; Очно-заочная	    восстановлены из числа ранее отчисленных / 4.0	0	0	0	0	0	0	0	0	0	0	0	0	0	0	0	0	0	0	0	0
Чеченская Республика	Частные; Очно-заочная	    выбыло по другим причинам / 16.0	0	0	0	0	0	0	0	0	0	0	0	0	0	8	8	0	0	0	8	8
Чеченская Республика	Частные; Очно-заочная	"    добровольно прекратили образовательные отношения
    (бросили учебу) / 10.0"	0	0	0	0	0	0	0	0	0	0	0	0	0	0	0	0	0	0	0	0
Чеченская Республика	Частные; Очно-заочная	"    отчислено:
         по неуспеваемости / 11.0"	0	0	0	0	0	0	0	0	0	0	0	0	0	0	0	0	0	0	0	0
Чеченская Республика	Частные; Очно-заочная	"    переведено в другие образовательные организации
    на программы того же уровня / 8.0"	0	0	0	0	0	0	0	0	0	0	0	0	0	6	6	0	0	0	1	1
Чеченская Республика	Частные; Очно-заочная	"    переведено из других образовательных организаций 
    с программ того же уровня / 3.0"	0	0	0	0	0	0	0	0	0	0	0	0	0	5	5	0	0	0	8	8
Чеченская Республика	Частные; Очно-заочная	    по болезни / 9.0	0	0	0	0	0	0	0	0	0	0	0	0	0	0	0	0	0	0	0	0
Чеченская Республика	Частные; Очно-заочная	    прибыло по другим причинам / 5.0	0	0	0	0	0	0	0	0	0	0	0	0	0	5	5	0	0	0	0	0
Чеченская Республика	Частные; Очно-заочная	Выбыло студентов - всего (сумма стр. 07-11, 13-15) / 6.0	0	0	0	0	0	0	0	0	0	0	0	0	0	14	14	0	0	0	12	12
Чеченская Республика	Частные; Очно-заочная	Прибыло студентов - всего (сумма стр. 02-05) / 1.0	0	0	0	0	0	0	0	0	0	0	0	0	0	34	34	0	0	0	8	8
Чеченская Республика	Частные; Очно-заочная	"Численность студентов на начало прошлого учебного года
(на 1 октября) / 17.0"	0	0	0	0	0	0	0	0	0	0	0	0	0	15	15	0	0	0	339	339
Чувашская Республика	Государственные, муниципальные (без учета организаций в ведении ФСИН); Заочная	            из стр. 11 - не прошли итоговую аттестацию / 12.0	0	0	0	0	0	0	0	0	0	0	0	0	0	0	0	4	0	0	0	4
Чувашская Республика	Государственные, муниципальные (без учета организаций в ведении ФСИН); Заочная	"            из стр. 11 – лица с ограниченными возможностями здоровья,
            инвалиды, дети-инвалиды / 13.0"	0	0	0	0	0	0	0	0	0	0	0	0	0	0	0	0	0	0	0	0
Чувашская Республика	Государственные, муниципальные (без учета организаций в ведении ФСИН); Заочная	         отчислено в виде меры дисциплинарного взыскания / 14.0	0	0	0	0	0	0	0	0	0	0	0	0	0	0	0	0	0	0	0	0
Чувашская Республика	Государственные, муниципальные (без учета организаций в ведении ФСИН); Заочная	         отчислено из-за просрочки оплаты обучения / 15.0	0	0	0	0	0	0	0	0	0	0	0	0	0	0	0	0	0	0	4	4
Чувашская Республика	Государственные, муниципальные (без учета организаций в ведении ФСИН); Заочная	"    в том числе:
    переведено на другие формы обучения данной
    организации на программы того же уровня / 7.0"	0	0	0	0	0	0	0	0	0	0	0	0	0	0	0	1	0	0	6	7
Чувашская Республика	Государственные, муниципальные (без учета организаций в ведении ФСИН); Заочная	"    в том числе:
    переведено с других форм обучения данной
    образовательной организации с программ того же уровня / 2.0"	0	0	0	0	0	0	0	0	0	0	0	0	0	0	0	10	0	0	29	39
Чувашская Республика	Государственные, муниципальные (без учета организаций в ведении ФСИН); Заочная	    восстановлены из числа ранее отчисленных / 4.0	0	0	0	0	0	0	0	0	0	0	0	0	0	1	1	20	0	0	32	52
Чувашская Республика	Государственные, муниципальные (без учета организаций в ведении ФСИН); Заочная	    выбыло по другим причинам / 16.0	0	0	0	0	0	0	0	0	0	0	0	0	0	1	1	3	0	1	5	9
Чувашская Республика	Государственные, муниципальные (без учета организаций в ведении ФСИН); Заочная	"    добровольно прекратили образовательные отношения
    (бросили учебу) / 10.0"	0	0	0	0	0	0	0	0	0	0	4	0	0	12	16	73	0	7	39	119
Чувашская Республика	Государственные, муниципальные (без учета организаций в ведении ФСИН); Заочная	"    отчислено:
         по неуспеваемости / 11.0"	0	0	0	0	0	0	0	0	0	0	0	0	0	10	10	59	0	0	3	62
Чувашская Республика	Государственные, муниципальные (без учета организаций в ведении ФСИН); Заочная	"    переведено в другие образовательные организации
    на программы того же уровня / 8.0"	0	0	0	0	0	0	0	0	0	0	0	0	0	1	1	1	0	0	0	1
Чувашская Республика	Государственные, муниципальные (без учета организаций в ведении ФСИН); Заочная	"    переведено из других образовательных организаций 
    с программ того же уровня / 3.0"	0	0	0	0	0	0	0	0	0	0	0	0	0	1	1	1	0	0	4	5
Чувашская Республика	Государственные, муниципальные (без учета организаций в ведении ФСИН); Заочная	    по болезни / 9.0	0	0	0	0	0	0	0	0	0	0	0	0	0	0	0	0	0	0	0	0
Чувашская Республика	Государственные, муниципальные (без учета организаций в ведении ФСИН); Заочная	    прибыло по другим причинам / 5.0	0	0	0	0	0	0	0	0	0	0	0	0	0	0	0	5	0	1	1	7
Чувашская Республика	Государственные, муниципальные (без учета организаций в ведении ФСИН); Заочная	Выбыло студентов - всего (сумма стр. 07-11, 13-15) / 6.0	0	0	0	0	0	0	0	0	0	0	4	0	0	24	28	137	0	8	57	202
Чувашская Республика	Государственные, муниципальные (без учета организаций в ведении ФСИН); Заочная	Прибыло студентов - всего (сумма стр. 02-05) / 1.0	0	0	0	0	0	0	0	0	0	0	0	0	0	2	2	36	0	1	66	103
Чувашская Республика	Государственные, муниципальные (без учета организаций в ведении ФСИН); Заочная	"Численность студентов на начало прошлого учебного года
(на 1 октября) / 17.0"	0	0	0	0	0	0	0	0	0	0	145	0	0	146	291	1544	0	173	238	1955
Чувашская Республика	Государственные, муниципальные (без учета организаций в ведении ФСИН); Очная	            из стр. 11 - не прошли итоговую аттестацию / 12.0	14	0	0	0	14	0	0	0	0	0	10	0	0	0	10	0	0	0	0	0
Чувашская Республика	Государственные, муниципальные (без учета организаций в ведении ФСИН); Очная	"            из стр. 11 – лица с ограниченными возможностями здоровья,
            инвалиды, дети-инвалиды / 13.0"	3	0	0	1	4	0	0	0	0	0	0	0	1	0	1	0	0	0	0	0
Чувашская Республика	Государственные, муниципальные (без учета организаций в ведении ФСИН); Очная	         отчислено в виде меры дисциплинарного взыскания / 14.0	5	0	0	0	5	5	0	0	0	5	11	0	4	1	16	0	0	0	0	0
Чувашская Республика	Государственные, муниципальные (без учета организаций в ведении ФСИН); Очная	         отчислено из-за просрочки оплаты обучения / 15.0	0	0	0	0	0	0	0	0	2	2	0	0	0	29	29	0	0	0	4	4
Чувашская Республика	Государственные, муниципальные (без учета организаций в ведении ФСИН); Очная	"    в том числе:
    переведено на другие формы обучения данной
    организации на программы того же уровня / 7.0"	8	0	0	1	9	0	0	0	0	0	41	0	1	36	78	4	0	0	3	7
Чувашская Республика	Государственные, муниципальные (без учета организаций в ведении ФСИН); Очная	"    в том числе:
    переведено с других форм обучения данной
    образовательной организации с программ того же уровня / 2.0"	16	0	0	0	16	0	0	0	0	0	36	0	0	11	47	1	0	0	5	6
Чувашская Республика	Государственные, муниципальные (без учета организаций в ведении ФСИН); Очная	    восстановлены из числа ранее отчисленных / 4.0	24	0	0	0	24	0	0	0	0	0	44	0	0	30	74	6	0	0	9	15
Чувашская Республика	Государственные, муниципальные (без учета организаций в ведении ФСИН); Очная	    выбыло по другим причинам / 16.0	37	0	0	6	43	1	0	0	4	5	115	0	1	30	146	7	0	0	4	11
Чувашская Республика	Государственные, муниципальные (без учета организаций в ведении ФСИН); Очная	"    добровольно прекратили образовательные отношения
    (бросили учебу) / 10.0"	229	0	0	6	235	25	0	0	0	25	515	0	23	250	788	44	0	3	36	83
Чувашская Республика	Государственные, муниципальные (без учета организаций в ведении ФСИН); Очная	"    отчислено:
         по неуспеваемости / 11.0"	71	0	0	5	76	16	0	0	6	22	156	0	2	56	214	9	0	0	3	12
Чувашская Республика	Государственные, муниципальные (без учета организаций в ведении ФСИН); Очная	"    переведено в другие образовательные организации
    на программы того же уровня / 8.0"	21	0	0	0	21	0	0	0	0	0	125	0	10	36	171	2	0	0	16	18
Чувашская Республика	Государственные, муниципальные (без учета организаций в ведении ФСИН); Очная	"    переведено из других образовательных организаций 
    с программ того же уровня / 3.0"	36	0	0	2	38	0	0	0	0	0	75	0	7	35	117	0	0	0	0	0
Чувашская Республика	Государственные, муниципальные (без учета организаций в ведении ФСИН); Очная	    по болезни / 9.0	41	0	0	0	41	0	0	0	0	0	1	0	0	0	1	0	0	0	0	0
Чувашская Республика	Государственные, муниципальные (без учета организаций в ведении ФСИН); Очная	    прибыло по другим причинам / 5.0	18	0	0	16	34	3	0	0	1	4	74	0	1	69	144	4	0	1	1	6
Чувашская Республика	Государственные, муниципальные (без учета организаций в ведении ФСИН); Очная	Выбыло студентов - всего (сумма стр. 07-11, 13-15) / 6.0	412	0	0	18	430	47	0	0	12	59	964	0	41	438	1443	66	0	3	66	135
Чувашская Республика	Государственные, муниципальные (без учета организаций в ведении ФСИН); Очная	Прибыло студентов - всего (сумма стр. 02-05) / 1.0	94	0	0	18	112	3	0	0	1	4	229	0	8	145	382	11	0	1	15	27
Чувашская Республика	Государственные, муниципальные (без учета организаций в ведении ФСИН); Очная	"Численность студентов на начало прошлого учебного года
(на 1 октября) / 17.0"	4087	0	0	66	4153	594	0	0	72	666	13434	0	770	4540	18744	740	0	44	510	1294
Чувашская Республика	Очно-заочная; Государственные, муниципальные (без учета организаций в ведении ФСИН)	            из стр. 11 - не прошли итоговую аттестацию / 12.0	0	0	0	0	0	0	0	0	0	0	0	0	0	0	0	0	0	0	0	0
Чувашская Республика	Очно-заочная; Государственные, муниципальные (без учета организаций в ведении ФСИН)	"            из стр. 11 – лица с ограниченными возможностями здоровья,
            инвалиды, дети-инвалиды / 13.0"	0	0	0	0	0	0	0	0	0	0	0	0	0	0	0	0	0	0	0	0
Чувашская Республика	Очно-заочная; Государственные, муниципальные (без учета организаций в ведении ФСИН)	         отчислено в виде меры дисциплинарного взыскания / 14.0	0	0	0	0	0	0	0	0	0	0	0	0	0	0	0	0	0	0	0	0
Чувашская Республика	Очно-заочная; Государственные, муниципальные (без учета организаций в ведении ФСИН)	         отчислено из-за просрочки оплаты обучения / 15.0	0	0	0	0	0	0	0	0	0	0	0	0	0	0	0	0	0	0	0	0
Чувашская Республика	Очно-заочная; Государственные, муниципальные (без учета организаций в ведении ФСИН)	"    в том числе:
    переведено на другие формы обучения данной
    организации на программы того же уровня / 7.0"	0	0	0	0	0	0	0	0	0	0	0	0	0	0	0	0	0	0	0	0
Чувашская Республика	Очно-заочная; Государственные, муниципальные (без учета организаций в ведении ФСИН)	"    в том числе:
    переведено с других форм обучения данной
    образовательной организации с программ того же уровня / 2.0"	0	0	0	0	0	0	0	0	0	0	0	0	0	1	1	0	0	0	0	0
Чувашская Республика	Очно-заочная; Государственные, муниципальные (без учета организаций в ведении ФСИН)	    восстановлены из числа ранее отчисленных / 4.0	0	0	0	0	0	0	0	0	0	0	0	0	0	1	1	0	0	0	2	2
Чувашская Республика	Очно-заочная; Государственные, муниципальные (без учета организаций в ведении ФСИН)	    выбыло по другим причинам / 16.0	0	0	0	0	0	0	0	0	0	0	0	0	0	0	0	0	0	0	0	0
Чувашская Республика	Очно-заочная; Государственные, муниципальные (без учета организаций в ведении ФСИН)	"    добровольно прекратили образовательные отношения
    (бросили учебу) / 10.0"	0	0	0	0	0	0	0	0	0	0	0	0	0	2	2	0	0	0	29	29
Чувашская Республика	Очно-заочная; Государственные, муниципальные (без учета организаций в ведении ФСИН)	"    отчислено:
         по неуспеваемости / 11.0"	0	0	0	0	0	0	0	0	0	0	0	0	0	0	0	0	0	0	2	2
Чувашская Республика	Очно-заочная; Государственные, муниципальные (без учета организаций в ведении ФСИН)	"    переведено в другие образовательные организации
    на программы того же уровня / 8.0"	0	0	0	0	0	0	0	0	0	0	0	0	0	0	0	0	0	0	0	0
Чувашская Республика	Очно-заочная; Государственные, муниципальные (без учета организаций в ведении ФСИН)	"    переведено из других образовательных организаций 
    с программ того же уровня / 3.0"	0	0	0	0	0	0	0	0	0	0	0	0	0	0	0	0	0	0	0	0
Чувашская Республика	Очно-заочная; Государственные, муниципальные (без учета организаций в ведении ФСИН)	    по болезни / 9.0	0	0	0	0	0	0	0	0	0	0	0	0	0	0	0	0	0	0	0	0
Чувашская Республика	Очно-заочная; Государственные, муниципальные (без учета организаций в ведении ФСИН)	    прибыло по другим причинам / 5.0	0	0	0	0	0	0	0	0	0	0	0	0	0	0	0	0	0	0	0	0
Чувашская Республика	Очно-заочная; Государственные, муниципальные (без учета организаций в ведении ФСИН)	Выбыло студентов - всего (сумма стр. 07-11, 13-15) / 6.0	0	0	0	0	0	0	0	0	0	0	0	0	0	2	2	0	0	0	31	31
Чувашская Республика	Очно-заочная; Государственные, муниципальные (без учета организаций в ведении ФСИН)	Прибыло студентов - всего (сумма стр. 02-05) / 1.0	0	0	0	0	0	0	0	0	0	0	0	0	0	2	2	0	0	0	2	2
Чувашская Республика	Очно-заочная; Государственные, муниципальные (без учета организаций в ведении ФСИН)	"Численность студентов на начало прошлого учебного года
(на 1 октября) / 17.0"	0	0	0	0	0	0	0	0	0	0	0	0	0	0	0	1	0	0	334	335
Чувашская Республика	Частные; Заочная	            из стр. 11 - не прошли итоговую аттестацию / 12.0	0	0	0	0	0	0	0	0	0	0	0	0	0	0	0	0	0	0	0	0
Чувашская Республика	Частные; Заочная	"            из стр. 11 – лица с ограниченными возможностями здоровья,
            инвалиды, дети-инвалиды / 13.0"	0	0	0	0	0	0	0	0	0	0	0	0	0	0	0	0	0	0	0	0
Чувашская Республика	Частные; Заочная	         отчислено в виде меры дисциплинарного взыскания / 14.0	0	0	0	0	0	0	0	0	0	0	0	0	0	0	0	0	0	0	0	0
Чувашская Республика	Частные; Заочная	         отчислено из-за просрочки оплаты обучения / 15.0	0	0	0	0	0	0	0	0	0	0	0	0	0	4	4	0	0	0	4	4
Чувашская Республика	Частные; Заочная	"    в том числе:
    переведено на другие формы обучения данной
    организации на программы того же уровня / 7.0"	0	0	0	0	0	0	0	0	0	0	0	0	0	1	1	0	0	0	1	1
Чувашская Республика	Частные; Заочная	"    в том числе:
    переведено с других форм обучения данной
    образовательной организации с программ того же уровня / 2.0"	0	0	0	0	0	0	0	0	0	0	0	0	0	13	13	0	0	0	1	1
Чувашская Республика	Частные; Заочная	    восстановлены из числа ранее отчисленных / 4.0	0	0	0	0	0	0	0	0	0	0	0	0	0	3	3	0	0	0	1	1
Чувашская Республика	Частные; Заочная	    выбыло по другим причинам / 16.0	0	0	0	0	0	0	0	0	0	0	0	0	0	31	31	0	0	0	5	5
Чувашская Республика	Частные; Заочная	"    добровольно прекратили образовательные отношения
    (бросили учебу) / 10.0"	0	0	0	0	0	0	0	0	0	0	0	0	0	18	18	0	0	0	7	7
Чувашская Республика	Частные; Заочная	"    отчислено:
         по неуспеваемости / 11.0"	0	0	0	0	0	0	0	0	0	0	0	0	0	16	16	0	0	0	2	2
Чувашская Республика	Частные; Заочная	"    переведено в другие образовательные организации
    на программы того же уровня / 8.0"	0	0	0	0	0	0	0	0	0	0	0	0	0	0	0	0	0	0	0	0
Чувашская Республика	Частные; Заочная	"    переведено из других образовательных организаций 
    с программ того же уровня / 3.0"	0	0	0	0	0	0	0	0	0	0	0	0	0	0	0	0	0	0	0	0
Чувашская Республика	Частные; Заочная	    по болезни / 9.0	0	0	0	0	0	0	0	0	0	0	0	0	0	0	0	0	0	0	0	0
Чувашская Республика	Частные; Заочная	    прибыло по другим причинам / 5.0	0	0	0	0	0	0	0	0	0	0	0	0	0	0	0	0	0	0	0	0
Чувашская Республика	Частные; Заочная	Выбыло студентов - всего (сумма стр. 07-11, 13-15) / 6.0	0	0	0	0	0	0	0	0	0	0	0	0	0	70	70	0	0	0	19	19
Чувашская Республика	Частные; Заочная	Прибыло студентов - всего (сумма стр. 02-05) / 1.0	0	0	0	0	0	0	0	0	0	0	0	0	0	16	16	0	0	0	2	2
Чувашская Республика	Частные; Заочная	"Численность студентов на начало прошлого учебного года
(на 1 октября) / 17.0"	0	0	0	0	0	0	0	0	0	0	0	0	0	220	220	0	0	0	122	122
Чувашская Республика	Частные; Очная	            из стр. 11 - не прошли итоговую аттестацию / 12.0	0	0	0	0	0	0	0	0	0	0	0	0	0	1	1	0	0	0	0	0
Чувашская Республика	Частные; Очная	"            из стр. 11 – лица с ограниченными возможностями здоровья,
            инвалиды, дети-инвалиды / 13.0"	0	0	0	0	0	0	0	0	0	0	0	0	0	0	0	0	0	0	0	0
Чувашская Республика	Частные; Очная	         отчислено в виде меры дисциплинарного взыскания / 14.0	0	0	0	0	0	0	0	0	0	0	0	0	0	0	0	0	0	0	0	0
Чувашская Республика	Частные; Очная	         отчислено из-за просрочки оплаты обучения / 15.0	0	0	0	0	0	0	0	0	0	0	0	0	0	33	33	0	0	0	8	8
Чувашская Республика	Частные; Очная	"    в том числе:
    переведено на другие формы обучения данной
    организации на программы того же уровня / 7.0"	0	0	0	0	0	0	0	0	0	0	0	0	0	12	12	0	0	0	1	1
Чувашская Республика	Частные; Очная	"    в том числе:
    переведено с других форм обучения данной
    образовательной организации с программ того же уровня / 2.0"	0	0	0	0	0	0	0	0	0	0	1	0	0	11	12	0	0	0	1	1
Чувашская Республика	Частные; Очная	    восстановлены из числа ранее отчисленных / 4.0	0	0	0	0	0	0	0	0	0	0	0	0	0	25	25	0	0	0	4	4
Чувашская Республика	Частные; Очная	    выбыло по другим причинам / 16.0	0	0	0	0	0	0	0	0	0	0	0	0	0	2	2	0	0	0	3	3
Чувашская Республика	Частные; Очная	"    добровольно прекратили образовательные отношения
    (бросили учебу) / 10.0"	4	0	0	0	4	0	0	0	0	0	21	0	0	155	176	0	0	0	40	40
Чувашская Республика	Частные; Очная	"    отчислено:
         по неуспеваемости / 11.0"	0	0	0	0	0	0	0	0	0	0	0	0	0	14	14	0	0	0	8	8
Чувашская Республика	Частные; Очная	"    переведено в другие образовательные организации
    на программы того же уровня / 8.0"	0	0	0	0	0	0	0	0	0	0	4	0	0	31	35	0	0	0	0	0
Чувашская Республика	Частные; Очная	"    переведено из других образовательных организаций 
    с программ того же уровня / 3.0"	0	0	0	0	0	0	0	0	0	0	4	0	0	15	19	0	0	0	2	2
Чувашская Республика	Частные; Очная	    по болезни / 9.0	0	0	0	0	0	0	0	0	0	0	0	0	0	0	0	0	0	0	0	0
Чувашская Республика	Частные; Очная	    прибыло по другим причинам / 5.0	0	0	0	0	0	0	0	0	0	0	0	0	0	0	0	0	0	0	0	0
Чувашская Республика	Частные; Очная	Выбыло студентов - всего (сумма стр. 07-11, 13-15) / 6.0	4	0	0	0	4	0	0	0	0	0	25	0	0	247	272	0	0	0	60	60
Чувашская Республика	Частные; Очная	Прибыло студентов - всего (сумма стр. 02-05) / 1.0	0	0	0	0	0	0	0	0	0	0	5	0	0	51	56	0	0	0	7	7
Чувашская Республика	Частные; Очная	"Численность студентов на начало прошлого учебного года
(на 1 октября) / 17.0"	0	0	0	0	0	0	0	0	0	0	396	75	0	2670	3141	0	0	0	407	407
Чукотский автономный округ	Государственные, муниципальные (без учета организаций в ведении ФСИН); Заочная	            из стр. 11 - не прошли итоговую аттестацию / 12.0	0	0	0	0	0	0	0	0	0	0	0	0	0	0	0	0	0	0	0	0
Чукотский автономный округ	Государственные, муниципальные (без учета организаций в ведении ФСИН); Заочная	"            из стр. 11 – лица с ограниченными возможностями здоровья,
            инвалиды, дети-инвалиды / 13.0"	0	0	0	0	0	0	0	0	0	0	0	0	0	0	0	0	0	0	0	0
Чукотский автономный округ	Государственные, муниципальные (без учета организаций в ведении ФСИН); Заочная	         отчислено в виде меры дисциплинарного взыскания / 14.0	0	0	0	0	0	0	0	0	0	0	0	0	0	0	0	0	0	0	0	0
Чукотский автономный округ	Государственные, муниципальные (без учета организаций в ведении ФСИН); Заочная	         отчислено из-за просрочки оплаты обучения / 15.0	0	0	0	0	0	0	0	0	0	0	0	0	0	9	9	0	0	0	0	0
Чукотский автономный округ	Государственные, муниципальные (без учета организаций в ведении ФСИН); Заочная	"    в том числе:
    переведено на другие формы обучения данной
    организации на программы того же уровня / 7.0"	0	0	0	0	0	0	0	0	0	0	0	0	0	0	0	0	0	0	0	0
Чукотский автономный округ	Государственные, муниципальные (без учета организаций в ведении ФСИН); Заочная	"    в том числе:
    переведено с других форм обучения данной
    образовательной организации с программ того же уровня / 2.0"	0	0	0	0	0	0	0	0	0	0	0	0	0	0	0	2	0	0	0	2
Чукотский автономный округ	Государственные, муниципальные (без учета организаций в ведении ФСИН); Заочная	    восстановлены из числа ранее отчисленных / 4.0	0	0	0	0	0	0	0	0	0	0	0	0	0	0	0	0	0	0	0	0
Чукотский автономный округ	Государственные, муниципальные (без учета организаций в ведении ФСИН); Заочная	    выбыло по другим причинам / 16.0	0	0	0	0	0	0	0	0	0	0	0	0	0	0	0	9	0	0	0	9
Чукотский автономный округ	Государственные, муниципальные (без учета организаций в ведении ФСИН); Заочная	"    добровольно прекратили образовательные отношения
    (бросили учебу) / 10.0"	0	0	0	0	0	0	0	0	0	0	0	0	0	0	0	8	0	0	0	8
Чукотский автономный округ	Государственные, муниципальные (без учета организаций в ведении ФСИН); Заочная	"    отчислено:
         по неуспеваемости / 11.0"	0	0	0	0	0	0	0	0	0	0	0	0	0	0	0	15	0	0	2	17
Чукотский автономный округ	Государственные, муниципальные (без учета организаций в ведении ФСИН); Заочная	"    переведено в другие образовательные организации
    на программы того же уровня / 8.0"	0	0	0	0	0	0	0	0	0	0	0	0	0	0	0	0	0	0	0	0
Чукотский автономный округ	Государственные, муниципальные (без учета организаций в ведении ФСИН); Заочная	"    переведено из других образовательных организаций 
    с программ того же уровня / 3.0"	0	0	0	0	0	0	0	0	0	0	0	0	0	0	0	0	0	0	0	0
Чукотский автономный округ	Государственные, муниципальные (без учета организаций в ведении ФСИН); Заочная	    по болезни / 9.0	0	0	0	0	0	0	0	0	0	0	0	0	0	0	0	0	0	0	0	0
Чукотский автономный округ	Государственные, муниципальные (без учета организаций в ведении ФСИН); Заочная	    прибыло по другим причинам / 5.0	0	0	0	0	0	0	0	0	0	0	0	0	0	0	0	4	0	0	0	4
Чукотский автономный округ	Государственные, муниципальные (без учета организаций в ведении ФСИН); Заочная	Выбыло студентов - всего (сумма стр. 07-11, 13-15) / 6.0	0	0	0	0	0	0	0	0	0	0	0	0	0	9	9	32	0	0	2	34
Чукотский автономный округ	Государственные, муниципальные (без учета организаций в ведении ФСИН); Заочная	Прибыло студентов - всего (сумма стр. 02-05) / 1.0	0	0	0	0	0	0	0	0	0	0	0	0	0	0	0	6	0	0	0	6
Чукотский автономный округ	Государственные, муниципальные (без учета организаций в ведении ФСИН); Заочная	"Численность студентов на начало прошлого учебного года
(на 1 октября) / 17.0"	0	0	0	0	0	0	0	0	0	0	0	0	0	24	24	148	0	0	7	155
Чукотский автономный округ	Государственные, муниципальные (без учета организаций в ведении ФСИН); Очная	            из стр. 11 - не прошли итоговую аттестацию / 12.0	0	0	0	0	0	0	0	0	0	0	1	0	0	0	1	0	0	0	0	0
Чукотский автономный округ	Государственные, муниципальные (без учета организаций в ведении ФСИН); Очная	"            из стр. 11 – лица с ограниченными возможностями здоровья,
            инвалиды, дети-инвалиды / 13.0"	0	0	0	0	0	0	0	0	0	0	0	0	0	0	0	0	0	0	0	0
Чукотский автономный округ	Государственные, муниципальные (без учета организаций в ведении ФСИН); Очная	         отчислено в виде меры дисциплинарного взыскания / 14.0	0	0	0	0	0	0	0	0	0	0	3	0	0	0	3	0	0	0	0	0
Чукотский автономный округ	Государственные, муниципальные (без учета организаций в ведении ФСИН); Очная	         отчислено из-за просрочки оплаты обучения / 15.0	0	0	0	0	0	0	0	0	0	0	0	0	0	0	0	0	0	0	0	0
Чукотский автономный округ	Государственные, муниципальные (без учета организаций в ведении ФСИН); Очная	"    в том числе:
    переведено на другие формы обучения данной
    организации на программы того же уровня / 7.0"	0	0	0	0	0	0	0	0	0	0	2	0	0	0	2	0	0	0	0	0
Чукотский автономный округ	Государственные, муниципальные (без учета организаций в ведении ФСИН); Очная	"    в том числе:
    переведено с других форм обучения данной
    образовательной организации с программ того же уровня / 2.0"	0	0	0	0	0	0	0	0	0	0	2	0	0	0	2	0	0	0	0	0
Чукотский автономный округ	Государственные, муниципальные (без учета организаций в ведении ФСИН); Очная	    восстановлены из числа ранее отчисленных / 4.0	0	0	0	0	0	0	0	0	0	0	2	0	0	0	2	0	0	0	0	0
Чукотский автономный округ	Государственные, муниципальные (без учета организаций в ведении ФСИН); Очная	    выбыло по другим причинам / 16.0	2	0	0	0	2	0	0	0	0	0	2	0	0	0	2	1	0	0	0	1
Чукотский автономный округ	Государственные, муниципальные (без учета организаций в ведении ФСИН); Очная	"    добровольно прекратили образовательные отношения
    (бросили учебу) / 10.0"	27	0	0	0	27	0	0	0	0	0	26	0	0	0	26	9	0	0	0	9
Чукотский автономный округ	Государственные, муниципальные (без учета организаций в ведении ФСИН); Очная	"    отчислено:
         по неуспеваемости / 11.0"	10	0	0	0	10	0	0	0	0	0	8	0	0	0	8	6	0	0	0	6
Чукотский автономный округ	Государственные, муниципальные (без учета организаций в ведении ФСИН); Очная	"    переведено в другие образовательные организации
    на программы того же уровня / 8.0"	1	0	0	0	1	0	0	0	0	0	1	0	0	0	1	4	0	0	0	4
Чукотский автономный округ	Государственные, муниципальные (без учета организаций в ведении ФСИН); Очная	"    переведено из других образовательных организаций 
    с программ того же уровня / 3.0"	0	0	0	0	0	0	0	0	0	0	3	0	0	0	3	0	0	0	0	0
Чукотский автономный округ	Государственные, муниципальные (без учета организаций в ведении ФСИН); Очная	    по болезни / 9.0	0	0	0	0	0	0	0	0	0	0	2	0	0	0	2	0	0	0	0	0
Чукотский автономный округ	Государственные, муниципальные (без учета организаций в ведении ФСИН); Очная	    прибыло по другим причинам / 5.0	2	0	0	0	2	0	0	0	0	0	2	0	0	0	2	2	0	0	0	2
Чукотский автономный округ	Государственные, муниципальные (без учета организаций в ведении ФСИН); Очная	Выбыло студентов - всего (сумма стр. 07-11, 13-15) / 6.0	40	0	0	0	40	0	0	0	0	0	44	0	0	0	44	20	0	0	0	20
Чукотский автономный округ	Государственные, муниципальные (без учета организаций в ведении ФСИН); Очная	Прибыло студентов - всего (сумма стр. 02-05) / 1.0	2	0	0	0	2	0	0	0	0	0	9	0	0	0	9	2	0	0	0	2
Чукотский автономный округ	Государственные, муниципальные (без учета организаций в ведении ФСИН); Очная	"Численность студентов на начало прошлого учебного года
(на 1 октября) / 17.0"	173	0	0	1	174	0	0	0	0	0	318	0	0	0	318	128	0	0	3	131
Чукотский автономный округ	Очно-заочная; Государственные, муниципальные (без учета организаций в ведении ФСИН)	            из стр. 11 - не прошли итоговую аттестацию / 12.0	0	0	0	0	0	0	0	0	0	0	0	0	0	0	0	0	0	0	0	0
Чукотский автономный округ	Очно-заочная; Государственные, муниципальные (без учета организаций в ведении ФСИН)	"            из стр. 11 – лица с ограниченными возможностями здоровья,
            инвалиды, дети-инвалиды / 13.0"	0	0	0	0	0	0	0	0	0	0	0	0	0	0	0	0	0	0	0	0
Чукотский автономный округ	Очно-заочная; Государственные, муниципальные (без учета организаций в ведении ФСИН)	         отчислено в виде меры дисциплинарного взыскания / 14.0	0	0	0	0	0	0	0	0	0	0	0	0	0	0	0	0	0	0	0	0
Чукотский автономный округ	Очно-заочная; Государственные, муниципальные (без учета организаций в ведении ФСИН)	         отчислено из-за просрочки оплаты обучения / 15.0	0	0	0	0	0	0	0	0	0	0	0	0	0	0	0	0	0	0	0	0
Чукотский автономный округ	Очно-заочная; Государственные, муниципальные (без учета организаций в ведении ФСИН)	"    в том числе:
    переведено на другие формы обучения данной
    организации на программы того же уровня / 7.0"	0	0	0	0	0	0	0	0	0	0	0	0	0	0	0	0	0	0	0	0
Чукотский автономный округ	Очно-заочная; Государственные, муниципальные (без учета организаций в ведении ФСИН)	"    в том числе:
    переведено с других форм обучения данной
    образовательной организации с программ того же уровня / 2.0"	0	0	0	0	0	0	0	0	0	0	0	0	0	0	0	0	0	0	0	0
Чукотский автономный округ	Очно-заочная; Государственные, муниципальные (без учета организаций в ведении ФСИН)	    восстановлены из числа ранее отчисленных / 4.0	0	0	0	0	0	0	0	0	0	0	0	0	0	0	0	0	0	0	0	0
Чукотский автономный округ	Очно-заочная; Государственные, муниципальные (без учета организаций в ведении ФСИН)	    выбыло по другим причинам / 16.0	0	0	0	0	0	0	0	0	0	0	0	0	0	0	0	0	0	0	0	0
Чукотский автономный округ	Очно-заочная; Государственные, муниципальные (без учета организаций в ведении ФСИН)	"    добровольно прекратили образовательные отношения
    (бросили учебу) / 10.0"	0	0	0	0	0	0	0	0	0	0	1	0	0	0	1	0	0	0	0	0
Чукотский автономный округ	Очно-заочная; Государственные, муниципальные (без учета организаций в ведении ФСИН)	"    отчислено:
         по неуспеваемости / 11.0"	0	0	0	0	0	0	0	0	0	0	1	0	0	0	1	0	0	0	0	0
Чукотский автономный округ	Очно-заочная; Государственные, муниципальные (без учета организаций в ведении ФСИН)	"    переведено в другие образовательные организации
    на программы того же уровня / 8.0"	0	0	0	0	0	0	0	0	0	0	0	0	0	0	0	0	0	0	0	0
Чукотский автономный округ	Очно-заочная; Государственные, муниципальные (без учета организаций в ведении ФСИН)	"    переведено из других образовательных организаций 
    с программ того же уровня / 3.0"	0	0	0	0	0	0	0	0	0	0	0	0	0	0	0	0	0	0	0	0
Чукотский автономный округ	Очно-заочная; Государственные, муниципальные (без учета организаций в ведении ФСИН)	    по болезни / 9.0	0	0	0	0	0	0	0	0	0	0	0	0	0	0	0	0	0	0	0	0
Чукотский автономный округ	Очно-заочная; Государственные, муниципальные (без учета организаций в ведении ФСИН)	    прибыло по другим причинам / 5.0	0	0	0	0	0	0	0	0	0	0	0	0	0	0	0	0	0	0	0	0
Чукотский автономный округ	Очно-заочная; Государственные, муниципальные (без учета организаций в ведении ФСИН)	Выбыло студентов - всего (сумма стр. 07-11, 13-15) / 6.0	0	0	0	0	0	0	0	0	0	0	2	0	0	0	2	0	0	0	0	0
Чукотский автономный округ	Очно-заочная; Государственные, муниципальные (без учета организаций в ведении ФСИН)	Прибыло студентов - всего (сумма стр. 02-05) / 1.0	0	0	0	0	0	0	0	0	0	0	0	0	0	0	0	0	0	0	0	0
Чукотский автономный округ	Очно-заочная; Государственные, муниципальные (без учета организаций в ведении ФСИН)	"Численность студентов на начало прошлого учебного года
(на 1 октября) / 17.0"	0	0	0	0	0	0	0	0	0	0	11	0	0	0	11	0	0	0	0	0
Ямало-Ненецкий автономный округ	Государственные, муниципальные (без учета организаций в ведении ФСИН); Заочная	            из стр. 11 - не прошли итоговую аттестацию / 12.0	0	0	0	0	0	0	0	0	0	0	0	0	0	0	0	0	0	0	0	0
Ямало-Ненецкий автономный округ	Государственные, муниципальные (без учета организаций в ведении ФСИН); Заочная	"            из стр. 11 – лица с ограниченными возможностями здоровья,
            инвалиды, дети-инвалиды / 13.0"	0	0	0	0	0	0	0	0	0	0	0	0	0	0	0	0	0	0	0	0
Ямало-Ненецкий автономный округ	Государственные, муниципальные (без учета организаций в ведении ФСИН); Заочная	         отчислено в виде меры дисциплинарного взыскания / 14.0	0	0	0	0	0	0	0	0	0	0	0	0	0	0	0	0	0	0	0	0
Ямало-Ненецкий автономный округ	Государственные, муниципальные (без учета организаций в ведении ФСИН); Заочная	         отчислено из-за просрочки оплаты обучения / 15.0	0	0	0	0	0	0	0	0	0	0	0	0	0	6	6	0	0	0	16	16
Ямало-Ненецкий автономный округ	Государственные, муниципальные (без учета организаций в ведении ФСИН); Заочная	"    в том числе:
    переведено на другие формы обучения данной
    организации на программы того же уровня / 7.0"	0	0	0	0	0	0	0	0	0	0	0	0	0	4	4	0	0	0	0	0
Ямало-Ненецкий автономный округ	Государственные, муниципальные (без учета организаций в ведении ФСИН); Заочная	"    в том числе:
    переведено с других форм обучения данной
    образовательной организации с программ того же уровня / 2.0"	0	0	0	0	0	0	0	0	0	0	0	0	0	50	50	0	0	0	19	19
Ямало-Ненецкий автономный округ	Государственные, муниципальные (без учета организаций в ведении ФСИН); Заочная	    восстановлены из числа ранее отчисленных / 4.0	0	0	0	0	0	0	0	0	0	0	0	0	0	12	12	0	0	0	16	16
Ямало-Ненецкий автономный округ	Государственные, муниципальные (без учета организаций в ведении ФСИН); Заочная	    выбыло по другим причинам / 16.0	0	0	0	0	0	0	0	0	0	0	0	0	0	10	10	19	0	0	10	29
Ямало-Ненецкий автономный округ	Государственные, муниципальные (без учета организаций в ведении ФСИН); Заочная	"    добровольно прекратили образовательные отношения
    (бросили учебу) / 10.0"	0	0	0	0	0	0	0	0	0	0	0	0	0	8	8	1	0	0	22	23
Ямало-Ненецкий автономный округ	Государственные, муниципальные (без учета организаций в ведении ФСИН); Заочная	"    отчислено:
         по неуспеваемости / 11.0"	0	0	0	0	0	0	0	0	0	0	0	0	0	7	7	0	0	0	10	10
Ямало-Ненецкий автономный округ	Государственные, муниципальные (без учета организаций в ведении ФСИН); Заочная	"    переведено в другие образовательные организации
    на программы того же уровня / 8.0"	0	0	0	0	0	0	0	0	0	0	0	0	0	2	2	0	0	0	4	4
Ямало-Ненецкий автономный округ	Государственные, муниципальные (без учета организаций в ведении ФСИН); Заочная	"    переведено из других образовательных организаций 
    с программ того же уровня / 3.0"	0	0	0	0	0	0	0	0	0	0	0	0	0	2	2	0	0	0	8	8
Ямало-Ненецкий автономный округ	Государственные, муниципальные (без учета организаций в ведении ФСИН); Заочная	    по болезни / 9.0	0	0	0	0	0	0	0	0	0	0	0	0	0	0	0	0	0	0	0	0
Ямало-Ненецкий автономный округ	Государственные, муниципальные (без учета организаций в ведении ФСИН); Заочная	    прибыло по другим причинам / 5.0	0	0	0	0	0	0	0	0	0	0	0	0	0	8	8	0	0	0	91	91
Ямало-Ненецкий автономный округ	Государственные, муниципальные (без учета организаций в ведении ФСИН); Заочная	Выбыло студентов - всего (сумма стр. 07-11, 13-15) / 6.0	0	0	0	0	0	0	0	0	0	0	0	0	0	37	37	20	0	0	62	82
Ямало-Ненецкий автономный округ	Государственные, муниципальные (без учета организаций в ведении ФСИН); Заочная	Прибыло студентов - всего (сумма стр. 02-05) / 1.0	0	0	0	0	0	0	0	0	0	0	0	0	0	72	72	0	0	0	134	134
Ямало-Ненецкий автономный округ	Государственные, муниципальные (без учета организаций в ведении ФСИН); Заочная	"Численность студентов на начало прошлого учебного года
(на 1 октября) / 17.0"	0	0	0	0	0	0	0	0	0	0	0	0	0	266	266	108	0	0	469	577
Ямало-Ненецкий автономный округ	Государственные, муниципальные (без учета организаций в ведении ФСИН); Очная	            из стр. 11 - не прошли итоговую аттестацию / 12.0	0	0	0	0	0	0	0	0	0	0	0	0	0	0	0	0	0	0	0	0
Ямало-Ненецкий автономный округ	Государственные, муниципальные (без учета организаций в ведении ФСИН); Очная	"            из стр. 11 – лица с ограниченными возможностями здоровья,
            инвалиды, дети-инвалиды / 13.0"	0	0	0	0	0	0	0	0	0	0	0	0	0	0	0	0	0	0	0	0
Ямало-Ненецкий автономный округ	Государственные, муниципальные (без учета организаций в ведении ФСИН); Очная	         отчислено в виде меры дисциплинарного взыскания / 14.0	0	0	0	0	0	0	0	0	0	0	1	0	0	1	2	0	0	0	0	0
Ямало-Ненецкий автономный округ	Государственные, муниципальные (без учета организаций в ведении ФСИН); Очная	         отчислено из-за просрочки оплаты обучения / 15.0	0	0	0	3	3	0	0	0	0	0	0	0	0	3	3	0	0	0	0	0
Ямало-Ненецкий автономный округ	Государственные, муниципальные (без учета организаций в ведении ФСИН); Очная	"    в том числе:
    переведено на другие формы обучения данной
    организации на программы того же уровня / 7.0"	27	0	0	16	43	0	0	0	0	0	100	0	0	27	127	2	0	0	2	4
Ямало-Ненецкий автономный округ	Государственные, муниципальные (без учета организаций в ведении ФСИН); Очная	"    в том числе:
    переведено с других форм обучения данной
    образовательной организации с программ того же уровня / 2.0"	27	0	1	0	28	0	0	0	0	0	51	0	5	6	62	2	0	0	0	2
Ямало-Ненецкий автономный округ	Государственные, муниципальные (без учета организаций в ведении ФСИН); Очная	    восстановлены из числа ранее отчисленных / 4.0	23	0	4	0	27	0	0	0	0	0	19	0	3	0	22	0	0	0	0	0
Ямало-Ненецкий автономный округ	Государственные, муниципальные (без учета организаций в ведении ФСИН); Очная	    выбыло по другим причинам / 16.0	108	0	1	9	118	0	0	0	0	0	77	0	5	24	106	13	0	3	1	17
Ямало-Ненецкий автономный округ	Государственные, муниципальные (без учета организаций в ведении ФСИН); Очная	"    добровольно прекратили образовательные отношения
    (бросили учебу) / 10.0"	55	0	46	5	106	0	0	0	0	0	118	0	30	13	161	13	0	2	0	15
Ямало-Ненецкий автономный округ	Государственные, муниципальные (без учета организаций в ведении ФСИН); Очная	"    отчислено:
         по неуспеваемости / 11.0"	18	0	0	1	19	0	0	0	0	0	33	0	0	3	36	0	0	0	0	0
Ямало-Ненецкий автономный округ	Государственные, муниципальные (без учета организаций в ведении ФСИН); Очная	"    переведено в другие образовательные организации
    на программы того же уровня / 8.0"	16	0	0	1	17	0	0	0	0	0	62	0	2	8	72	2	0	0	0	2
Ямало-Ненецкий автономный округ	Государственные, муниципальные (без учета организаций в ведении ФСИН); Очная	"    переведено из других образовательных организаций 
    с программ того же уровня / 3.0"	23	0	1	3	27	0	0	0	0	0	29	0	0	3	32	5	0	0	1	6
Ямало-Ненецкий автономный округ	Государственные, муниципальные (без учета организаций в ведении ФСИН); Очная	    по болезни / 9.0	1	0	0	0	1	0	0	0	0	0	9	0	0	0	9	0	0	0	0	0
Ямало-Ненецкий автономный округ	Государственные, муниципальные (без учета организаций в ведении ФСИН); Очная	    прибыло по другим причинам / 5.0	31	0	0	7	38	0	0	0	0	0	24	20	0	17	61	1	0	1	0	2
Ямало-Ненецкий автономный округ	Государственные, муниципальные (без учета организаций в ведении ФСИН); Очная	Выбыло студентов - всего (сумма стр. 07-11, 13-15) / 6.0	225	0	47	35	307	0	0	0	0	0	400	0	37	79	516	30	0	5	3	38
Ямало-Ненецкий автономный округ	Государственные, муниципальные (без учета организаций в ведении ФСИН); Очная	Прибыло студентов - всего (сумма стр. 02-05) / 1.0	104	0	6	10	120	0	0	0	0	0	123	20	8	26	177	8	0	1	1	10
Ямало-Ненецкий автономный округ	Государственные, муниципальные (без учета организаций в ведении ФСИН); Очная	"Численность студентов на начало прошлого учебного года
(на 1 октября) / 17.0"	1808	0	248	139	2195	1	0	0	0	1	3942	0	364	756	5062	254	0	40	49	343
Ямало-Ненецкий автономный округ	Очно-заочная; Государственные, муниципальные (без учета организаций в ведении ФСИН)	            из стр. 11 - не прошли итоговую аттестацию / 12.0	0	0	0	0	0	0	0	0	0	0	0	0	0	0	0	0	0	0	0	0
Ямало-Ненецкий автономный округ	Очно-заочная; Государственные, муниципальные (без учета организаций в ведении ФСИН)	"            из стр. 11 – лица с ограниченными возможностями здоровья,
            инвалиды, дети-инвалиды / 13.0"	0	0	0	0	0	0	0	0	0	0	0	0	0	0	0	0	0	0	0	0
Ямало-Ненецкий автономный округ	Очно-заочная; Государственные, муниципальные (без учета организаций в ведении ФСИН)	         отчислено в виде меры дисциплинарного взыскания / 14.0	0	0	0	0	0	0	0	0	0	0	0	0	0	0	0	0	0	0	0	0
Ямало-Ненецкий автономный округ	Очно-заочная; Государственные, муниципальные (без учета организаций в ведении ФСИН)	         отчислено из-за просрочки оплаты обучения / 15.0	0	0	0	0	0	0	0	0	0	0	0	0	0	0	0	0	0	0	11	11
Ямало-Ненецкий автономный округ	Очно-заочная; Государственные, муниципальные (без учета организаций в ведении ФСИН)	"    в том числе:
    переведено на другие формы обучения данной
    организации на программы того же уровня / 7.0"	0	0	0	0	0	0	0	0	0	0	0	0	0	0	0	0	0	0	0	0
Ямало-Ненецкий автономный округ	Очно-заочная; Государственные, муниципальные (без учета организаций в ведении ФСИН)	"    в том числе:
    переведено с других форм обучения данной
    образовательной организации с программ того же уровня / 2.0"	0	0	0	0	0	0	0	0	0	0	0	0	0	0	0	0	0	0	1	1
Ямало-Ненецкий автономный округ	Очно-заочная; Государственные, муниципальные (без учета организаций в ведении ФСИН)	    восстановлены из числа ранее отчисленных / 4.0	0	0	0	0	0	0	0	0	0	0	0	0	0	0	0	0	0	0	1	1
Ямало-Ненецкий автономный округ	Очно-заочная; Государственные, муниципальные (без учета организаций в ведении ФСИН)	    выбыло по другим причинам / 16.0	0	0	0	0	0	0	0	0	0	0	0	0	0	0	0	1	0	0	23	24
Ямало-Ненецкий автономный округ	Очно-заочная; Государственные, муниципальные (без учета организаций в ведении ФСИН)	"    добровольно прекратили образовательные отношения
    (бросили учебу) / 10.0"	0	0	0	0	0	0	0	0	0	0	0	0	0	0	0	0	0	0	19	19
Ямало-Ненецкий автономный округ	Очно-заочная; Государственные, муниципальные (без учета организаций в ведении ФСИН)	"    отчислено:
         по неуспеваемости / 11.0"	0	0	0	0	0	0	0	0	0	0	0	0	0	0	0	0	0	0	0	0
Ямало-Ненецкий автономный округ	Очно-заочная; Государственные, муниципальные (без учета организаций в ведении ФСИН)	"    переведено в другие образовательные организации
    на программы того же уровня / 8.0"	0	0	0	0	0	0	0	0	0	0	0	0	0	0	0	0	0	0	5	5
Ямало-Ненецкий автономный округ	Очно-заочная; Государственные, муниципальные (без учета организаций в ведении ФСИН)	"    переведено из других образовательных организаций 
    с программ того же уровня / 3.0"	0	0	0	0	0	0	0	0	0	0	0	0	0	0	0	0	0	0	4	4
Ямало-Ненецкий автономный округ	Очно-заочная; Государственные, муниципальные (без учета организаций в ведении ФСИН)	    по болезни / 9.0	0	0	0	0	0	0	0	0	0	0	0	0	0	0	0	0	0	0	0	0
Ямало-Ненецкий автономный округ	Очно-заочная; Государственные, муниципальные (без учета организаций в ведении ФСИН)	    прибыло по другим причинам / 5.0	0	0	0	0	0	0	0	0	0	0	0	0	0	0	0	0	0	0	26	26
Ямало-Ненецкий автономный округ	Очно-заочная; Государственные, муниципальные (без учета организаций в ведении ФСИН)	Выбыло студентов - всего (сумма стр. 07-11, 13-15) / 6.0	0	0	0	0	0	0	0	0	0	0	0	0	0	0	0	1	0	0	58	59
Ямало-Ненецкий автономный округ	Очно-заочная; Государственные, муниципальные (без учета организаций в ведении ФСИН)	Прибыло студентов - всего (сумма стр. 02-05) / 1.0	0	0	0	0	0	0	0	0	0	0	0	0	0	0	0	0	0	0	32	32
Ямало-Ненецкий автономный округ	Очно-заочная; Государственные, муниципальные (без учета организаций в ведении ФСИН)	"Численность студентов на начало прошлого учебного года
(на 1 октября) / 17.0"	0	0	0	0	0	0	0	0	0	0	0	0	0	0	0	25	0	0	298	323
Ямало-Ненецкий автономный округ	Частные; Заочная	            из стр. 11 - не прошли итоговую аттестацию / 12.0	0	0	0	0	0	0	0	0	0	0	0	0	0	0	0	0	0	0	0	0
Ямало-Ненецкий автономный округ	Частные; Заочная	"            из стр. 11 – лица с ограниченными возможностями здоровья,
            инвалиды, дети-инвалиды / 13.0"	0	0	0	0	0	0	0	0	0	0	0	0	0	0	0	0	0	0	0	0
Ямало-Ненецкий автономный округ	Частные; Заочная	         отчислено в виде меры дисциплинарного взыскания / 14.0	0	0	0	0	0	0	0	0	0	0	0	0	0	0	0	0	0	0	0	0
Ямало-Ненецкий автономный округ	Частные; Заочная	         отчислено из-за просрочки оплаты обучения / 15.0	0	0	0	0	0	0	0	0	0	0	0	0	0	5	5	0	0	0	2	2
Ямало-Ненецкий автономный округ	Частные; Заочная	"    в том числе:
    переведено на другие формы обучения данной
    организации на программы того же уровня / 7.0"	0	0	0	0	0	0	0	0	0	0	0	0	0	0	0	0	0	0	0	0
Ямало-Ненецкий автономный округ	Частные; Заочная	"    в том числе:
    переведено с других форм обучения данной
    образовательной организации с программ того же уровня / 2.0"	0	0	0	0	0	0	0	0	0	0	0	0	0	12	12	0	0	0	3	3
Ямало-Ненецкий автономный округ	Частные; Заочная	    восстановлены из числа ранее отчисленных / 4.0	0	0	0	0	0	0	0	0	0	0	0	0	0	2	2	0	0	0	14	14
Ямало-Ненецкий автономный округ	Частные; Заочная	    выбыло по другим причинам / 16.0	0	0	0	0	0	0	0	0	0	0	0	0	0	0	0	0	0	0	0	0
Ямало-Ненецкий автономный округ	Частные; Заочная	"    добровольно прекратили образовательные отношения
    (бросили учебу) / 10.0"	0	0	0	0	0	0	0	0	0	0	0	0	0	1	1	0	0	0	27	27
Ямало-Ненецкий автономный округ	Частные; Заочная	"    отчислено:
         по неуспеваемости / 11.0"	0	0	0	0	0	0	0	0	0	0	0	0	0	0	0	0	0	0	0	0
Ямало-Ненецкий автономный округ	Частные; Заочная	"    переведено в другие образовательные организации
    на программы того же уровня / 8.0"	0	0	0	0	0	0	0	0	0	0	0	0	0	0	0	0	0	0	1	1
Ямало-Ненецкий автономный округ	Частные; Заочная	"    переведено из других образовательных организаций 
    с программ того же уровня / 3.0"	0	0	0	0	0	0	0	0	0	0	0	0	0	1	1	0	0	0	0	0
Ямало-Ненецкий автономный округ	Частные; Заочная	    по болезни / 9.0	0	0	0	0	0	0	0	0	0	0	0	0	0	0	0	0	0	0	0	0
Ямало-Ненецкий автономный округ	Частные; Заочная	    прибыло по другим причинам / 5.0	0	0	0	0	0	0	0	0	0	0	0	0	0	0	0	0	0	0	8	8
Ямало-Ненецкий автономный округ	Частные; Заочная	Выбыло студентов - всего (сумма стр. 07-11, 13-15) / 6.0	0	0	0	0	0	0	0	0	0	0	0	0	0	6	6	0	0	0	30	30
Ямало-Ненецкий автономный округ	Частные; Заочная	Прибыло студентов - всего (сумма стр. 02-05) / 1.0	0	0	0	0	0	0	0	0	0	0	0	0	0	15	15	0	0	0	25	25
Ямало-Ненецкий автономный округ	Частные; Заочная	"Численность студентов на начало прошлого учебного года
(на 1 октября) / 17.0"	0	0	0	0	0	0	0	0	0	0	0	0	0	19	19	0	0	0	312	312
Ямало-Ненецкий автономный округ	Частные; Очная	            из стр. 11 - не прошли итоговую аттестацию / 12.0	0	0	0	0	0	0	0	0	0	0	0	0	0	0	0	0	0	0	0	0
Ямало-Ненецкий автономный округ	Частные; Очная	"            из стр. 11 – лица с ограниченными возможностями здоровья,
            инвалиды, дети-инвалиды / 13.0"	0	0	0	0	0	0	0	0	0	0	0	0	0	0	0	0	0	0	0	0
Ямало-Ненецкий автономный округ	Частные; Очная	         отчислено в виде меры дисциплинарного взыскания / 14.0	0	0	0	0	0	0	0	0	0	0	0	0	0	0	0	0	0	0	0	0
Ямало-Ненецкий автономный округ	Частные; Очная	         отчислено из-за просрочки оплаты обучения / 15.0	0	0	0	0	0	0	0	0	0	0	0	0	0	3	3	0	0	0	1	1
Ямало-Ненецкий автономный округ	Частные; Очная	"    в том числе:
    переведено на другие формы обучения данной
    организации на программы того же уровня / 7.0"	0	0	0	0	0	0	0	0	0	0	0	0	0	19	19	0	0	0	0	0
Ямало-Ненецкий автономный округ	Частные; Очная	"    в том числе:
    переведено с других форм обучения данной
    образовательной организации с программ того же уровня / 2.0"	0	0	0	0	0	0	0	0	0	0	0	0	0	4	4	0	0	0	0	0
Ямало-Ненецкий автономный округ	Частные; Очная	    восстановлены из числа ранее отчисленных / 4.0	0	0	0	0	0	0	0	0	0	0	0	0	0	3	3	0	0	0	0	0
Ямало-Ненецкий автономный округ	Частные; Очная	    выбыло по другим причинам / 16.0	0	0	0	0	0	0	0	0	0	0	0	0	0	10	10	0	0	0	0	0
Ямало-Ненецкий автономный округ	Частные; Очная	"    добровольно прекратили образовательные отношения
    (бросили учебу) / 10.0"	0	0	0	0	0	0	0	0	0	0	0	0	0	24	24	0	0	0	2	2
Ямало-Ненецкий автономный округ	Частные; Очная	"    отчислено:
         по неуспеваемости / 11.0"	0	0	0	0	0	0	0	0	0	0	0	0	0	9	9	0	0	0	0	0
Ямало-Ненецкий автономный округ	Частные; Очная	"    переведено в другие образовательные организации
    на программы того же уровня / 8.0"	0	0	0	0	0	0	0	0	0	0	0	0	0	10	10	0	0	0	0	0
Ямало-Ненецкий автономный округ	Частные; Очная	"    переведено из других образовательных организаций 
    с программ того же уровня / 3.0"	0	0	0	0	0	0	0	0	0	0	0	0	0	4	4	0	0	0	0	0
Ямало-Ненецкий автономный округ	Частные; Очная	    по болезни / 9.0	0	0	0	0	0	0	0	0	0	0	0	0	0	0	0	0	0	0	0	0
Ямало-Ненецкий автономный округ	Частные; Очная	    прибыло по другим причинам / 5.0	0	0	0	0	0	0	0	0	0	0	0	0	0	14	14	0	0	0	0	0
Ямало-Ненецкий автономный округ	Частные; Очная	Выбыло студентов - всего (сумма стр. 07-11, 13-15) / 6.0	0	0	0	0	0	0	0	0	0	0	0	0	0	75	75	0	0	0	3	3
Ямало-Ненецкий автономный округ	Частные; Очная	Прибыло студентов - всего (сумма стр. 02-05) / 1.0	0	0	0	0	0	0	0	0	0	0	0	0	0	25	25	0	0	0	0	0
Ямало-Ненецкий автономный округ	Частные; Очная	"Численность студентов на начало прошлого учебного года
(на 1 октября) / 17.0"	0	0	0	0	0	0	0	0	0	0	0	0	0	1245	1245	0	0	0	39	39
Ярославская область	Государственные, муниципальные (без учета организаций в ведении ФСИН); Заочная	            из стр. 11 - не прошли итоговую аттестацию / 12.0	0	0	0	0	0	0	0	0	0	0	0	0	0	0	0	0	0	0	0	0
Ярославская область	Государственные, муниципальные (без учета организаций в ведении ФСИН); Заочная	"            из стр. 11 – лица с ограниченными возможностями здоровья,
            инвалиды, дети-инвалиды / 13.0"	0	0	0	0	0	0	0	0	0	0	0	0	0	0	0	0	0	0	0	0
Ярославская область	Государственные, муниципальные (без учета организаций в ведении ФСИН); Заочная	         отчислено в виде меры дисциплинарного взыскания / 14.0	0	0	0	0	0	0	0	0	0	0	0	0	0	0	0	0	0	0	0	0
Ярославская область	Государственные, муниципальные (без учета организаций в ведении ФСИН); Заочная	         отчислено из-за просрочки оплаты обучения / 15.0	0	0	0	0	0	0	0	0	0	0	0	0	0	6	6	0	0	0	8	8
Ярославская область	Государственные, муниципальные (без учета организаций в ведении ФСИН); Заочная	"    в том числе:
    переведено на другие формы обучения данной
    организации на программы того же уровня / 7.0"	0	0	0	0	0	0	0	0	0	0	0	0	0	0	0	2	0	0	6	8
Ярославская область	Государственные, муниципальные (без учета организаций в ведении ФСИН); Заочная	"    в том числе:
    переведено с других форм обучения данной
    образовательной организации с программ того же уровня / 2.0"	0	0	0	0	0	0	0	0	0	0	7	0	0	57	64	16	0	0	16	32
Ярославская область	Государственные, муниципальные (без учета организаций в ведении ФСИН); Заочная	    восстановлены из числа ранее отчисленных / 4.0	0	0	0	0	0	0	0	0	0	0	4	0	0	19	23	13	0	0	12	25
Ярославская область	Государственные, муниципальные (без учета организаций в ведении ФСИН); Заочная	    выбыло по другим причинам / 16.0	0	0	0	0	0	0	0	0	0	0	2	0	0	12	14	25	0	0	26	51
Ярославская область	Государственные, муниципальные (без учета организаций в ведении ФСИН); Заочная	"    добровольно прекратили образовательные отношения
    (бросили учебу) / 10.0"	0	0	0	0	0	0	0	0	0	0	26	4	0	31	61	96	0	12	114	222
Ярославская область	Государственные, муниципальные (без учета организаций в ведении ФСИН); Заочная	"    отчислено:
         по неуспеваемости / 11.0"	0	0	0	0	0	0	0	0	0	0	3	0	0	7	10	30	0	14	13	57
Ярославская область	Государственные, муниципальные (без учета организаций в ведении ФСИН); Заочная	"    переведено в другие образовательные организации
    на программы того же уровня / 8.0"	0	0	0	0	0	0	0	0	0	0	0	0	0	1	1	4	0	0	1	5
Ярославская область	Государственные, муниципальные (без учета организаций в ведении ФСИН); Заочная	"    переведено из других образовательных организаций 
    с программ того же уровня / 3.0"	0	0	0	0	0	0	0	0	0	0	1	0	0	2	3	7	0	0	4	11
Ярославская область	Государственные, муниципальные (без учета организаций в ведении ФСИН); Заочная	    по болезни / 9.0	0	0	0	0	0	0	0	0	0	0	0	0	0	0	0	0	0	0	0	0
Ярославская область	Государственные, муниципальные (без учета организаций в ведении ФСИН); Заочная	    прибыло по другим причинам / 5.0	0	0	0	0	0	0	0	0	0	0	0	0	0	5	5	2	0	0	16	18
Ярославская область	Государственные, муниципальные (без учета организаций в ведении ФСИН); Заочная	Выбыло студентов - всего (сумма стр. 07-11, 13-15) / 6.0	0	0	0	0	0	0	0	0	0	0	31	4	0	57	92	157	0	26	168	351
Ярославская область	Государственные, муниципальные (без учета организаций в ведении ФСИН); Заочная	Прибыло студентов - всего (сумма стр. 02-05) / 1.0	0	0	0	0	0	0	0	0	0	0	12	0	0	83	95	38	0	0	48	86
Ярославская область	Государственные, муниципальные (без учета организаций в ведении ФСИН); Заочная	"Численность студентов на начало прошлого учебного года
(на 1 октября) / 17.0"	0	0	0	0	0	0	0	0	0	0	140	0	0	380	520	1187	0	255	790	2232
Ярославская область	Государственные, муниципальные (без учета организаций в ведении ФСИН); Очная	            из стр. 11 - не прошли итоговую аттестацию / 12.0	33	0	0	0	33	0	0	0	1	1	5	0	0	0	5	0	0	0	0	0
Ярославская область	Государственные, муниципальные (без учета организаций в ведении ФСИН); Очная	"            из стр. 11 – лица с ограниченными возможностями здоровья,
            инвалиды, дети-инвалиды / 13.0"	0	0	0	0	0	0	0	0	0	0	0	0	0	0	0	0	0	0	0	0
Ярославская область	Государственные, муниципальные (без учета организаций в ведении ФСИН); Очная	         отчислено в виде меры дисциплинарного взыскания / 14.0	4	0	0	0	4	0	0	0	0	0	2	0	0	0	2	0	0	0	0	0
Ярославская область	Государственные, муниципальные (без учета организаций в ведении ФСИН); Очная	         отчислено из-за просрочки оплаты обучения / 15.0	0	0	0	3	3	0	0	0	0	0	0	0	0	11	11	0	0	0	1	1
Ярославская область	Государственные, муниципальные (без учета организаций в ведении ФСИН); Очная	"    в том числе:
    переведено на другие формы обучения данной
    организации на программы того же уровня / 7.0"	12	0	0	15	27	0	0	0	1	1	95	0	0	140	235	7	0	0	37	44
Ярославская область	Государственные, муниципальные (без учета организаций в ведении ФСИН); Очная	"    в том числе:
    переведено с других форм обучения данной
    образовательной организации с программ того же уровня / 2.0"	56	0	0	9	65	1	0	0	2	3	124	0	4	20	148	32	0	0	1	33
Ярославская область	Государственные, муниципальные (без учета организаций в ведении ФСИН); Очная	    восстановлены из числа ранее отчисленных / 4.0	25	0	0	0	25	0	0	0	1	1	61	0	1	39	101	20	0	0	21	41
Ярославская область	Государственные, муниципальные (без учета организаций в ведении ФСИН); Очная	    выбыло по другим причинам / 16.0	113	0	0	7	120	11	0	0	0	11	113	0	9	93	215	137	0	2	53	192
Ярославская область	Государственные, муниципальные (без учета организаций в ведении ФСИН); Очная	"    добровольно прекратили образовательные отношения
    (бросили учебу) / 10.0"	398	0	0	47	445	25	0	0	5	30	654	0	73	288	1015	136	0	6	83	225
Ярославская область	Государственные, муниципальные (без учета организаций в ведении ФСИН); Очная	"    отчислено:
         по неуспеваемости / 11.0"	243	0	0	2	245	20	0	0	2	22	135	0	35	51	221	24	0	5	28	57
Ярославская область	Государственные, муниципальные (без учета организаций в ведении ФСИН); Очная	"    переведено в другие образовательные организации
    на программы того же уровня / 8.0"	65	0	0	4	69	0	0	0	0	0	175	0	60	119	354	8	0	0	15	23
Ярославская область	Государственные, муниципальные (без учета организаций в ведении ФСИН); Очная	"    переведено из других образовательных организаций 
    с программ того же уровня / 3.0"	97	0	0	5	102	0	0	0	0	0	133	0	16	37	186	8	0	0	5	13
Ярославская область	Государственные, муниципальные (без учета организаций в ведении ФСИН); Очная	    по болезни / 9.0	0	0	0	0	0	0	0	0	0	0	0	0	0	0	0	1	0	0	0	1
Ярославская область	Государственные, муниципальные (без учета организаций в ведении ФСИН); Очная	    прибыло по другим причинам / 5.0	21	0	0	0	21	3	0	0	4	7	66	0	3	40	109	32	0	0	23	55
Ярославская область	Государственные, муниципальные (без учета организаций в ведении ФСИН); Очная	Выбыло студентов - всего (сумма стр. 07-11, 13-15) / 6.0	835	0	0	78	913	56	0	0	8	64	1174	0	177	702	2053	313	0	13	217	543
Ярославская область	Государственные, муниципальные (без учета организаций в ведении ФСИН); Очная	Прибыло студентов - всего (сумма стр. 02-05) / 1.0	199	0	0	14	213	4	0	0	7	11	384	0	24	136	544	92	0	0	50	142
Ярославская область	Государственные, муниципальные (без учета организаций в ведении ФСИН); Очная	"Численность студентов на начало прошлого учебного года
(на 1 октября) / 17.0"	7664	0	0	307	7971	485	0	0	19	504	13052	0	2539	4074	19665	2311	0	123	1054	3488
Ярославская область	Очно-заочная; Государственные, муниципальные (без учета организаций в ведении ФСИН)	            из стр. 11 - не прошли итоговую аттестацию / 12.0	0	0	0	0	0	0	0	0	0	0	0	0	0	0	0	0	0	0	0	0
Ярославская область	Очно-заочная; Государственные, муниципальные (без учета организаций в ведении ФСИН)	"            из стр. 11 – лица с ограниченными возможностями здоровья,
            инвалиды, дети-инвалиды / 13.0"	0	0	0	0	0	0	0	0	0	0	0	0	0	0	0	0	0	0	0	0
Ярославская область	Очно-заочная; Государственные, муниципальные (без учета организаций в ведении ФСИН)	         отчислено в виде меры дисциплинарного взыскания / 14.0	0	0	0	0	0	0	0	0	0	0	0	0	0	0	0	0	0	0	0	0
Ярославская область	Очно-заочная; Государственные, муниципальные (без учета организаций в ведении ФСИН)	         отчислено из-за просрочки оплаты обучения / 15.0	0	0	0	0	0	0	0	0	0	0	0	0	0	0	0	0	0	0	0	0
Ярославская область	Очно-заочная; Государственные, муниципальные (без учета организаций в ведении ФСИН)	"    в том числе:
    переведено на другие формы обучения данной
    организации на программы того же уровня / 7.0"	0	0	0	0	0	0	0	0	0	0	0	0	4	0	4	1	0	0	0	1
Ярославская область	Очно-заочная; Государственные, муниципальные (без учета организаций в ведении ФСИН)	"    в том числе:
    переведено с других форм обучения данной
    образовательной организации с программ того же уровня / 2.0"	0	0	0	0	0	0	0	0	1	1	0	0	0	1	1	3	0	0	0	3
Ярославская область	Очно-заочная; Государственные, муниципальные (без учета организаций в ведении ФСИН)	    восстановлены из числа ранее отчисленных / 4.0	0	0	0	0	0	0	0	0	0	0	0	0	0	2	2	10	0	0	11	21
Ярославская область	Очно-заочная; Государственные, муниципальные (без учета организаций в ведении ФСИН)	    выбыло по другим причинам / 16.0	0	0	0	0	0	0	0	0	0	0	0	0	0	0	0	16	0	0	32	48
Ярославская область	Очно-заочная; Государственные, муниципальные (без учета организаций в ведении ФСИН)	"    добровольно прекратили образовательные отношения
    (бросили учебу) / 10.0"	0	0	0	0	0	11	0	0	9	20	0	0	3	2	5	10	0	0	10	20
Ярославская область	Очно-заочная; Государственные, муниципальные (без учета организаций в ведении ФСИН)	"    отчислено:
         по неуспеваемости / 11.0"	0	0	0	0	0	0	0	0	8	8	0	0	2	3	5	0	0	0	4	4
Ярославская область	Очно-заочная; Государственные, муниципальные (без учета организаций в ведении ФСИН)	"    переведено в другие образовательные организации
    на программы того же уровня / 8.0"	0	0	0	0	0	0	0	0	0	0	0	0	0	0	0	0	0	0	0	0
Ярославская область	Очно-заочная; Государственные, муниципальные (без учета организаций в ведении ФСИН)	"    переведено из других образовательных организаций 
    с программ того же уровня / 3.0"	0	0	0	0	0	0	0	0	0	0	0	0	0	0	0	0	0	0	0	0
Ярославская область	Очно-заочная; Государственные, муниципальные (без учета организаций в ведении ФСИН)	    по болезни / 9.0	0	0	0	0	0	0	0	0	0	0	0	0	0	0	0	0	0	0	0	0
Ярославская область	Очно-заочная; Государственные, муниципальные (без учета организаций в ведении ФСИН)	    прибыло по другим причинам / 5.0	0	0	0	0	0	6	0	0	5	11	0	0	0	0	0	0	0	0	5	5
Ярославская область	Очно-заочная; Государственные, муниципальные (без учета организаций в ведении ФСИН)	Выбыло студентов - всего (сумма стр. 07-11, 13-15) / 6.0	0	0	0	0	0	11	0	0	17	28	0	0	9	5	14	27	0	0	46	73
Ярославская область	Очно-заочная; Государственные, муниципальные (без учета организаций в ведении ФСИН)	Прибыло студентов - всего (сумма стр. 02-05) / 1.0	0	0	0	0	0	6	0	0	6	12	0	0	0	3	3	13	0	0	16	29
Ярославская область	Очно-заочная; Государственные, муниципальные (без учета организаций в ведении ФСИН)	"Численность студентов на начало прошлого учебного года
(на 1 октября) / 17.0"	0	0	0	0	0	171	0	0	7	178	0	0	25	16	41	255	0	0	130	385
Ярославская область	Частные; Заочная	            из стр. 11 - не прошли итоговую аттестацию / 12.0	0	0	0	0	0	0	0	0	0	0	0	0	0	1	1	0	0	0	2	2
Ярославская область	Частные; Заочная	"            из стр. 11 – лица с ограниченными возможностями здоровья,
            инвалиды, дети-инвалиды / 13.0"	0	0	0	0	0	0	0	0	0	0	0	0	0	0	0	0	0	0	0	0
Ярославская область	Частные; Заочная	         отчислено в виде меры дисциплинарного взыскания / 14.0	0	0	0	0	0	0	0	0	0	0	0	0	0	0	0	0	0	0	0	0
Ярославская область	Частные; Заочная	         отчислено из-за просрочки оплаты обучения / 15.0	0	0	0	0	0	0	0	0	0	0	0	0	0	31	31	0	0	0	10	10
Ярославская область	Частные; Заочная	"    в том числе:
    переведено на другие формы обучения данной
    организации на программы того же уровня / 7.0"	0	0	0	0	0	0	0	0	0	0	0	0	0	1	1	0	0	0	0	0
Ярославская область	Частные; Заочная	"    в том числе:
    переведено с других форм обучения данной
    образовательной организации с программ того же уровня / 2.0"	0	0	0	0	0	0	0	0	0	0	0	0	0	15	15	0	0	0	0	0
Ярославская область	Частные; Заочная	    восстановлены из числа ранее отчисленных / 4.0	0	0	0	0	0	0	0	0	0	0	0	0	0	10	10	0	0	0	6	6
Ярославская область	Частные; Заочная	    выбыло по другим причинам / 16.0	0	0	0	0	0	0	0	0	0	0	0	0	0	0	0	0	0	0	0	0
Ярославская область	Частные; Заочная	"    добровольно прекратили образовательные отношения
    (бросили учебу) / 10.0"	0	0	0	0	0	0	0	0	0	0	0	0	0	15	15	0	0	0	8	8
Ярославская область	Частные; Заочная	"    отчислено:
         по неуспеваемости / 11.0"	0	0	0	0	0	0	0	0	0	0	0	0	0	5	5	0	0	0	4	4
Ярославская область	Частные; Заочная	"    переведено в другие образовательные организации
    на программы того же уровня / 8.0"	0	0	0	0	0	0	0	0	0	0	0	0	0	2	2	0	0	0	0	0
Ярославская область	Частные; Заочная	"    переведено из других образовательных организаций 
    с программ того же уровня / 3.0"	0	0	0	0	0	0	0	0	0	0	0	0	0	15	15	0	0	0	3	3
Ярославская область	Частные; Заочная	    по болезни / 9.0	0	0	0	0	0	0	0	0	0	0	0	0	0	0	0	0	0	0	0	0
Ярославская область	Частные; Заочная	    прибыло по другим причинам / 5.0	0	0	0	0	0	0	0	0	0	0	0	0	0	4	4	0	0	0	4	4
Ярославская область	Частные; Заочная	Выбыло студентов - всего (сумма стр. 07-11, 13-15) / 6.0	0	0	0	0	0	0	0	0	0	0	0	0	0	54	54	0	0	0	22	22
Ярославская область	Частные; Заочная	Прибыло студентов - всего (сумма стр. 02-05) / 1.0	0	0	0	0	0	0	0	0	0	0	0	0	0	44	44	0	0	0	13	13
Ярославская область	Частные; Заочная	"Численность студентов на начало прошлого учебного года
(на 1 октября) / 17.0"	0	0	0	0	0	0	0	0	0	0	0	0	0	161	161	0	0	0	88	88
Ярославская область	Частные; Очная	            из стр. 11 - не прошли итоговую аттестацию / 12.0	0	0	0	0	0	0	0	0	0	0	0	0	0	4	4	0	0	0	2	2
Ярославская область	Частные; Очная	"            из стр. 11 – лица с ограниченными возможностями здоровья,
            инвалиды, дети-инвалиды / 13.0"	0	0	0	0	0	0	0	0	0	0	0	0	0	0	0	0	0	0	0	0
Ярославская область	Частные; Очная	         отчислено в виде меры дисциплинарного взыскания / 14.0	0	0	0	0	0	0	0	0	0	0	0	0	0	0	0	0	0	0	0	0
Ярославская область	Частные; Очная	         отчислено из-за просрочки оплаты обучения / 15.0	0	0	0	0	0	0	0	0	0	0	0	0	0	24	24	0	0	0	4	4
Ярославская область	Частные; Очная	"    в том числе:
    переведено на другие формы обучения данной
    организации на программы того же уровня / 7.0"	0	0	0	0	0	0	0	0	0	0	2	0	0	15	17	0	0	0	0	0
Ярославская область	Частные; Очная	"    в том числе:
    переведено с других форм обучения данной
    образовательной организации с программ того же уровня / 2.0"	0	0	0	0	0	0	0	0	0	0	0	0	0	1	1	0	0	0	0	0
Ярославская область	Частные; Очная	    восстановлены из числа ранее отчисленных / 4.0	0	0	0	0	0	0	0	0	0	0	0	0	0	6	6	0	0	0	1	1
Ярославская область	Частные; Очная	    выбыло по другим причинам / 16.0	0	0	0	0	0	0	0	0	0	0	0	0	0	1	1	0	0	0	0	0
Ярославская область	Частные; Очная	"    добровольно прекратили образовательные отношения
    (бросили учебу) / 10.0"	0	0	0	0	0	0	0	0	0	0	5	0	0	48	53	1	0	0	9	10
Ярославская область	Частные; Очная	"    отчислено:
         по неуспеваемости / 11.0"	0	0	0	0	0	0	0	0	0	0	5	0	0	21	26	1	0	0	4	5
Ярославская область	Частные; Очная	"    переведено в другие образовательные организации
    на программы того же уровня / 8.0"	0	0	0	0	0	0	0	0	0	0	2	0	0	6	8	0	0	0	1	1
Ярославская область	Частные; Очная	"    переведено из других образовательных организаций 
    с программ того же уровня / 3.0"	0	0	0	0	0	0	0	0	0	0	1	0	0	34	35	0	0	0	1	1
Ярославская область	Частные; Очная	    по болезни / 9.0	0	0	0	0	0	0	0	0	0	0	0	0	0	0	0	0	0	0	0	0
Ярославская область	Частные; Очная	    прибыло по другим причинам / 5.0	0	0	0	0	0	0	0	0	0	0	0	0	0	2	2	0	0	0	1	1
Ярославская область	Частные; Очная	Выбыло студентов - всего (сумма стр. 07-11, 13-15) / 6.0	0	0	0	0	0	0	0	0	0	0	14	0	0	115	129	2	0	0	18	20
Ярославская область	Частные; Очная	Прибыло студентов - всего (сумма стр. 02-05) / 1.0	0	0	0	0	0	0	0	0	0	0	1	0	0	43	44	0	0	0	3	3
Ярославская область	Частные; Очная	"Численность студентов на начало прошлого учебного года
(на 1 октября) / 17.0"	0	0	0	0	0	0	0	0	0	0	144	0	0	594	738	24	0	0	129	153
г.Москва	Государственные, муниципальные (без учета организаций в ведении ФСИН); Заочная	            из стр. 11 - не прошли итоговую аттестацию / 12.0	0	0	0	0	0	0	0	0	0	0	0	0	0	0	0	0	0	0	6	6
г.Москва	Государственные, муниципальные (без учета организаций в ведении ФСИН); Заочная	"            из стр. 11 – лица с ограниченными возможностями здоровья,
            инвалиды, дети-инвалиды / 13.0"	0	0	0	0	0	0	0	0	0	0	0	0	0	0	0	0	0	0	1	1
г.Москва	Государственные, муниципальные (без учета организаций в ведении ФСИН); Заочная	         отчислено в виде меры дисциплинарного взыскания / 14.0	0	0	0	0	0	0	0	0	0	0	0	0	0	0	0	0	0	0	0	0
г.Москва	Государственные, муниципальные (без учета организаций в ведении ФСИН); Заочная	         отчислено из-за просрочки оплаты обучения / 15.0	0	0	0	0	0	0	0	0	0	0	0	0	0	87	87	0	0	0	146	146
г.Москва	Государственные, муниципальные (без учета организаций в ведении ФСИН); Заочная	"    в том числе:
    переведено на другие формы обучения данной
    организации на программы того же уровня / 7.0"	0	0	0	0	0	0	0	0	3	3	0	0	0	17	17	0	0	0	7	7
г.Москва	Государственные, муниципальные (без учета организаций в ведении ФСИН); Заочная	"    в том числе:
    переведено с других форм обучения данной
    образовательной организации с программ того же уровня / 2.0"	0	0	0	0	0	0	0	0	0	0	0	0	0	110	110	0	0	0	56	56
г.Москва	Государственные, муниципальные (без учета организаций в ведении ФСИН); Заочная	    восстановлены из числа ранее отчисленных / 4.0	0	0	0	0	0	0	0	0	0	0	0	0	0	85	85	0	0	0	25	25
г.Москва	Государственные, муниципальные (без учета организаций в ведении ФСИН); Заочная	    выбыло по другим причинам / 16.0	0	0	0	0	0	0	0	0	0	0	0	0	0	30	30	1	0	1	172	174
г.Москва	Государственные, муниципальные (без учета организаций в ведении ФСИН); Заочная	"    добровольно прекратили образовательные отношения
    (бросили учебу) / 10.0"	0	0	0	0	0	0	0	0	0	0	0	0	27	120	147	0	0	50	216	266
г.Москва	Государственные, муниципальные (без учета организаций в ведении ФСИН); Заочная	"    отчислено:
         по неуспеваемости / 11.0"	0	0	0	0	0	0	0	0	0	0	0	0	7	18	25	0	0	10	98	108
г.Москва	Государственные, муниципальные (без учета организаций в ведении ФСИН); Заочная	"    переведено в другие образовательные организации
    на программы того же уровня / 8.0"	0	0	0	0	0	0	0	0	0	0	0	0	0	48	48	0	0	0	79	79
г.Москва	Государственные, муниципальные (без учета организаций в ведении ФСИН); Заочная	"    переведено из других образовательных организаций 
    с программ того же уровня / 3.0"	0	0	0	0	0	0	0	0	0	0	0	0	1	95	96	0	0	0	44	44
г.Москва	Государственные, муниципальные (без учета организаций в ведении ФСИН); Заочная	    по болезни / 9.0	0	0	0	0	0	0	0	0	0	0	0	0	0	0	0	0	0	0	0	0
г.Москва	Государственные, муниципальные (без учета организаций в ведении ФСИН); Заочная	    прибыло по другим причинам / 5.0	0	0	0	0	0	0	0	0	0	0	0	0	0	45	45	3	0	0	82	85
г.Москва	Государственные, муниципальные (без учета организаций в ведении ФСИН); Заочная	Выбыло студентов - всего (сумма стр. 07-11, 13-15) / 6.0	0	0	0	0	0	0	0	0	3	3	0	0	34	320	354	1	0	61	718	780
г.Москва	Государственные, муниципальные (без учета организаций в ведении ФСИН); Заочная	Прибыло студентов - всего (сумма стр. 02-05) / 1.0	0	0	0	0	0	0	0	0	0	0	0	0	1	335	336	3	0	0	207	210
г.Москва	Государственные, муниципальные (без учета организаций в ведении ФСИН); Заочная	"Численность студентов на начало прошлого учебного года
(на 1 октября) / 17.0"	0	0	0	0	0	0	0	0	3	3	0	0	201	1331	1532	18	0	400	3334	3752
г.Москва	Государственные, муниципальные (без учета организаций в ведении ФСИН); Очная	            из стр. 11 - не прошли итоговую аттестацию / 12.0	9	0	0	0	9	4	0	0	0	4	9	0	9	23	41	6	0	0	12	18
г.Москва	Государственные, муниципальные (без учета организаций в ведении ФСИН); Очная	"            из стр. 11 – лица с ограниченными возможностями здоровья,
            инвалиды, дети-инвалиды / 13.0"	5	0	0	0	5	0	0	0	0	0	4	0	3	3	10	1	0	0	0	1
г.Москва	Государственные, муниципальные (без учета организаций в ведении ФСИН); Очная	         отчислено в виде меры дисциплинарного взыскания / 14.0	5	0	0	1	6	3	0	0	4	7	14	0	5	24	43	7	0	3	9	19
г.Москва	Государственные, муниципальные (без учета организаций в ведении ФСИН); Очная	         отчислено из-за просрочки оплаты обучения / 15.0	0	0	0	14	14	0	0	0	4	4	0	0	0	260	260	0	0	0	98	98
г.Москва	Государственные, муниципальные (без учета организаций в ведении ФСИН); Очная	"    в том числе:
    переведено на другие формы обучения данной
    организации на программы того же уровня / 7.0"	39	0	0	47	86	6	0	0	2	8	98	0	7	410	515	75	0	9	96	180
г.Москва	Государственные, муниципальные (без учета организаций в ведении ФСИН); Очная	"    в том числе:
    переведено с других форм обучения данной
    образовательной организации с программ того же уровня / 2.0"	71	0	0	23	94	6	0	0	1	7	201	0	109	82	392	51	0	4	18	73
г.Москва	Государственные, муниципальные (без учета организаций в ведении ФСИН); Очная	    восстановлены из числа ранее отчисленных / 4.0	33	0	0	6	39	3	0	0	6	9	55	1	25	297	378	45	0	3	97	145
г.Москва	Государственные, муниципальные (без учета организаций в ведении ФСИН); Очная	    выбыло по другим причинам / 16.0	281	0	0	106	387	89	0	0	22	111	600	0	136	718	1454	237	0	17	279	533
г.Москва	Государственные, муниципальные (без учета организаций в ведении ФСИН); Очная	"    добровольно прекратили образовательные отношения
    (бросили учебу) / 10.0"	809	0	0	194	1003	233	0	0	50	283	1295	4	465	1941	3705	729	3	104	789	1625
г.Москва	Государственные, муниципальные (без учета организаций в ведении ФСИН); Очная	"    отчислено:
         по неуспеваемости / 11.0"	188	0	0	6	194	41	0	0	1	42	279	1	129	463	872	201	0	21	177	399
г.Москва	Государственные, муниципальные (без учета организаций в ведении ФСИН); Очная	"    переведено в другие образовательные организации
    на программы того же уровня / 8.0"	582	0	0	75	657	50	0	0	4	54	2110	4	159	1561	3834	530	0	4	164	698
г.Москва	Государственные, муниципальные (без учета организаций в ведении ФСИН); Очная	"    переведено из других образовательных организаций 
    с программ того же уровня / 3.0"	415	0	0	30	445	13	0	0	7	20	1556	2	279	902	2739	405	0	7	91	503
г.Москва	Государственные, муниципальные (без учета организаций в ведении ФСИН); Очная	    по болезни / 9.0	2	0	0	1	3	0	0	0	0	0	6	0	2	19	27	2	0	0	4	6
г.Москва	Государственные, муниципальные (без учета организаций в ведении ФСИН); Очная	    прибыло по другим причинам / 5.0	272	0	0	65	337	94	0	0	13	107	864	0	33	397	1294	233	0	21	103	357
г.Москва	Государственные, муниципальные (без учета организаций в ведении ФСИН); Очная	Выбыло студентов - всего (сумма стр. 07-11, 13-15) / 6.0	1906	0	0	444	2350	422	0	0	87	509	4402	9	903	5396	10710	1781	3	158	1616	3558
г.Москва	Государственные, муниципальные (без учета организаций в ведении ФСИН); Очная	Прибыло студентов - всего (сумма стр. 02-05) / 1.0	791	0	0	124	915	116	0	0	27	143	2676	3	446	1678	4803	734	0	35	309	1078
г.Москва	Государственные, муниципальные (без учета организаций в ведении ФСИН); Очная	"Численность студентов на начало прошлого учебного года
(на 1 октября) / 17.0"	13818	0	0	2950	16768	1753	0	0	465	2218	43929	131	15452	43330	102842	13156	50	1412	9988	24606
г.Москва	Очно-заочная; Государственные, муниципальные (без учета организаций в ведении ФСИН)	            из стр. 11 - не прошли итоговую аттестацию / 12.0	0	0	0	0	0	0	0	0	0	0	0	0	0	0	0	0	0	0	3	3
г.Москва	Очно-заочная; Государственные, муниципальные (без учета организаций в ведении ФСИН)	"            из стр. 11 – лица с ограниченными возможностями здоровья,
            инвалиды, дети-инвалиды / 13.0"	0	0	0	0	0	0	0	0	0	0	0	0	0	0	0	0	0	0	0	0
г.Москва	Очно-заочная; Государственные, муниципальные (без учета организаций в ведении ФСИН)	         отчислено в виде меры дисциплинарного взыскания / 14.0	0	0	0	0	0	0	0	0	0	0	0	0	0	1	1	0	0	0	9	9
г.Москва	Очно-заочная; Государственные, муниципальные (без учета организаций в ведении ФСИН)	         отчислено из-за просрочки оплаты обучения / 15.0	0	0	0	5	5	0	0	0	1	1	0	0	0	45	45	0	0	0	140	140
г.Москва	Очно-заочная; Государственные, муниципальные (без учета организаций в ведении ФСИН)	"    в том числе:
    переведено на другие формы обучения данной
    организации на программы того же уровня / 7.0"	0	0	0	0	0	0	0	0	0	0	0	0	0	2	2	0	0	0	10	10
г.Москва	Очно-заочная; Государственные, муниципальные (без учета организаций в ведении ФСИН)	"    в том числе:
    переведено с других форм обучения данной
    образовательной организации с программ того же уровня / 2.0"	0	0	0	0	0	0	0	0	0	0	0	0	0	10	10	0	0	0	49	49
г.Москва	Очно-заочная; Государственные, муниципальные (без учета организаций в ведении ФСИН)	    восстановлены из числа ранее отчисленных / 4.0	0	0	0	2	2	0	0	0	0	0	0	0	0	13	13	0	0	0	23	23
г.Москва	Очно-заочная; Государственные, муниципальные (без учета организаций в ведении ФСИН)	    выбыло по другим причинам / 16.0	0	0	0	66	66	0	0	0	0	0	0	0	0	18	18	2	0	0	76	78
г.Москва	Очно-заочная; Государственные, муниципальные (без учета организаций в ведении ФСИН)	"    добровольно прекратили образовательные отношения
    (бросили учебу) / 10.0"	0	0	0	10	10	0	0	0	0	0	0	0	0	54	54	10	0	0	434	444
г.Москва	Очно-заочная; Государственные, муниципальные (без учета организаций в ведении ФСИН)	"    отчислено:
         по неуспеваемости / 11.0"	0	0	0	0	0	0	0	0	0	0	0	0	0	4	4	2	0	0	37	39
г.Москва	Очно-заочная; Государственные, муниципальные (без учета организаций в ведении ФСИН)	"    переведено в другие образовательные организации
    на программы того же уровня / 8.0"	0	0	0	0	0	0	0	0	0	0	0	0	0	63	63	1	0	0	65	66
г.Москва	Очно-заочная; Государственные, муниципальные (без учета организаций в ведении ФСИН)	"    переведено из других образовательных организаций 
    с программ того же уровня / 3.0"	0	0	0	7	7	0	0	0	0	0	0	0	0	71	71	0	0	0	50	50
г.Москва	Очно-заочная; Государственные, муниципальные (без учета организаций в ведении ФСИН)	    по болезни / 9.0	0	0	0	0	0	0	0	0	0	0	0	0	0	1	1	0	0	0	0	0
г.Москва	Очно-заочная; Государственные, муниципальные (без учета организаций в ведении ФСИН)	    прибыло по другим причинам / 5.0	0	0	0	55	55	0	0	0	0	0	0	0	0	20	20	2	0	0	90	92
г.Москва	Очно-заочная; Государственные, муниципальные (без учета организаций в ведении ФСИН)	Выбыло студентов - всего (сумма стр. 07-11, 13-15) / 6.0	0	0	0	81	81	0	0	0	1	1	0	0	0	188	188	15	0	0	771	786
г.Москва	Очно-заочная; Государственные, муниципальные (без учета организаций в ведении ФСИН)	Прибыло студентов - всего (сумма стр. 02-05) / 1.0	0	0	0	64	64	0	0	0	0	0	0	0	0	114	114	2	0	0	212	214
г.Москва	Очно-заочная; Государственные, муниципальные (без учета организаций в ведении ФСИН)	"Численность студентов на начало прошлого учебного года
(на 1 октября) / 17.0"	0	0	0	151	151	0	0	0	11	11	0	0	0	689	689	75	0	0	3454	3529
г.Москва	Частные; Заочная	            из стр. 11 - не прошли итоговую аттестацию / 12.0	0	0	0	0	0	0	0	0	0	0	0	0	0	27	27	0	0	0	49	49
г.Москва	Частные; Заочная	"            из стр. 11 – лица с ограниченными возможностями здоровья,
            инвалиды, дети-инвалиды / 13.0"	0	0	0	0	0	0	0	0	0	0	0	0	0	0	0	0	0	0	0	0
г.Москва	Частные; Заочная	         отчислено в виде меры дисциплинарного взыскания / 14.0	0	0	0	0	0	0	0	0	0	0	0	0	0	0	0	0	0	0	0	0
г.Москва	Частные; Заочная	         отчислено из-за просрочки оплаты обучения / 15.0	0	0	0	0	0	0	0	0	0	0	0	0	0	754	754	0	0	0	692	692
г.Москва	Частные; Заочная	"    в том числе:
    переведено на другие формы обучения данной
    организации на программы того же уровня / 7.0"	0	0	0	0	0	0	0	0	0	0	0	0	0	305	305	0	0	0	552	552
г.Москва	Частные; Заочная	"    в том числе:
    переведено с других форм обучения данной
    образовательной организации с программ того же уровня / 2.0"	0	0	0	0	0	0	0	0	0	0	0	0	0	1235	1235	0	0	0	919	919
г.Москва	Частные; Заочная	    восстановлены из числа ранее отчисленных / 4.0	0	0	0	0	0	0	0	0	0	0	0	0	0	1641	1641	0	0	0	1487	1487
г.Москва	Частные; Заочная	    выбыло по другим причинам / 16.0	0	0	0	0	0	0	0	0	0	0	0	0	0	386	386	0	0	0	584	584
г.Москва	Частные; Заочная	"    добровольно прекратили образовательные отношения
    (бросили учебу) / 10.0"	0	0	0	0	0	0	0	0	0	0	0	0	0	1041	1041	0	0	0	868	868
г.Москва	Частные; Заочная	"    отчислено:
         по неуспеваемости / 11.0"	0	0	0	0	0	0	0	0	0	0	0	0	0	622	622	0	0	0	504	504
г.Москва	Частные; Заочная	"    переведено в другие образовательные организации
    на программы того же уровня / 8.0"	0	0	0	0	0	0	0	0	0	0	0	0	0	208	208	0	0	0	227	227
г.Москва	Частные; Заочная	"    переведено из других образовательных организаций 
    с программ того же уровня / 3.0"	0	0	0	0	0	0	0	0	0	0	0	0	0	1726	1726	0	0	0	1177	1177
г.Москва	Частные; Заочная	    по болезни / 9.0	0	0	0	0	0	0	0	0	0	0	0	0	0	2	2	0	0	0	9	9
г.Москва	Частные; Заочная	    прибыло по другим причинам / 5.0	0	0	0	0	0	0	0	0	0	0	0	0	0	3459	3459	0	0	0	2465	2465
г.Москва	Частные; Заочная	Выбыло студентов - всего (сумма стр. 07-11, 13-15) / 6.0	0	0	0	0	0	0	0	0	0	0	0	0	0	3318	3318	0	0	0	3436	3436
г.Москва	Частные; Заочная	Прибыло студентов - всего (сумма стр. 02-05) / 1.0	0	0	0	0	0	0	0	0	0	0	0	0	0	8061	8061	0	0	0	6048	6048
г.Москва	Частные; Заочная	"Численность студентов на начало прошлого учебного года
(на 1 октября) / 17.0"	0	0	0	10	10	0	0	0	0	0	0	0	0	15149	15149	0	2	0	10665	10667
г.Москва	Частные; Очная	            из стр. 11 - не прошли итоговую аттестацию / 12.0	0	0	0	0	0	0	0	0	4	4	0	0	0	28	28	0	0	0	9	9
г.Москва	Частные; Очная	"            из стр. 11 – лица с ограниченными возможностями здоровья,
            инвалиды, дети-инвалиды / 13.0"	0	0	0	0	0	0	0	0	0	0	0	0	0	0	0	0	0	0	0	0
г.Москва	Частные; Очная	         отчислено в виде меры дисциплинарного взыскания / 14.0	0	0	0	0	0	0	0	0	0	0	0	0	0	11	11	0	0	0	0	0
г.Москва	Частные; Очная	         отчислено из-за просрочки оплаты обучения / 15.0	0	0	0	2	2	0	0	0	14	14	0	0	0	685	685	0	0	0	176	176
г.Москва	Частные; Очная	"    в том числе:
    переведено на другие формы обучения данной
    организации на программы того же уровня / 7.0"	0	0	0	0	0	0	0	0	0	0	0	0	0	1084	1084	0	0	0	623	623
г.Москва	Частные; Очная	"    в том числе:
    переведено с других форм обучения данной
    образовательной организации с программ того же уровня / 2.0"	0	0	0	1	1	0	0	0	0	0	0	0	0	125	125	0	0	0	47	47
г.Москва	Частные; Очная	    восстановлены из числа ранее отчисленных / 4.0	0	0	0	0	0	0	0	0	0	0	0	0	0	241	241	0	0	0	102	102
г.Москва	Частные; Очная	    выбыло по другим причинам / 16.0	0	0	0	0	0	0	0	0	30	30	0	0	8	1395	1403	0	0	0	1232	1232
г.Москва	Частные; Очная	"    добровольно прекратили образовательные отношения
    (бросили учебу) / 10.0"	0	0	0	1	1	0	0	0	11	11	0	0	9	1589	1598	0	0	4	893	897
г.Москва	Частные; Очная	"    отчислено:
         по неуспеваемости / 11.0"	0	0	0	0	0	0	0	0	8	8	0	0	2	443	445	0	0	0	158	158
г.Москва	Частные; Очная	"    переведено в другие образовательные организации
    на программы того же уровня / 8.0"	0	0	0	0	0	0	0	0	20	20	0	0	0	927	927	0	0	0	306	306
г.Москва	Частные; Очная	"    переведено из других образовательных организаций 
    с программ того же уровня / 3.0"	0	0	0	0	0	0	0	0	42	42	0	0	0	793	793	0	0	0	270	270
г.Москва	Частные; Очная	    по болезни / 9.0	0	0	0	0	0	0	0	0	0	0	0	0	0	5	5	0	0	0	0	0
г.Москва	Частные; Очная	    прибыло по другим причинам / 5.0	0	0	0	0	0	0	0	0	55	55	0	0	11	3047	3058	0	0	0	2362	2362
г.Москва	Частные; Очная	Выбыло студентов - всего (сумма стр. 07-11, 13-15) / 6.0	0	0	0	3	3	0	0	0	83	83	0	0	19	6139	6158	0	0	4	3388	3392
г.Москва	Частные; Очная	Прибыло студентов - всего (сумма стр. 02-05) / 1.0	0	0	0	1	1	0	0	0	97	97	0	0	11	4206	4217	0	0	0	2781	2781
г.Москва	Частные; Очная	"Численность студентов на начало прошлого учебного года
(на 1 октября) / 17.0"	0	0	0	57	57	0	0	0	780	780	0	0	414	26282	26696	0	0	23	6682	6705
г.Москва	Частные; Очно-заочная	            из стр. 11 - не прошли итоговую аттестацию / 12.0	0	0	0	0	0	0	0	0	3	3	0	0	0	0	0	0	0	0	1	1
г.Москва	Частные; Очно-заочная	"            из стр. 11 – лица с ограниченными возможностями здоровья,
            инвалиды, дети-инвалиды / 13.0"	0	0	0	0	0	0	0	0	0	0	0	0	0	0	0	0	0	0	0	0
г.Москва	Частные; Очно-заочная	         отчислено в виде меры дисциплинарного взыскания / 14.0	0	0	0	0	0	0	0	0	0	0	0	0	0	1	1	0	0	0	0	0
г.Москва	Частные; Очно-заочная	         отчислено из-за просрочки оплаты обучения / 15.0	0	0	0	6	6	0	0	0	228	228	0	0	0	459	459	0	0	0	524	524
г.Москва	Частные; Очно-заочная	"    в том числе:
    переведено на другие формы обучения данной
    организации на программы того же уровня / 7.0"	0	0	0	0	0	0	0	0	0	0	0	0	0	422	422	0	0	0	855	855
г.Москва	Частные; Очно-заочная	"    в том числе:
    переведено с других форм обучения данной
    образовательной организации с программ того же уровня / 2.0"	0	0	0	0	0	0	0	0	0	0	0	0	0	74	74	0	0	0	330	330
г.Москва	Частные; Очно-заочная	    восстановлены из числа ранее отчисленных / 4.0	0	0	0	0	0	0	0	0	1	1	0	0	0	65	65	0	0	0	79	79
г.Москва	Частные; Очно-заочная	    выбыло по другим причинам / 16.0	0	0	0	0	0	0	0	0	469	469	0	0	0	319	319	0	0	0	359	359
г.Москва	Частные; Очно-заочная	"    добровольно прекратили образовательные отношения
    (бросили учебу) / 10.0"	0	0	0	2	2	0	0	0	349	349	0	0	0	1092	1092	0	0	0	1017	1017
г.Москва	Частные; Очно-заочная	"    отчислено:
         по неуспеваемости / 11.0"	0	0	0	0	0	0	0	0	107	107	0	0	0	582	582	0	0	0	430	430
г.Москва	Частные; Очно-заочная	"    переведено в другие образовательные организации
    на программы того же уровня / 8.0"	0	0	0	8	8	0	0	0	0	0	0	0	0	357	357	0	0	0	274	274
г.Москва	Частные; Очно-заочная	"    переведено из других образовательных организаций 
    с программ того же уровня / 3.0"	0	0	0	3	3	0	0	0	2	2	0	0	0	280	280	0	0	0	160	160
г.Москва	Частные; Очно-заочная	    по болезни / 9.0	0	0	0	9	9	0	0	0	1	1	0	0	0	0	0	0	0	0	39	39
г.Москва	Частные; Очно-заочная	    прибыло по другим причинам / 5.0	0	0	0	0	0	0	0	0	1674	1674	0	0	0	3192	3192	0	0	0	2750	2750
г.Москва	Частные; Очно-заочная	Выбыло студентов - всего (сумма стр. 07-11, 13-15) / 6.0	0	0	0	25	25	0	0	0	1154	1154	0	0	0	3232	3232	0	0	0	3498	3498
г.Москва	Частные; Очно-заочная	Прибыло студентов - всего (сумма стр. 02-05) / 1.0	0	0	0	3	3	0	0	0	1677	1677	0	0	0	3611	3611	0	0	0	3319	3319
г.Москва	Частные; Очно-заочная	"Численность студентов на начало прошлого учебного года
(на 1 октября) / 17.0"	0	0	0	55	55	0	0	0	77	77	0	0	0	2201	2201	0	0	0	2525	2525
г.Санкт-Петербург	Государственные, муниципальные (без учета организаций в ведении ФСИН); Заочная	            из стр. 11 - не прошли итоговую аттестацию / 12.0	0	0	0	0	0	0	0	0	0	0	0	0	0	0	0	4	0	0	3	7
г.Санкт-Петербург	Государственные, муниципальные (без учета организаций в ведении ФСИН); Заочная	"            из стр. 11 – лица с ограниченными возможностями здоровья,
            инвалиды, дети-инвалиды / 13.0"	0	0	0	0	0	0	0	0	0	0	0	0	0	0	0	0	0	0	0	0
г.Санкт-Петербург	Государственные, муниципальные (без учета организаций в ведении ФСИН); Заочная	         отчислено в виде меры дисциплинарного взыскания / 14.0	0	0	0	0	0	0	0	0	0	0	0	0	0	4	4	0	0	0	3	3
г.Санкт-Петербург	Государственные, муниципальные (без учета организаций в ведении ФСИН); Заочная	         отчислено из-за просрочки оплаты обучения / 15.0	0	0	0	0	0	0	0	0	0	0	0	0	0	250	250	0	0	0	243	243
г.Санкт-Петербург	Государственные, муниципальные (без учета организаций в ведении ФСИН); Заочная	"    в том числе:
    переведено на другие формы обучения данной
    организации на программы того же уровня / 7.0"	0	0	0	0	0	0	0	0	0	0	0	0	0	9	9	0	0	3	14	17
г.Санкт-Петербург	Государственные, муниципальные (без учета организаций в ведении ФСИН); Заочная	"    в том числе:
    переведено с других форм обучения данной
    образовательной организации с программ того же уровня / 2.0"	0	0	0	0	0	0	0	0	0	0	0	0	0	71	71	16	0	0	58	74
г.Санкт-Петербург	Государственные, муниципальные (без учета организаций в ведении ФСИН); Заочная	    восстановлены из числа ранее отчисленных / 4.0	0	0	0	0	0	0	0	0	0	0	0	0	0	60	60	48	0	4	85	137
г.Санкт-Петербург	Государственные, муниципальные (без учета организаций в ведении ФСИН); Заочная	    выбыло по другим причинам / 16.0	0	0	0	0	0	0	0	0	0	0	0	0	0	14	14	5	0	1	109	115
г.Санкт-Петербург	Государственные, муниципальные (без учета организаций в ведении ФСИН); Заочная	"    добровольно прекратили образовательные отношения
    (бросили учебу) / 10.0"	0	0	0	0	0	0	0	0	0	0	0	0	0	127	127	86	0	23	322	431
г.Санкт-Петербург	Государственные, муниципальные (без учета организаций в ведении ФСИН); Заочная	"    отчислено:
         по неуспеваемости / 11.0"	0	0	0	0	0	0	0	0	0	0	0	0	0	70	70	92	0	26	161	279
г.Санкт-Петербург	Государственные, муниципальные (без учета организаций в ведении ФСИН); Заочная	"    переведено в другие образовательные организации
    на программы того же уровня / 8.0"	0	0	0	0	0	0	0	0	0	0	0	0	0	9	9	0	0	0	12	12
г.Санкт-Петербург	Государственные, муниципальные (без учета организаций в ведении ФСИН); Заочная	"    переведено из других образовательных организаций 
    с программ того же уровня / 3.0"	0	0	0	0	0	0	0	0	0	0	0	0	0	27	27	0	0	0	13	13
г.Санкт-Петербург	Государственные, муниципальные (без учета организаций в ведении ФСИН); Заочная	    по болезни / 9.0	0	0	0	0	0	0	0	0	0	0	0	0	0	0	0	0	0	0	0	0
г.Санкт-Петербург	Государственные, муниципальные (без учета организаций в ведении ФСИН); Заочная	    прибыло по другим причинам / 5.0	0	0	0	0	0	0	0	0	0	0	0	0	0	63	63	40	0	6	51	97
г.Санкт-Петербург	Государственные, муниципальные (без учета организаций в ведении ФСИН); Заочная	Выбыло студентов - всего (сумма стр. 07-11, 13-15) / 6.0	0	0	0	0	0	0	0	0	0	0	0	0	0	483	483	183	0	53	864	1100
г.Санкт-Петербург	Государственные, муниципальные (без учета организаций в ведении ФСИН); Заочная	Прибыло студентов - всего (сумма стр. 02-05) / 1.0	0	0	0	0	0	0	0	0	0	0	0	0	0	221	221	104	0	10	207	321
г.Санкт-Петербург	Государственные, муниципальные (без учета организаций в ведении ФСИН); Заочная	"Численность студентов на начало прошлого учебного года
(на 1 октября) / 17.0"	0	0	0	0	0	0	0	0	0	0	0	0	0	1972	1972	757	0	553	4142	5452
г.Санкт-Петербург	Государственные, муниципальные (без учета организаций в ведении ФСИН); Очная	            из стр. 11 - не прошли итоговую аттестацию / 12.0	3	0	0	0	3	2	0	0	0	2	23	0	1	11	35	9	0	0	7	16
г.Санкт-Петербург	Государственные, муниципальные (без учета организаций в ведении ФСИН); Очная	"            из стр. 11 – лица с ограниченными возможностями здоровья,
            инвалиды, дети-инвалиды / 13.0"	1	0	0	0	1	12	0	0	0	12	8	0	2	0	10	13	0	0	0	13
г.Санкт-Петербург	Государственные, муниципальные (без учета организаций в ведении ФСИН); Очная	         отчислено в виде меры дисциплинарного взыскания / 14.0	6	0	0	0	6	0	0	0	0	0	41	0	6	11	58	1	0	0	9	10
г.Санкт-Петербург	Государственные, муниципальные (без учета организаций в ведении ФСИН); Очная	         отчислено из-за просрочки оплаты обучения / 15.0	0	0	0	0	0	0	0	0	0	0	0	0	0	66	66	0	0	0	51	51
г.Санкт-Петербург	Государственные, муниципальные (без учета организаций в ведении ФСИН); Очная	"    в том числе:
    переведено на другие формы обучения данной
    организации на программы того же уровня / 7.0"	9	0	0	20	29	0	0	0	1	1	92	0	8	145	245	19	0	1	77	97
г.Санкт-Петербург	Государственные, муниципальные (без учета организаций в ведении ФСИН); Очная	"    в том числе:
    переведено с других форм обучения данной
    образовательной организации с программ того же уровня / 2.0"	20	0	0	0	20	29	0	0	1	30	105	0	5	48	158	26	0	14	12	52
г.Санкт-Петербург	Государственные, муниципальные (без учета организаций в ведении ФСИН); Очная	    восстановлены из числа ранее отчисленных / 4.0	30	0	0	0	30	4	0	0	0	4	225	0	41	184	450	110	0	1	83	194
г.Санкт-Петербург	Государственные, муниципальные (без учета организаций в ведении ФСИН); Очная	    выбыло по другим причинам / 16.0	325	0	0	11	336	238	0	0	4	242	665	0	33	305	1003	159	0	16	69	244
г.Санкт-Петербург	Государственные, муниципальные (без учета организаций в ведении ФСИН); Очная	"    добровольно прекратили образовательные отношения
    (бросили учебу) / 10.0"	678	0	0	10	688	172	0	0	23	195	1926	0	490	903	3319	656	0	152	506	1314
г.Санкт-Петербург	Государственные, муниципальные (без учета организаций в ведении ФСИН); Очная	"    отчислено:
         по неуспеваемости / 11.0"	164	0	0	20	184	69	0	0	2	71	609	0	128	483	1220	205	0	50	322	577
г.Санкт-Петербург	Государственные, муниципальные (без учета организаций в ведении ФСИН); Очная	"    переведено в другие образовательные организации
    на программы того же уровня / 8.0"	51	0	0	4	55	11	0	0	0	11	279	0	123	163	565	55	0	3	60	118
г.Санкт-Петербург	Государственные, муниципальные (без учета организаций в ведении ФСИН); Очная	"    переведено из других образовательных организаций 
    с программ того же уровня / 3.0"	2006	0	0	85	2091	84	0	0	0	84	1051	0	85	230	1366	59	0	4	41	104
г.Санкт-Петербург	Государственные, муниципальные (без учета организаций в ведении ФСИН); Очная	    по болезни / 9.0	9	0	0	0	9	2	0	0	0	2	18	0	0	3	21	14	0	2	2	18
г.Санкт-Петербург	Государственные, муниципальные (без учета организаций в ведении ФСИН); Очная	    прибыло по другим причинам / 5.0	138	0	0	0	138	175	0	0	3	178	1009	0	238	369	1616	84	0	173	224	481
г.Санкт-Петербург	Государственные, муниципальные (без учета организаций в ведении ФСИН); Очная	Выбыло студентов - всего (сумма стр. 07-11, 13-15) / 6.0	1242	0	0	65	1307	492	0	0	30	522	3630	0	788	2079	6497	1109	0	224	1096	2429
г.Санкт-Петербург	Государственные, муниципальные (без учета организаций в ведении ФСИН); Очная	Прибыло студентов - всего (сумма стр. 02-05) / 1.0	2194	0	0	85	2279	292	0	0	4	296	2390	0	369	831	3590	279	0	192	360	831
г.Санкт-Петербург	Государственные, муниципальные (без учета организаций в ведении ФСИН); Очная	"Численность студентов на начало прошлого учебного года
(на 1 октября) / 17.0"	13857	0	0	251	14108	2213	0	0	241	2454	41345	0	8808	13544	63697	7989	0	2128	6830	16947
г.Санкт-Петербург	Очно-заочная; Государственные, муниципальные (без учета организаций в ведении ФСИН)	            из стр. 11 - не прошли итоговую аттестацию / 12.0	0	0	0	0	0	0	0	0	0	0	0	0	0	0	0	0	0	0	0	0
г.Санкт-Петербург	Очно-заочная; Государственные, муниципальные (без учета организаций в ведении ФСИН)	"            из стр. 11 – лица с ограниченными возможностями здоровья,
            инвалиды, дети-инвалиды / 13.0"	0	0	0	0	0	0	0	0	0	0	0	0	0	0	0	0	0	0	0	0
г.Санкт-Петербург	Очно-заочная; Государственные, муниципальные (без учета организаций в ведении ФСИН)	         отчислено в виде меры дисциплинарного взыскания / 14.0	0	0	0	0	0	0	0	0	0	0	0	0	0	0	0	0	0	0	0	0
г.Санкт-Петербург	Очно-заочная; Государственные, муниципальные (без учета организаций в ведении ФСИН)	         отчислено из-за просрочки оплаты обучения / 15.0	0	0	0	0	0	0	0	0	0	0	0	0	0	17	17	0	0	0	16	16
г.Санкт-Петербург	Очно-заочная; Государственные, муниципальные (без учета организаций в ведении ФСИН)	"    в том числе:
    переведено на другие формы обучения данной
    организации на программы того же уровня / 7.0"	0	0	0	0	0	0	0	0	0	0	0	0	0	4	4	4	0	0	9	13
г.Санкт-Петербург	Очно-заочная; Государственные, муниципальные (без учета организаций в ведении ФСИН)	"    в том числе:
    переведено с других форм обучения данной
    образовательной организации с программ того же уровня / 2.0"	0	0	0	0	0	0	0	0	0	0	0	0	0	6	6	8	0	0	14	22
г.Санкт-Петербург	Очно-заочная; Государственные, муниципальные (без учета организаций в ведении ФСИН)	    восстановлены из числа ранее отчисленных / 4.0	0	0	0	0	0	0	0	0	0	0	0	0	0	2	2	30	0	0	14	44
г.Санкт-Петербург	Очно-заочная; Государственные, муниципальные (без учета организаций в ведении ФСИН)	    выбыло по другим причинам / 16.0	0	0	0	0	0	0	0	0	0	0	1	0	0	0	1	21	0	0	34	55
г.Санкт-Петербург	Очно-заочная; Государственные, муниципальные (без учета организаций в ведении ФСИН)	"    добровольно прекратили образовательные отношения
    (бросили учебу) / 10.0"	0	0	0	0	0	18	0	0	0	18	12	0	0	35	47	195	0	0	165	360
г.Санкт-Петербург	Очно-заочная; Государственные, муниципальные (без учета организаций в ведении ФСИН)	"    отчислено:
         по неуспеваемости / 11.0"	0	0	0	0	0	0	0	0	0	0	2	0	0	34	36	175	0	0	72	247
г.Санкт-Петербург	Очно-заочная; Государственные, муниципальные (без учета организаций в ведении ФСИН)	"    переведено в другие образовательные организации
    на программы того же уровня / 8.0"	0	0	0	0	0	0	0	0	0	0	0	0	0	9	9	18	0	0	44	62
г.Санкт-Петербург	Очно-заочная; Государственные, муниципальные (без учета организаций в ведении ФСИН)	"    переведено из других образовательных организаций 
    с программ того же уровня / 3.0"	0	0	0	0	0	0	0	0	0	0	11	0	0	8	19	24	0	0	14	38
г.Санкт-Петербург	Очно-заочная; Государственные, муниципальные (без учета организаций в ведении ФСИН)	    по болезни / 9.0	0	0	0	0	0	0	0	0	0	0	0	0	0	2	2	0	0	0	0	0
г.Санкт-Петербург	Очно-заочная; Государственные, муниципальные (без учета организаций в ведении ФСИН)	    прибыло по другим причинам / 5.0	0	0	0	0	0	0	0	0	0	0	0	0	0	9	9	15	0	0	41	56
г.Санкт-Петербург	Очно-заочная; Государственные, муниципальные (без учета организаций в ведении ФСИН)	Выбыло студентов - всего (сумма стр. 07-11, 13-15) / 6.0	0	0	0	0	0	18	0	0	0	18	15	0	0	101	116	413	0	0	340	753
г.Санкт-Петербург	Очно-заочная; Государственные, муниципальные (без учета организаций в ведении ФСИН)	Прибыло студентов - всего (сумма стр. 02-05) / 1.0	0	0	0	0	0	0	0	0	0	0	11	0	0	25	36	77	0	0	83	160
г.Санкт-Петербург	Очно-заочная; Государственные, муниципальные (без учета организаций в ведении ФСИН)	"Численность студентов на начало прошлого учебного года
(на 1 октября) / 17.0"	0	0	0	0	0	51	0	0	0	51	97	0	0	603	700	2845	0	0	1560	4405
г.Санкт-Петербург	Частные; Заочная	            из стр. 11 - не прошли итоговую аттестацию / 12.0	0	0	0	0	0	0	0	0	0	0	0	0	0	0	0	0	0	0	0	0
г.Санкт-Петербург	Частные; Заочная	"            из стр. 11 – лица с ограниченными возможностями здоровья,
            инвалиды, дети-инвалиды / 13.0"	0	0	0	0	0	0	0	0	0	0	0	0	0	0	0	0	0	0	0	0
г.Санкт-Петербург	Частные; Заочная	         отчислено в виде меры дисциплинарного взыскания / 14.0	0	0	0	0	0	0	0	0	0	0	0	0	0	0	0	0	0	0	0	0
г.Санкт-Петербург	Частные; Заочная	         отчислено из-за просрочки оплаты обучения / 15.0	0	0	0	0	0	0	0	0	0	0	0	0	0	35	35	0	0	0	11	11
г.Санкт-Петербург	Частные; Заочная	"    в том числе:
    переведено на другие формы обучения данной
    организации на программы того же уровня / 7.0"	0	0	0	0	0	0	0	0	0	0	0	0	0	1	1	0	0	0	0	0
г.Санкт-Петербург	Частные; Заочная	"    в том числе:
    переведено с других форм обучения данной
    образовательной организации с программ того же уровня / 2.0"	0	0	0	0	0	0	0	0	0	0	0	0	0	30	30	0	0	0	16	16
г.Санкт-Петербург	Частные; Заочная	    восстановлены из числа ранее отчисленных / 4.0	0	0	0	0	0	0	0	0	0	0	0	0	0	12	12	0	0	0	14	14
г.Санкт-Петербург	Частные; Заочная	    выбыло по другим причинам / 16.0	0	0	0	0	0	0	0	0	0	0	0	0	0	2	2	0	0	0	3	3
г.Санкт-Петербург	Частные; Заочная	"    добровольно прекратили образовательные отношения
    (бросили учебу) / 10.0"	0	0	0	0	0	0	0	0	0	0	0	0	0	47	47	0	0	0	51	51
г.Санкт-Петербург	Частные; Заочная	"    отчислено:
         по неуспеваемости / 11.0"	0	0	0	0	0	0	0	0	0	0	0	0	0	35	35	0	0	0	58	58
г.Санкт-Петербург	Частные; Заочная	"    переведено в другие образовательные организации
    на программы того же уровня / 8.0"	0	0	0	0	0	0	0	0	0	0	0	0	0	32	32	0	0	0	97	97
г.Санкт-Петербург	Частные; Заочная	"    переведено из других образовательных организаций 
    с программ того же уровня / 3.0"	0	0	0	0	0	0	0	0	0	0	0	0	0	35	35	0	0	0	122	122
г.Санкт-Петербург	Частные; Заочная	    по болезни / 9.0	0	0	0	0	0	0	0	0	0	0	0	0	0	0	0	0	0	0	0	0
г.Санкт-Петербург	Частные; Заочная	    прибыло по другим причинам / 5.0	0	0	0	0	0	0	0	0	0	0	0	0	0	0	0	0	0	0	0	0
г.Санкт-Петербург	Частные; Заочная	Выбыло студентов - всего (сумма стр. 07-11, 13-15) / 6.0	0	0	0	0	0	0	0	0	0	0	0	0	0	152	152	0	0	0	220	220
г.Санкт-Петербург	Частные; Заочная	Прибыло студентов - всего (сумма стр. 02-05) / 1.0	0	0	0	0	0	0	0	0	0	0	0	0	0	77	77	0	0	0	152	152
г.Санкт-Петербург	Частные; Заочная	"Численность студентов на начало прошлого учебного года
(на 1 октября) / 17.0"	0	0	0	0	0	0	0	0	0	0	0	0	0	463	463	0	0	0	854	854
г.Санкт-Петербург	Частные; Очная	            из стр. 11 - не прошли итоговую аттестацию / 12.0	0	0	0	0	0	0	0	0	0	0	0	0	0	0	0	0	0	0	0	0
г.Санкт-Петербург	Частные; Очная	"            из стр. 11 – лица с ограниченными возможностями здоровья,
            инвалиды, дети-инвалиды / 13.0"	0	0	0	0	0	0	0	0	0	0	0	0	0	0	0	0	0	0	0	0
г.Санкт-Петербург	Частные; Очная	         отчислено в виде меры дисциплинарного взыскания / 14.0	0	0	0	0	0	0	0	0	0	0	0	0	0	3	3	0	0	0	1	1
г.Санкт-Петербург	Частные; Очная	         отчислено из-за просрочки оплаты обучения / 15.0	0	0	0	0	0	0	0	0	0	0	0	0	0	40	40	0	0	0	40	40
г.Санкт-Петербург	Частные; Очная	"    в том числе:
    переведено на другие формы обучения данной
    организации на программы того же уровня / 7.0"	0	0	0	0	0	0	0	0	0	0	0	0	0	40	40	0	0	0	19	19
г.Санкт-Петербург	Частные; Очная	"    в том числе:
    переведено с других форм обучения данной
    образовательной организации с программ того же уровня / 2.0"	0	0	0	0	0	0	0	0	0	0	0	0	0	1	1	0	0	0	5	5
г.Санкт-Петербург	Частные; Очная	    восстановлены из числа ранее отчисленных / 4.0	0	0	0	0	0	0	0	0	0	0	0	0	0	32	32	0	0	0	6	6
г.Санкт-Петербург	Частные; Очная	    выбыло по другим причинам / 16.0	0	0	0	0	0	0	0	0	0	0	0	0	0	18	18	0	0	0	9	9
г.Санкт-Петербург	Частные; Очная	"    добровольно прекратили образовательные отношения
    (бросили учебу) / 10.0"	0	0	0	0	0	0	0	0	0	0	0	0	0	95	95	0	0	0	100	100
г.Санкт-Петербург	Частные; Очная	"    отчислено:
         по неуспеваемости / 11.0"	0	0	0	0	0	0	0	0	0	0	0	0	0	96	96	0	0	0	77	77
г.Санкт-Петербург	Частные; Очная	"    переведено в другие образовательные организации
    на программы того же уровня / 8.0"	0	0	0	0	0	0	0	0	0	0	0	0	0	35	35	0	0	0	4	4
г.Санкт-Петербург	Частные; Очная	"    переведено из других образовательных организаций 
    с программ того же уровня / 3.0"	0	0	0	0	0	0	0	0	0	0	0	0	0	55	55	0	0	0	5	5
г.Санкт-Петербург	Частные; Очная	    по болезни / 9.0	0	0	0	0	0	0	0	0	0	0	0	0	0	0	0	0	0	0	0	0
г.Санкт-Петербург	Частные; Очная	    прибыло по другим причинам / 5.0	0	0	0	0	0	0	0	0	0	0	0	0	0	7	7	0	0	0	217	217
г.Санкт-Петербург	Частные; Очная	Выбыло студентов - всего (сумма стр. 07-11, 13-15) / 6.0	0	0	0	0	0	0	0	0	0	0	0	0	0	327	327	0	0	0	250	250
г.Санкт-Петербург	Частные; Очная	Прибыло студентов - всего (сумма стр. 02-05) / 1.0	0	0	0	0	0	0	0	0	0	0	0	0	0	95	95	0	0	0	233	233
г.Санкт-Петербург	Частные; Очная	"Численность студентов на начало прошлого учебного года
(на 1 октября) / 17.0"	0	0	0	0	0	0	0	0	0	0	0	0	15	2137	2152	0	0	0	1018	1018
г.Санкт-Петербург	Частные; Очно-заочная	            из стр. 11 - не прошли итоговую аттестацию / 12.0	0	0	0	0	0	0	0	0	0	0	0	0	0	0	0	0	0	0	0	0
г.Санкт-Петербург	Частные; Очно-заочная	"            из стр. 11 – лица с ограниченными возможностями здоровья,
            инвалиды, дети-инвалиды / 13.0"	0	0	0	0	0	0	0	0	0	0	0	0	0	0	0	0	0	0	0	0
г.Санкт-Петербург	Частные; Очно-заочная	         отчислено в виде меры дисциплинарного взыскания / 14.0	0	0	0	0	0	0	0	0	0	0	0	0	0	0	0	0	0	0	0	0
г.Санкт-Петербург	Частные; Очно-заочная	         отчислено из-за просрочки оплаты обучения / 15.0	0	0	0	0	0	0	0	0	0	0	0	0	0	1	1	0	0	0	0	0
г.Санкт-Петербург	Частные; Очно-заочная	"    в том числе:
    переведено на другие формы обучения данной
    организации на программы того же уровня / 7.0"	0	0	0	0	0	0	0	0	0	0	0	0	0	3	3	0	0	0	0	0
г.Санкт-Петербург	Частные; Очно-заочная	"    в том числе:
    переведено с других форм обучения данной
    образовательной организации с программ того же уровня / 2.0"	0	0	0	0	0	0	0	0	0	0	0	0	0	0	0	0	0	0	0	0
г.Санкт-Петербург	Частные; Очно-заочная	    восстановлены из числа ранее отчисленных / 4.0	0	0	0	0	0	0	0	0	0	0	0	0	0	0	0	0	0	0	0	0
г.Санкт-Петербург	Частные; Очно-заочная	    выбыло по другим причинам / 16.0	0	0	0	0	0	0	0	0	0	0	0	0	0	0	0	0	0	0	0	0
г.Санкт-Петербург	Частные; Очно-заочная	"    добровольно прекратили образовательные отношения
    (бросили учебу) / 10.0"	0	0	0	0	0	0	0	0	0	0	0	0	0	0	0	0	0	0	0	0
г.Санкт-Петербург	Частные; Очно-заочная	"    отчислено:
         по неуспеваемости / 11.0"	0	0	0	0	0	0	0	0	0	0	0	0	0	1	1	0	0	0	0	0
г.Санкт-Петербург	Частные; Очно-заочная	"    переведено в другие образовательные организации
    на программы того же уровня / 8.0"	0	0	0	0	0	0	0	0	0	0	0	0	0	0	0	0	0	0	0	0
г.Санкт-Петербург	Частные; Очно-заочная	"    переведено из других образовательных организаций 
    с программ того же уровня / 3.0"	0	0	0	0	0	0	0	0	0	0	0	0	0	15	15	0	0	0	23	23
г.Санкт-Петербург	Частные; Очно-заочная	    по болезни / 9.0	0	0	0	0	0	0	0	0	0	0	0	0	0	0	0	0	0	0	0	0
г.Санкт-Петербург	Частные; Очно-заочная	    прибыло по другим причинам / 5.0	0	0	0	0	0	0	0	0	0	0	0	0	0	0	0	0	0	0	0	0
г.Санкт-Петербург	Частные; Очно-заочная	Выбыло студентов - всего (сумма стр. 07-11, 13-15) / 6.0	0	0	0	0	0	0	0	0	0	0	0	0	0	5	5	0	0	0	0	0
г.Санкт-Петербург	Частные; Очно-заочная	Прибыло студентов - всего (сумма стр. 02-05) / 1.0	0	0	0	0	0	0	0	0	0	0	0	0	0	15	15	0	0	0	23	23
г.Санкт-Петербург	Частные; Очно-заочная	"Численность студентов на начало прошлого учебного года
(на 1 октября) / 17.0"	0	0	0	0	0	0	0	0	0	0	0	0	0	24	24	0	0	0	38	38
г.Севастополь	Государственные, муниципальные (без учета организаций в ведении ФСИН); Заочная	            из стр. 11 - не прошли итоговую аттестацию / 12.0	0	0	0	0	0	0	0	0	0	0	0	0	0	0	0	2	0	0	1	3
г.Севастополь	Государственные, муниципальные (без учета организаций в ведении ФСИН); Заочная	"            из стр. 11 – лица с ограниченными возможностями здоровья,
            инвалиды, дети-инвалиды / 13.0"	0	0	0	0	0	0	0	0	0	0	0	0	0	0	0	0	0	0	0	0
г.Севастополь	Государственные, муниципальные (без учета организаций в ведении ФСИН); Заочная	         отчислено в виде меры дисциплинарного взыскания / 14.0	0	0	0	0	0	0	0	0	0	0	0	0	0	0	0	0	0	0	0	0
г.Севастополь	Государственные, муниципальные (без учета организаций в ведении ФСИН); Заочная	         отчислено из-за просрочки оплаты обучения / 15.0	0	0	0	0	0	0	0	0	0	0	0	0	0	0	0	0	0	0	0	0
г.Севастополь	Государственные, муниципальные (без учета организаций в ведении ФСИН); Заочная	"    в том числе:
    переведено на другие формы обучения данной
    организации на программы того же уровня / 7.0"	0	0	0	0	0	0	0	0	0	0	0	0	0	0	0	0	0	0	2	2
г.Севастополь	Государственные, муниципальные (без учета организаций в ведении ФСИН); Заочная	"    в том числе:
    переведено с других форм обучения данной
    образовательной организации с программ того же уровня / 2.0"	0	0	0	0	0	0	0	0	0	0	0	0	0	0	0	8	0	0	6	14
г.Севастополь	Государственные, муниципальные (без учета организаций в ведении ФСИН); Заочная	    восстановлены из числа ранее отчисленных / 4.0	0	0	0	0	0	0	0	0	0	0	0	0	0	0	0	12	0	0	14	26
г.Севастополь	Государственные, муниципальные (без учета организаций в ведении ФСИН); Заочная	    выбыло по другим причинам / 16.0	0	0	0	0	0	0	0	0	0	0	0	0	0	0	0	0	0	0	1	1
г.Севастополь	Государственные, муниципальные (без учета организаций в ведении ФСИН); Заочная	"    добровольно прекратили образовательные отношения
    (бросили учебу) / 10.0"	0	0	0	0	0	0	0	0	0	0	0	0	0	0	0	17	0	0	22	39
г.Севастополь	Государственные, муниципальные (без учета организаций в ведении ФСИН); Заочная	"    отчислено:
         по неуспеваемости / 11.0"	0	0	0	0	0	0	0	0	0	0	0	0	0	0	0	9	0	0	20	29
г.Севастополь	Государственные, муниципальные (без учета организаций в ведении ФСИН); Заочная	"    переведено в другие образовательные организации
    на программы того же уровня / 8.0"	0	0	0	0	0	0	0	0	0	0	0	0	0	0	0	4	0	0	2	6
г.Севастополь	Государственные, муниципальные (без учета организаций в ведении ФСИН); Заочная	"    переведено из других образовательных организаций 
    с программ того же уровня / 3.0"	0	0	0	0	0	0	0	0	0	0	0	0	0	0	0	0	0	0	0	0
г.Севастополь	Государственные, муниципальные (без учета организаций в ведении ФСИН); Заочная	    по болезни / 9.0	0	0	0	0	0	0	0	0	0	0	0	0	0	0	0	0	0	0	0	0
г.Севастополь	Государственные, муниципальные (без учета организаций в ведении ФСИН); Заочная	    прибыло по другим причинам / 5.0	0	0	0	0	0	0	0	0	0	0	0	0	0	0	0	3	0	0	2	5
г.Севастополь	Государственные, муниципальные (без учета организаций в ведении ФСИН); Заочная	Выбыло студентов - всего (сумма стр. 07-11, 13-15) / 6.0	0	0	0	0	0	0	0	0	0	0	0	0	0	0	0	30	0	0	47	77
г.Севастополь	Государственные, муниципальные (без учета организаций в ведении ФСИН); Заочная	Прибыло студентов - всего (сумма стр. 02-05) / 1.0	0	0	0	0	0	0	0	0	0	0	0	0	0	0	0	23	0	0	22	45
г.Севастополь	Государственные, муниципальные (без учета организаций в ведении ФСИН); Заочная	"Численность студентов на начало прошлого учебного года
(на 1 октября) / 17.0"	0	0	0	0	0	0	0	0	0	0	0	0	0	0	0	680	0	0	213	893
г.Севастополь	Государственные, муниципальные (без учета организаций в ведении ФСИН); Очная	            из стр. 11 - не прошли итоговую аттестацию / 12.0	4	0	0	0	4	0	0	0	0	0	3	0	1	0	4	0	0	0	0	0
г.Севастополь	Государственные, муниципальные (без учета организаций в ведении ФСИН); Очная	"            из стр. 11 – лица с ограниченными возможностями здоровья,
            инвалиды, дети-инвалиды / 13.0"	0	0	0	0	0	0	0	0	0	0	0	0	0	0	0	0	0	0	0	0
г.Севастополь	Государственные, муниципальные (без учета организаций в ведении ФСИН); Очная	         отчислено в виде меры дисциплинарного взыскания / 14.0	2	1	0	0	3	0	0	0	0	0	4	0	0	0	4	1	0	0	0	1
г.Севастополь	Государственные, муниципальные (без учета организаций в ведении ФСИН); Очная	         отчислено из-за просрочки оплаты обучения / 15.0	0	0	0	0	0	0	0	0	0	0	0	0	0	1	1	0	0	0	0	0
г.Севастополь	Государственные, муниципальные (без учета организаций в ведении ФСИН); Очная	"    в том числе:
    переведено на другие формы обучения данной
    организации на программы того же уровня / 7.0"	7	0	0	0	7	0	0	0	0	0	16	0	0	14	30	5	0	0	7	12
г.Севастополь	Государственные, муниципальные (без учета организаций в ведении ФСИН); Очная	"    в том числе:
    переведено с других форм обучения данной
    образовательной организации с программ того же уровня / 2.0"	2	0	0	0	2	0	0	0	0	0	2	0	0	0	2	0	0	0	1	1
г.Севастополь	Государственные, муниципальные (без учета организаций в ведении ФСИН); Очная	    восстановлены из числа ранее отчисленных / 4.0	1	0	0	0	1	0	0	0	0	0	7	0	14	16	37	0	0	0	7	7
г.Севастополь	Государственные, муниципальные (без учета организаций в ведении ФСИН); Очная	    выбыло по другим причинам / 16.0	50	24	0	2	76	0	4	0	6	10	45	0	18	56	119	1	0	1	4	6
г.Севастополь	Государственные, муниципальные (без учета организаций в ведении ФСИН); Очная	"    добровольно прекратили образовательные отношения
    (бросили учебу) / 10.0"	10	1	0	2	13	3	0	0	4	7	47	0	58	103	208	3	0	30	33	66
г.Севастополь	Государственные, муниципальные (без учета организаций в ведении ФСИН); Очная	"    отчислено:
         по неуспеваемости / 11.0"	12	8	0	0	20	0	0	0	0	0	22	0	36	32	90	0	0	1	10	11
г.Севастополь	Государственные, муниципальные (без учета организаций в ведении ФСИН); Очная	"    переведено в другие образовательные организации
    на программы того же уровня / 8.0"	1	1	0	0	2	0	0	0	0	0	33	0	6	19	58	0	0	4	13	17
г.Севастополь	Государственные, муниципальные (без учета организаций в ведении ФСИН); Очная	"    переведено из других образовательных организаций 
    с программ того же уровня / 3.0"	17	0	0	5	22	0	0	0	0	0	25	0	5	28	58	1	0	0	4	5
г.Севастополь	Государственные, муниципальные (без учета организаций в ведении ФСИН); Очная	    по болезни / 9.0	0	1	0	0	1	0	0	0	0	0	4	0	0	1	5	5	0	0	0	5
г.Севастополь	Государственные, муниципальные (без учета организаций в ведении ФСИН); Очная	    прибыло по другим причинам / 5.0	0	0	0	0	0	0	0	0	0	0	7	0	52	30	89	0	0	1	6	7
г.Севастополь	Государственные, муниципальные (без учета организаций в ведении ФСИН); Очная	Выбыло студентов - всего (сумма стр. 07-11, 13-15) / 6.0	82	36	0	4	122	3	4	0	10	17	171	0	118	226	515	15	0	36	67	118
г.Севастополь	Государственные, муниципальные (без учета организаций в ведении ФСИН); Очная	Прибыло студентов - всего (сумма стр. 02-05) / 1.0	20	0	0	5	25	0	0	0	0	0	41	0	71	74	186	1	0	1	18	20
г.Севастополь	Государственные, муниципальные (без учета организаций в ведении ФСИН); Очная	"Численность студентов на начало прошлого учебного года
(на 1 октября) / 17.0"	1226	521	0	153	1900	100	50	0	51	201	3054	0	1341	1388	5783	295	0	259	483	1037
