region	tags	indicator	Программы подготовки квалифицированных рабочих, служащих > Всего (сумма гр. 7, 8) > 6.0	Программы подготовки квалифицированных рабочих, служащих > в том числе программы > на базе основного общего образования > 7.0	Программы подготовки квалифицированных рабочих, служащих > в том числе программы > на базе среднего общего образования > 8.0	Программы подготовки специалистов среднего звена > Всего (сумма гр. 4, 5) > 3.0	Программы подготовки специалистов среднего звена > в том числе программы > на базе основного общего образования > 4.0	Программы подготовки специалистов среднего звена > в том числе программы > на базе среднего общего образования > 5.0
Алтайский край	Государственные, муниципальные (без учета организаций в ведении ФСИН); Очная	      в том числе студентам, направленным ими на обучение / 11.0	14	14	0	117	62	55
Алтайский край	Государственные, муниципальные (без учета организаций в ведении ФСИН); Очная	      в том числе студентам, направленным ими на обучение / 13.0	0	0	0	0	0	0
Алтайский край	Государственные, муниципальные (без учета организаций в ведении ФСИН); Очная	      из них организацией, студентами которой они являются / 8.0	8	8	0	8	5	3
Алтайский край	Государственные, муниципальные (без учета организаций в ведении ФСИН); Очная	   бюджетных ассигнований бюджета субъекта Российской Федерации / 16.0	639	639	0	464	398	66
Алтайский край	Государственные, муниципальные (без учета организаций в ведении ФСИН); Очная	   государственные социальные стипендии / 2.0	2557	2531	26	3656	3030	626
Алтайский край	Государственные, муниципальные (без учета организаций в ведении ФСИН); Очная	"   из них за счет средств: 
   стипендиального фонда / 15.0"	218	212	6	644	502	142
Алтайский край	Государственные, муниципальные (без учета организаций в ведении ФСИН); Очная	"   именные стипендии, учрежденные: 
   органами государственной власти субъекта Российской Федерации / 5.0"	33	33	0	89	77	12
Алтайский край	Государственные, муниципальные (без учета организаций в ведении ФСИН); Очная	   именные стипендии, учрежденные: органами местного самоуправления / 6.0	0	0	0	4	3	1
Алтайский край	Государственные, муниципальные (без учета организаций в ведении ФСИН); Очная	   именные стипендии, учрежденные: федеральными государственными органами / 4.0	3	3	0	5	4	1
Алтайский край	Государственные, муниципальные (без учета организаций в ведении ФСИН); Очная	   именные стипендии, учрежденные: физическими лицами / 9.0	0	0	0	0	0	0
Алтайский край	Государственные, муниципальные (без учета организаций в ведении ФСИН); Очная	   именные стипендии, учрежденные: юридическими лицами / 7.0	8	8	0	10	7	3
Алтайский край	Государственные, муниципальные (без учета организаций в ведении ФСИН); Очная	   полученных от приносящей доход деятельности / 17.0	202	202	0	108	87	21
Алтайский край	Государственные, муниципальные (без учета организаций в ведении ФСИН); Очная	   стипендии Правительства Российской Федерации / 3.0	50	50	0	53	44	9
Алтайский край	Государственные, муниципальные (без учета организаций в ведении ФСИН); Очная	"   стипендии, назначенные физическими лицами (кроме именных,
   указанных в строке 09) / 12.0"	0	0	0	74	37	37
Алтайский край	Государственные, муниципальные (без учета организаций в ведении ФСИН); Очная	"   стипендии, назначенные юридическими лицами (кроме именных,
   указанных в строке 07) / 10.0"	14	14	0	135	75	60
Алтайский край	Государственные, муниципальные (без учета организаций в ведении ФСИН); Очная	Численность студентов, получающих другие формы материальной поддержки / 14.0	1083	1077	6	1301	1029	272
Алтайский край	Государственные, муниципальные (без учета организаций в ведении ФСИН); Очная	Численность студентов, получающих: государственные академические стипендии / 1.0	7065	6742	323	15012	11812	3200
Алтайский край	Частные; Очная	      в том числе студентам, направленным ими на обучение / 11.0	0	0	0	0	0	0
Алтайский край	Частные; Очная	      в том числе студентам, направленным ими на обучение / 13.0	0	0	0	0	0	0
Алтайский край	Частные; Очная	      из них организацией, студентами которой они являются / 8.0	0	0	0	0	0	0
Алтайский край	Частные; Очная	   бюджетных ассигнований бюджета субъекта Российской Федерации / 16.0	0	0	0	0	0	0
Алтайский край	Частные; Очная	   государственные социальные стипендии / 2.0	0	0	0	0	0	0
Алтайский край	Частные; Очная	"   из них за счет средств: 
   стипендиального фонда / 15.0"	0	0	0	0	0	0
Алтайский край	Частные; Очная	"   именные стипендии, учрежденные: 
   органами государственной власти субъекта Российской Федерации / 5.0"	0	0	0	0	0	0
Алтайский край	Частные; Очная	   именные стипендии, учрежденные: органами местного самоуправления / 6.0	0	0	0	0	0	0
Алтайский край	Частные; Очная	   именные стипендии, учрежденные: федеральными государственными органами / 4.0	0	0	0	0	0	0
Алтайский край	Частные; Очная	   именные стипендии, учрежденные: физическими лицами / 9.0	0	0	0	0	0	0
Алтайский край	Частные; Очная	   именные стипендии, учрежденные: юридическими лицами / 7.0	0	0	0	0	0	0
Алтайский край	Частные; Очная	   полученных от приносящей доход деятельности / 17.0	0	0	0	80	61	19
Алтайский край	Частные; Очная	   стипендии Правительства Российской Федерации / 3.0	0	0	0	0	0	0
Алтайский край	Частные; Очная	"   стипендии, назначенные физическими лицами (кроме именных,
   указанных в строке 09) / 12.0"	0	0	0	0	0	0
Алтайский край	Частные; Очная	"   стипендии, назначенные юридическими лицами (кроме именных,
   указанных в строке 07) / 10.0"	0	0	0	0	0	0
Алтайский край	Частные; Очная	Численность студентов, получающих другие формы материальной поддержки / 14.0	0	0	0	80	61	19
Алтайский край	Частные; Очная	Численность студентов, получающих: государственные академические стипендии / 1.0	0	0	0	0	0	0
Амурская область	Государственные, муниципальные (без учета организаций в ведении ФСИН); Очная	      в том числе студентам, направленным ими на обучение / 11.0	0	0	0	20	19	1
Амурская область	Государственные, муниципальные (без учета организаций в ведении ФСИН); Очная	      в том числе студентам, направленным ими на обучение / 13.0	0	0	0	0	0	0
Амурская область	Государственные, муниципальные (без учета организаций в ведении ФСИН); Очная	      из них организацией, студентами которой они являются / 8.0	0	0	0	1	1	0
Амурская область	Государственные, муниципальные (без учета организаций в ведении ФСИН); Очная	   бюджетных ассигнований бюджета субъекта Российской Федерации / 16.0	203	190	13	209	198	11
Амурская область	Государственные, муниципальные (без учета организаций в ведении ФСИН); Очная	   государственные социальные стипендии / 2.0	542	525	17	868	708	160
Амурская область	Государственные, муниципальные (без учета организаций в ведении ФСИН); Очная	"   из них за счет средств: 
   стипендиального фонда / 15.0"	19	19	0	364	100	264
Амурская область	Государственные, муниципальные (без учета организаций в ведении ФСИН); Очная	"   именные стипендии, учрежденные: 
   органами государственной власти субъекта Российской Федерации / 5.0"	17	13	4	149	114	35
Амурская область	Государственные, муниципальные (без учета организаций в ведении ФСИН); Очная	   именные стипендии, учрежденные: органами местного самоуправления / 6.0	0	0	0	1	1	0
Амурская область	Государственные, муниципальные (без учета организаций в ведении ФСИН); Очная	   именные стипендии, учрежденные: федеральными государственными органами / 4.0	12	12	0	0	0	0
Амурская область	Государственные, муниципальные (без учета организаций в ведении ФСИН); Очная	   именные стипендии, учрежденные: физическими лицами / 9.0	0	0	0	0	0	0
Амурская область	Государственные, муниципальные (без учета организаций в ведении ФСИН); Очная	   именные стипендии, учрежденные: юридическими лицами / 7.0	0	0	0	36	4	32
Амурская область	Государственные, муниципальные (без учета организаций в ведении ФСИН); Очная	   полученных от приносящей доход деятельности / 17.0	7	6	1	281	200	81
Амурская область	Государственные, муниципальные (без учета организаций в ведении ФСИН); Очная	   стипендии Правительства Российской Федерации / 3.0	14	14	0	26	23	3
Амурская область	Государственные, муниципальные (без учета организаций в ведении ФСИН); Очная	"   стипендии, назначенные физическими лицами (кроме именных,
   указанных в строке 09) / 12.0"	0	0	0	0	0	0
Амурская область	Государственные, муниципальные (без учета организаций в ведении ФСИН); Очная	"   стипендии, назначенные юридическими лицами (кроме именных,
   указанных в строке 07) / 10.0"	0	0	0	41	27	14
Амурская область	Государственные, муниципальные (без учета организаций в ведении ФСИН); Очная	Численность студентов, получающих другие формы материальной поддержки / 14.0	229	215	14	1512	1149	363
Амурская область	Государственные, муниципальные (без учета организаций в ведении ФСИН); Очная	Численность студентов, получающих: государственные академические стипендии / 1.0	1853	1803	50	5969	4766	1203
Амурская область	Частные; Очная	      в том числе студентам, направленным ими на обучение / 11.0	0	0	0	0	0	0
Амурская область	Частные; Очная	      в том числе студентам, направленным ими на обучение / 13.0	0	0	0	0	0	0
Амурская область	Частные; Очная	      из них организацией, студентами которой они являются / 8.0	0	0	0	0	0	0
Амурская область	Частные; Очная	   бюджетных ассигнований бюджета субъекта Российской Федерации / 16.0	0	0	0	0	0	0
Амурская область	Частные; Очная	   государственные социальные стипендии / 2.0	0	0	0	0	0	0
Амурская область	Частные; Очная	"   из них за счет средств: 
   стипендиального фонда / 15.0"	0	0	0	0	0	0
Амурская область	Частные; Очная	"   именные стипендии, учрежденные: 
   органами государственной власти субъекта Российской Федерации / 5.0"	0	0	0	0	0	0
Амурская область	Частные; Очная	   именные стипендии, учрежденные: органами местного самоуправления / 6.0	0	0	0	0	0	0
Амурская область	Частные; Очная	   именные стипендии, учрежденные: федеральными государственными органами / 4.0	0	0	0	0	0	0
Амурская область	Частные; Очная	   именные стипендии, учрежденные: физическими лицами / 9.0	0	0	0	0	0	0
Амурская область	Частные; Очная	   именные стипендии, учрежденные: юридическими лицами / 7.0	11	0	11	36	0	36
Амурская область	Частные; Очная	   полученных от приносящей доход деятельности / 17.0	0	0	0	0	0	0
Амурская область	Частные; Очная	   стипендии Правительства Российской Федерации / 3.0	0	0	0	0	0	0
Амурская область	Частные; Очная	"   стипендии, назначенные физическими лицами (кроме именных,
   указанных в строке 09) / 12.0"	0	0	0	0	0	0
Амурская область	Частные; Очная	"   стипендии, назначенные юридическими лицами (кроме именных,
   указанных в строке 07) / 10.0"	11	0	11	36	0	36
Амурская область	Частные; Очная	Численность студентов, получающих другие формы материальной поддержки / 14.0	0	0	0	0	0	0
Амурская область	Частные; Очная	Численность студентов, получающих: государственные академические стипендии / 1.0	0	0	0	0	0	0
Архангельская область	Государственные, муниципальные (без учета организаций в ведении ФСИН); Очная	      в том числе студентам, направленным ими на обучение / 11.0	0	0	0	2	2	0
Архангельская область	Государственные, муниципальные (без учета организаций в ведении ФСИН); Очная	      в том числе студентам, направленным ими на обучение / 13.0	0	0	0	0	0	0
Архангельская область	Государственные, муниципальные (без учета организаций в ведении ФСИН); Очная	      из них организацией, студентами которой они являются / 8.0	0	0	0	1	1	0
Архангельская область	Государственные, муниципальные (без учета организаций в ведении ФСИН); Очная	   бюджетных ассигнований бюджета субъекта Российской Федерации / 16.0	77	73	4	32	25	7
Архангельская область	Государственные, муниципальные (без учета организаций в ведении ФСИН); Очная	   государственные социальные стипендии / 2.0	1136	1063	73	1867	1440	427
Архангельская область	Государственные, муниципальные (без учета организаций в ведении ФСИН); Очная	"   из них за счет средств: 
   стипендиального фонда / 15.0"	877	775	102	1149	940	209
Архангельская область	Государственные, муниципальные (без учета организаций в ведении ФСИН); Очная	"   именные стипендии, учрежденные: 
   органами государственной власти субъекта Российской Федерации / 5.0"	0	0	0	13	3	10
Архангельская область	Государственные, муниципальные (без учета организаций в ведении ФСИН); Очная	   именные стипендии, учрежденные: органами местного самоуправления / 6.0	0	0	0	4	4	0
Архангельская область	Государственные, муниципальные (без учета организаций в ведении ФСИН); Очная	   именные стипендии, учрежденные: федеральными государственными органами / 4.0	0	0	0	0	0	0
Архангельская область	Государственные, муниципальные (без учета организаций в ведении ФСИН); Очная	   именные стипендии, учрежденные: физическими лицами / 9.0	0	0	0	2	0	2
Архангельская область	Государственные, муниципальные (без учета организаций в ведении ФСИН); Очная	   именные стипендии, учрежденные: юридическими лицами / 7.0	1	1	0	3	3	0
Архангельская область	Государственные, муниципальные (без учета организаций в ведении ФСИН); Очная	   полученных от приносящей доход деятельности / 17.0	10	10	0	3	3	0
Архангельская область	Государственные, муниципальные (без учета организаций в ведении ФСИН); Очная	   стипендии Правительства Российской Федерации / 3.0	8	7	1	19	18	1
Архангельская область	Государственные, муниципальные (без учета организаций в ведении ФСИН); Очная	"   стипендии, назначенные физическими лицами (кроме именных,
   указанных в строке 09) / 12.0"	0	0	0	0	0	0
Архангельская область	Государственные, муниципальные (без учета организаций в ведении ФСИН); Очная	"   стипендии, назначенные юридическими лицами (кроме именных,
   указанных в строке 07) / 10.0"	23	23	0	67	32	35
Архангельская область	Государственные, муниципальные (без учета организаций в ведении ФСИН); Очная	Численность студентов, получающих другие формы материальной поддержки / 14.0	986	880	106	1182	966	216
Архангельская область	Государственные, муниципальные (без учета организаций в ведении ФСИН); Очная	Численность студентов, получающих: государственные академические стипендии / 1.0	3691	3447	244	6848	4962	1886
Астраханская область	Государственные, муниципальные (без учета организаций в ведении ФСИН); Очная	      в том числе студентам, направленным ими на обучение / 11.0	0	0	0	0	0	0
Астраханская область	Государственные, муниципальные (без учета организаций в ведении ФСИН); Очная	      в том числе студентам, направленным ими на обучение / 13.0	0	0	0	0	0	0
Астраханская область	Государственные, муниципальные (без учета организаций в ведении ФСИН); Очная	      из них организацией, студентами которой они являются / 8.0	0	0	0	0	0	0
Астраханская область	Государственные, муниципальные (без учета организаций в ведении ФСИН); Очная	   бюджетных ассигнований бюджета субъекта Российской Федерации / 16.0	24	24	0	35	35	0
Астраханская область	Государственные, муниципальные (без учета организаций в ведении ФСИН); Очная	   государственные социальные стипендии / 2.0	925	828	97	2196	1767	429
Астраханская область	Государственные, муниципальные (без учета организаций в ведении ФСИН); Очная	"   из них за счет средств: 
   стипендиального фонда / 15.0"	0	0	0	5	3	2
Астраханская область	Государственные, муниципальные (без учета организаций в ведении ФСИН); Очная	"   именные стипендии, учрежденные: 
   органами государственной власти субъекта Российской Федерации / 5.0"	0	0	0	1	1	0
Астраханская область	Государственные, муниципальные (без учета организаций в ведении ФСИН); Очная	   именные стипендии, учрежденные: органами местного самоуправления / 6.0	0	0	0	0	0	0
Астраханская область	Государственные, муниципальные (без учета организаций в ведении ФСИН); Очная	   именные стипендии, учрежденные: федеральными государственными органами / 4.0	0	0	0	3	2	1
Астраханская область	Государственные, муниципальные (без учета организаций в ведении ФСИН); Очная	   именные стипендии, учрежденные: физическими лицами / 9.0	0	0	0	0	0	0
Астраханская область	Государственные, муниципальные (без учета организаций в ведении ФСИН); Очная	   именные стипендии, учрежденные: юридическими лицами / 7.0	0	0	0	0	0	0
Астраханская область	Государственные, муниципальные (без учета организаций в ведении ФСИН); Очная	   полученных от приносящей доход деятельности / 17.0	0	0	0	0	0	0
Астраханская область	Государственные, муниципальные (без учета организаций в ведении ФСИН); Очная	   стипендии Правительства Российской Федерации / 3.0	5	5	0	30	27	3
Астраханская область	Государственные, муниципальные (без учета организаций в ведении ФСИН); Очная	"   стипендии, назначенные физическими лицами (кроме именных,
   указанных в строке 09) / 12.0"	0	0	0	0	0	0
Астраханская область	Государственные, муниципальные (без учета организаций в ведении ФСИН); Очная	"   стипендии, назначенные юридическими лицами (кроме именных,
   указанных в строке 07) / 10.0"	0	0	0	0	0	0
Астраханская область	Государственные, муниципальные (без учета организаций в ведении ФСИН); Очная	Численность студентов, получающих другие формы материальной поддержки / 14.0	26	26	0	81	76	5
Астраханская область	Государственные, муниципальные (без учета организаций в ведении ФСИН); Очная	Численность студентов, получающих: государственные академические стипендии / 1.0	1594	1481	113	7212	6361	851
Астраханская область	Частные; Очная	      в том числе студентам, направленным ими на обучение / 11.0	0	0	0	0	0	0
Астраханская область	Частные; Очная	      в том числе студентам, направленным ими на обучение / 13.0	0	0	0	0	0	0
Астраханская область	Частные; Очная	      из них организацией, студентами которой они являются / 8.0	0	0	0	35	30	5
Астраханская область	Частные; Очная	   бюджетных ассигнований бюджета субъекта Российской Федерации / 16.0	0	0	0	0	0	0
Астраханская область	Частные; Очная	   государственные социальные стипендии / 2.0	0	0	0	1	1	0
Астраханская область	Частные; Очная	"   из них за счет средств: 
   стипендиального фонда / 15.0"	0	0	0	0	0	0
Астраханская область	Частные; Очная	"   именные стипендии, учрежденные: 
   органами государственной власти субъекта Российской Федерации / 5.0"	0	0	0	0	0	0
Астраханская область	Частные; Очная	   именные стипендии, учрежденные: органами местного самоуправления / 6.0	0	0	0	0	0	0
Астраханская область	Частные; Очная	   именные стипендии, учрежденные: федеральными государственными органами / 4.0	0	0	0	0	0	0
Астраханская область	Частные; Очная	   именные стипендии, учрежденные: физическими лицами / 9.0	0	0	0	0	0	0
Астраханская область	Частные; Очная	   именные стипендии, учрежденные: юридическими лицами / 7.0	0	0	0	35	30	5
Астраханская область	Частные; Очная	   полученных от приносящей доход деятельности / 17.0	0	0	0	41	30	11
Астраханская область	Частные; Очная	   стипендии Правительства Российской Федерации / 3.0	0	0	0	0	0	0
Астраханская область	Частные; Очная	"   стипендии, назначенные физическими лицами (кроме именных,
   указанных в строке 09) / 12.0"	0	0	0	0	0	0
Астраханская область	Частные; Очная	"   стипендии, назначенные юридическими лицами (кроме именных,
   указанных в строке 07) / 10.0"	0	0	0	5	5	0
Астраханская область	Частные; Очная	Численность студентов, получающих другие формы материальной поддержки / 14.0	0	0	0	41	30	11
Астраханская область	Частные; Очная	Численность студентов, получающих: государственные академические стипендии / 1.0	0	0	0	30	30	0
Белгородская область	Государственные, муниципальные (без учета организаций в ведении ФСИН); Очная	      в том числе студентам, направленным ими на обучение / 11.0	0	0	0	0	0	0
Белгородская область	Государственные, муниципальные (без учета организаций в ведении ФСИН); Очная	      в том числе студентам, направленным ими на обучение / 13.0	0	0	0	0	0	0
Белгородская область	Государственные, муниципальные (без учета организаций в ведении ФСИН); Очная	      из них организацией, студентами которой они являются / 8.0	0	0	0	223	192	31
Белгородская область	Государственные, муниципальные (без учета организаций в ведении ФСИН); Очная	   бюджетных ассигнований бюджета субъекта Российской Федерации / 16.0	5	5	0	182	148	34
Белгородская область	Государственные, муниципальные (без учета организаций в ведении ФСИН); Очная	   государственные социальные стипендии / 2.0	577	576	1	2410	2359	51
Белгородская область	Государственные, муниципальные (без учета организаций в ведении ФСИН); Очная	"   из них за счет средств: 
   стипендиального фонда / 15.0"	86	86	0	1081	1066	15
Белгородская область	Государственные, муниципальные (без учета организаций в ведении ФСИН); Очная	"   именные стипендии, учрежденные: 
   органами государственной власти субъекта Российской Федерации / 5.0"	7	7	0	93	92	1
Белгородская область	Государственные, муниципальные (без учета организаций в ведении ФСИН); Очная	   именные стипендии, учрежденные: органами местного самоуправления / 6.0	2	2	0	38	31	7
Белгородская область	Государственные, муниципальные (без учета организаций в ведении ФСИН); Очная	   именные стипендии, учрежденные: федеральными государственными органами / 4.0	1	1	0	4	4	0
Белгородская область	Государственные, муниципальные (без учета организаций в ведении ФСИН); Очная	   именные стипендии, учрежденные: физическими лицами / 9.0	0	0	0	1	1	0
Белгородская область	Государственные, муниципальные (без учета организаций в ведении ФСИН); Очная	   именные стипендии, учрежденные: юридическими лицами / 7.0	6	6	0	339	307	32
Белгородская область	Государственные, муниципальные (без учета организаций в ведении ФСИН); Очная	   полученных от приносящей доход деятельности / 17.0	0	0	0	660	539	121
Белгородская область	Государственные, муниципальные (без учета организаций в ведении ФСИН); Очная	   стипендии Правительства Российской Федерации / 3.0	34	34	0	98	96	2
Белгородская область	Государственные, муниципальные (без учета организаций в ведении ФСИН); Очная	"   стипендии, назначенные физическими лицами (кроме именных,
   указанных в строке 09) / 12.0"	0	0	0	0	0	0
Белгородская область	Государственные, муниципальные (без учета организаций в ведении ФСИН); Очная	"   стипендии, назначенные юридическими лицами (кроме именных,
   указанных в строке 07) / 10.0"	0	0	0	64	64	0
Белгородская область	Государственные, муниципальные (без учета организаций в ведении ФСИН); Очная	Численность студентов, получающих другие формы материальной поддержки / 14.0	97	97	0	2220	1979	241
Белгородская область	Государственные, муниципальные (без учета организаций в ведении ФСИН); Очная	Численность студентов, получающих: государственные академические стипендии / 1.0	1913	1887	26	18079	17453	626
Белгородская область	Частные; Очная	      в том числе студентам, направленным ими на обучение / 11.0	0	0	0	0	0	0
Белгородская область	Частные; Очная	      в том числе студентам, направленным ими на обучение / 13.0	0	0	0	0	0	0
Белгородская область	Частные; Очная	      из них организацией, студентами которой они являются / 8.0	0	0	0	16	16	0
Белгородская область	Частные; Очная	   бюджетных ассигнований бюджета субъекта Российской Федерации / 16.0	0	0	0	0	0	0
Белгородская область	Частные; Очная	   государственные социальные стипендии / 2.0	0	0	0	0	0	0
Белгородская область	Частные; Очная	"   из них за счет средств: 
   стипендиального фонда / 15.0"	0	0	0	0	0	0
Белгородская область	Частные; Очная	"   именные стипендии, учрежденные: 
   органами государственной власти субъекта Российской Федерации / 5.0"	0	0	0	5	5	0
Белгородская область	Частные; Очная	   именные стипендии, учрежденные: органами местного самоуправления / 6.0	0	0	0	1	1	0
Белгородская область	Частные; Очная	   именные стипендии, учрежденные: федеральными государственными органами / 4.0	0	0	0	0	0	0
Белгородская область	Частные; Очная	   именные стипендии, учрежденные: физическими лицами / 9.0	0	0	0	0	0	0
Белгородская область	Частные; Очная	   именные стипендии, учрежденные: юридическими лицами / 7.0	0	0	0	16	16	0
Белгородская область	Частные; Очная	   полученных от приносящей доход деятельности / 17.0	0	0	0	15	15	0
Белгородская область	Частные; Очная	   стипендии Правительства Российской Федерации / 3.0	0	0	0	3	3	0
Белгородская область	Частные; Очная	"   стипендии, назначенные физическими лицами (кроме именных,
   указанных в строке 09) / 12.0"	0	0	0	0	0	0
Белгородская область	Частные; Очная	"   стипендии, назначенные юридическими лицами (кроме именных,
   указанных в строке 07) / 10.0"	0	0	0	0	0	0
Белгородская область	Частные; Очная	Численность студентов, получающих другие формы материальной поддержки / 14.0	0	0	0	15	15	0
Белгородская область	Частные; Очная	Численность студентов, получающих: государственные академические стипендии / 1.0	0	0	0	5	5	0
Брянская область	Государственные, муниципальные (без учета организаций в ведении ФСИН); Очная	      в том числе студентам, направленным ими на обучение / 11.0	0	0	0	0	0	0
Брянская область	Государственные, муниципальные (без учета организаций в ведении ФСИН); Очная	      в том числе студентам, направленным ими на обучение / 13.0	0	0	0	0	0	0
Брянская область	Государственные, муниципальные (без учета организаций в ведении ФСИН); Очная	      из них организацией, студентами которой они являются / 8.0	0	0	0	9	9	0
Брянская область	Государственные, муниципальные (без учета организаций в ведении ФСИН); Очная	   бюджетных ассигнований бюджета субъекта Российской Федерации / 16.0	214	214	0	633	477	156
Брянская область	Государственные, муниципальные (без учета организаций в ведении ФСИН); Очная	   государственные социальные стипендии / 2.0	2085	1800	285	6841	5768	1073
Брянская область	Государственные, муниципальные (без учета организаций в ведении ФСИН); Очная	"   из них за счет средств: 
   стипендиального фонда / 15.0"	502	500	2	2571	2462	109
Брянская область	Государственные, муниципальные (без учета организаций в ведении ФСИН); Очная	"   именные стипендии, учрежденные: 
   органами государственной власти субъекта Российской Федерации / 5.0"	1	1	0	35	28	7
Брянская область	Государственные, муниципальные (без учета организаций в ведении ФСИН); Очная	   именные стипендии, учрежденные: органами местного самоуправления / 6.0	0	0	0	1	1	0
Брянская область	Государственные, муниципальные (без учета организаций в ведении ФСИН); Очная	   именные стипендии, учрежденные: федеральными государственными органами / 4.0	0	0	0	2	2	0
Брянская область	Государственные, муниципальные (без учета организаций в ведении ФСИН); Очная	   именные стипендии, учрежденные: физическими лицами / 9.0	0	0	0	0	0	0
Брянская область	Государственные, муниципальные (без учета организаций в ведении ФСИН); Очная	   именные стипендии, учрежденные: юридическими лицами / 7.0	0	0	0	19	19	0
Брянская область	Государственные, муниципальные (без учета организаций в ведении ФСИН); Очная	   полученных от приносящей доход деятельности / 17.0	0	0	0	18	18	0
Брянская область	Государственные, муниципальные (без учета организаций в ведении ФСИН); Очная	   стипендии Правительства Российской Федерации / 3.0	14	11	3	45	37	8
Брянская область	Государственные, муниципальные (без учета организаций в ведении ФСИН); Очная	"   стипендии, назначенные физическими лицами (кроме именных,
   указанных в строке 09) / 12.0"	0	0	0	0	0	0
Брянская область	Государственные, муниципальные (без учета организаций в ведении ФСИН); Очная	"   стипендии, назначенные юридическими лицами (кроме именных,
   указанных в строке 07) / 10.0"	0	0	0	51	51	0
Брянская область	Государственные, муниципальные (без учета организаций в ведении ФСИН); Очная	Численность студентов, получающих другие формы материальной поддержки / 14.0	758	714	44	3575	3251	324
Брянская область	Государственные, муниципальные (без учета организаций в ведении ФСИН); Очная	Численность студентов, получающих: государственные академические стипендии / 1.0	4825	4139	686	11295	9973	1322
Владимирская область	Государственные, муниципальные (без учета организаций в ведении ФСИН); Очная	      в том числе студентам, направленным ими на обучение / 11.0	12	12	0	118	99	19
Владимирская область	Государственные, муниципальные (без учета организаций в ведении ФСИН); Очная	      в том числе студентам, направленным ими на обучение / 13.0	0	0	0	0	0	0
Владимирская область	Государственные, муниципальные (без учета организаций в ведении ФСИН); Очная	      из них организацией, студентами которой они являются / 8.0	0	0	0	0	0	0
Владимирская область	Государственные, муниципальные (без учета организаций в ведении ФСИН); Очная	   бюджетных ассигнований бюджета субъекта Российской Федерации / 16.0	418	418	0	736	662	74
Владимирская область	Государственные, муниципальные (без учета организаций в ведении ФСИН); Очная	   государственные социальные стипендии / 2.0	1083	1043	40	1958	1720	238
Владимирская область	Государственные, муниципальные (без учета организаций в ведении ФСИН); Очная	"   из них за счет средств: 
   стипендиального фонда / 15.0"	288	274	14	1574	1390	184
Владимирская область	Государственные, муниципальные (без учета организаций в ведении ФСИН); Очная	"   именные стипендии, учрежденные: 
   органами государственной власти субъекта Российской Федерации / 5.0"	9	9	0	22	19	3
Владимирская область	Государственные, муниципальные (без учета организаций в ведении ФСИН); Очная	   именные стипендии, учрежденные: органами местного самоуправления / 6.0	0	0	0	3	3	0
Владимирская область	Государственные, муниципальные (без учета организаций в ведении ФСИН); Очная	   именные стипендии, учрежденные: федеральными государственными органами / 4.0	0	0	0	0	0	0
Владимирская область	Государственные, муниципальные (без учета организаций в ведении ФСИН); Очная	   именные стипендии, учрежденные: физическими лицами / 9.0	0	0	0	0	0	0
Владимирская область	Государственные, муниципальные (без учета организаций в ведении ФСИН); Очная	   именные стипендии, учрежденные: юридическими лицами / 7.0	1	1	0	8	4	4
Владимирская область	Государственные, муниципальные (без учета организаций в ведении ФСИН); Очная	   полученных от приносящей доход деятельности / 17.0	1	1	0	13	6	7
Владимирская область	Государственные, муниципальные (без учета организаций в ведении ФСИН); Очная	   стипендии Правительства Российской Федерации / 3.0	28	28	0	45	43	2
Владимирская область	Государственные, муниципальные (без учета организаций в ведении ФСИН); Очная	"   стипендии, назначенные физическими лицами (кроме именных,
   указанных в строке 09) / 12.0"	0	0	0	0	0	0
Владимирская область	Государственные, муниципальные (без учета организаций в ведении ФСИН); Очная	"   стипендии, назначенные юридическими лицами (кроме именных,
   указанных в строке 07) / 10.0"	12	12	0	118	99	19
Владимирская область	Государственные, муниципальные (без учета организаций в ведении ФСИН); Очная	Численность студентов, получающих другие формы материальной поддержки / 14.0	707	693	14	2164	1944	220
Владимирская область	Государственные, муниципальные (без учета организаций в ведении ФСИН); Очная	Численность студентов, получающих: государственные академические стипендии / 1.0	3233	3148	85	8999	8132	867
Владимирская область	Частные; Очная	      в том числе студентам, направленным ими на обучение / 11.0	0	0	0	0	0	0
Владимирская область	Частные; Очная	      в том числе студентам, направленным ими на обучение / 13.0	0	0	0	0	0	0
Владимирская область	Частные; Очная	      из них организацией, студентами которой они являются / 8.0	0	0	0	0	0	0
Владимирская область	Частные; Очная	   бюджетных ассигнований бюджета субъекта Российской Федерации / 16.0	0	0	0	350	350	0
Владимирская область	Частные; Очная	   государственные социальные стипендии / 2.0	0	0	0	21	21	0
Владимирская область	Частные; Очная	"   из них за счет средств: 
   стипендиального фонда / 15.0"	0	0	0	0	0	0
Владимирская область	Частные; Очная	"   именные стипендии, учрежденные: 
   органами государственной власти субъекта Российской Федерации / 5.0"	0	0	0	0	0	0
Владимирская область	Частные; Очная	   именные стипендии, учрежденные: органами местного самоуправления / 6.0	0	0	0	0	0	0
Владимирская область	Частные; Очная	   именные стипендии, учрежденные: федеральными государственными органами / 4.0	0	0	0	0	0	0
Владимирская область	Частные; Очная	   именные стипендии, учрежденные: физическими лицами / 9.0	0	0	0	0	0	0
Владимирская область	Частные; Очная	   именные стипендии, учрежденные: юридическими лицами / 7.0	0	0	0	0	0	0
Владимирская область	Частные; Очная	   полученных от приносящей доход деятельности / 17.0	0	0	0	0	0	0
Владимирская область	Частные; Очная	   стипендии Правительства Российской Федерации / 3.0	0	0	0	0	0	0
Владимирская область	Частные; Очная	"   стипендии, назначенные физическими лицами (кроме именных,
   указанных в строке 09) / 12.0"	0	0	0	0	0	0
Владимирская область	Частные; Очная	"   стипендии, назначенные юридическими лицами (кроме именных,
   указанных в строке 07) / 10.0"	0	0	0	0	0	0
Владимирская область	Частные; Очная	Численность студентов, получающих другие формы материальной поддержки / 14.0	0	0	0	350	350	0
Владимирская область	Частные; Очная	Численность студентов, получающих: государственные академические стипендии / 1.0	0	0	0	284	284	0
Волгоградская область	Государственные, муниципальные (без учета организаций в ведении ФСИН); Очная	      в том числе студентам, направленным ими на обучение / 11.0	0	0	0	0	0	0
Волгоградская область	Государственные, муниципальные (без учета организаций в ведении ФСИН); Очная	      в том числе студентам, направленным ими на обучение / 13.0	0	0	0	0	0	0
Волгоградская область	Государственные, муниципальные (без учета организаций в ведении ФСИН); Очная	      из них организацией, студентами которой они являются / 8.0	0	0	0	0	0	0
Волгоградская область	Государственные, муниципальные (без учета организаций в ведении ФСИН); Очная	   бюджетных ассигнований бюджета субъекта Российской Федерации / 16.0	126	126	0	364	352	12
Волгоградская область	Государственные, муниципальные (без учета организаций в ведении ФСИН); Очная	   государственные социальные стипендии / 2.0	694	681	13	2440	2181	259
Волгоградская область	Государственные, муниципальные (без учета организаций в ведении ФСИН); Очная	"   из них за счет средств: 
   стипендиального фонда / 15.0"	171	133	38	1148	945	203
Волгоградская область	Государственные, муниципальные (без учета организаций в ведении ФСИН); Очная	"   именные стипендии, учрежденные: 
   органами государственной власти субъекта Российской Федерации / 5.0"	19	17	2	72	63	9
Волгоградская область	Государственные, муниципальные (без учета организаций в ведении ФСИН); Очная	   именные стипендии, учрежденные: органами местного самоуправления / 6.0	0	0	0	6	6	0
Волгоградская область	Государственные, муниципальные (без учета организаций в ведении ФСИН); Очная	   именные стипендии, учрежденные: федеральными государственными органами / 4.0	1	1	0	33	29	4
Волгоградская область	Государственные, муниципальные (без учета организаций в ведении ФСИН); Очная	   именные стипендии, учрежденные: физическими лицами / 9.0	0	0	0	0	0	0
Волгоградская область	Государственные, муниципальные (без учета организаций в ведении ФСИН); Очная	   именные стипендии, учрежденные: юридическими лицами / 7.0	0	0	0	20	20	0
Волгоградская область	Государственные, муниципальные (без учета организаций в ведении ФСИН); Очная	   полученных от приносящей доход деятельности / 17.0	0	0	0	48	48	0
Волгоградская область	Государственные, муниципальные (без учета организаций в ведении ФСИН); Очная	   стипендии Правительства Российской Федерации / 3.0	5	5	0	58	57	1
Волгоградская область	Государственные, муниципальные (без учета организаций в ведении ФСИН); Очная	"   стипендии, назначенные физическими лицами (кроме именных,
   указанных в строке 09) / 12.0"	0	0	0	0	0	0
Волгоградская область	Государственные, муниципальные (без учета организаций в ведении ФСИН); Очная	"   стипендии, назначенные юридическими лицами (кроме именных,
   указанных в строке 07) / 10.0"	0	0	0	351	351	0
Волгоградская область	Государственные, муниципальные (без учета организаций в ведении ФСИН); Очная	Численность студентов, получающих другие формы материальной поддержки / 14.0	297	259	38	1601	1386	215
Волгоградская область	Государственные, муниципальные (без учета организаций в ведении ФСИН); Очная	Численность студентов, получающих: государственные академические стипендии / 1.0	3606	3507	99	17916	16238	1678
Волгоградская область	Частные; Очная	      в том числе студентам, направленным ими на обучение / 11.0	0	0	0	0	0	0
Волгоградская область	Частные; Очная	      в том числе студентам, направленным ими на обучение / 13.0	0	0	0	0	0	0
Волгоградская область	Частные; Очная	      из них организацией, студентами которой они являются / 8.0	0	0	0	0	0	0
Волгоградская область	Частные; Очная	   бюджетных ассигнований бюджета субъекта Российской Федерации / 16.0	0	0	0	0	0	0
Волгоградская область	Частные; Очная	   государственные социальные стипендии / 2.0	0	0	0	3	3	0
Волгоградская область	Частные; Очная	"   из них за счет средств: 
   стипендиального фонда / 15.0"	0	0	0	248	229	19
Волгоградская область	Частные; Очная	"   именные стипендии, учрежденные: 
   органами государственной власти субъекта Российской Федерации / 5.0"	0	0	0	0	0	0
Волгоградская область	Частные; Очная	   именные стипендии, учрежденные: органами местного самоуправления / 6.0	0	0	0	1	1	0
Волгоградская область	Частные; Очная	   именные стипендии, учрежденные: федеральными государственными органами / 4.0	0	0	0	0	0	0
Волгоградская область	Частные; Очная	   именные стипендии, учрежденные: физическими лицами / 9.0	0	0	0	0	0	0
Волгоградская область	Частные; Очная	   именные стипендии, учрежденные: юридическими лицами / 7.0	0	0	0	0	0	0
Волгоградская область	Частные; Очная	   полученных от приносящей доход деятельности / 17.0	0	0	0	0	0	0
Волгоградская область	Частные; Очная	   стипендии Правительства Российской Федерации / 3.0	0	0	0	0	0	0
Волгоградская область	Частные; Очная	"   стипендии, назначенные физическими лицами (кроме именных,
   указанных в строке 09) / 12.0"	0	0	0	0	0	0
Волгоградская область	Частные; Очная	"   стипендии, назначенные юридическими лицами (кроме именных,
   указанных в строке 07) / 10.0"	0	0	0	0	0	0
Волгоградская область	Частные; Очная	Численность студентов, получающих другие формы материальной поддержки / 14.0	0	0	0	248	229	19
Волгоградская область	Частные; Очная	Численность студентов, получающих: государственные академические стипендии / 1.0	0	0	0	2	2	0
Вологодская область	Государственные, муниципальные (без учета организаций в ведении ФСИН); Очная	      в том числе студентам, направленным ими на обучение / 11.0	0	0	0	56	56	0
Вологодская область	Государственные, муниципальные (без учета организаций в ведении ФСИН); Очная	      в том числе студентам, направленным ими на обучение / 13.0	0	0	0	0	0	0
Вологодская область	Государственные, муниципальные (без учета организаций в ведении ФСИН); Очная	      из них организацией, студентами которой они являются / 8.0	0	0	0	3	3	0
Вологодская область	Государственные, муниципальные (без учета организаций в ведении ФСИН); Очная	   бюджетных ассигнований бюджета субъекта Российской Федерации / 16.0	223	223	0	419	404	15
Вологодская область	Государственные, муниципальные (без учета организаций в ведении ФСИН); Очная	   государственные социальные стипендии / 2.0	1411	1411	0	4186	3903	283
Вологодская область	Государственные, муниципальные (без учета организаций в ведении ФСИН); Очная	"   из них за счет средств: 
   стипендиального фонда / 15.0"	490	490	0	2575	2365	210
Вологодская область	Государственные, муниципальные (без учета организаций в ведении ФСИН); Очная	"   именные стипендии, учрежденные: 
   органами государственной власти субъекта Российской Федерации / 5.0"	0	0	0	94	94	0
Вологодская область	Государственные, муниципальные (без учета организаций в ведении ФСИН); Очная	   именные стипендии, учрежденные: органами местного самоуправления / 6.0	0	0	0	2	2	0
Вологодская область	Государственные, муниципальные (без учета организаций в ведении ФСИН); Очная	   именные стипендии, учрежденные: федеральными государственными органами / 4.0	0	0	0	0	0	0
Вологодская область	Государственные, муниципальные (без учета организаций в ведении ФСИН); Очная	   именные стипендии, учрежденные: физическими лицами / 9.0	0	0	0	0	0	0
Вологодская область	Государственные, муниципальные (без учета организаций в ведении ФСИН); Очная	   именные стипендии, учрежденные: юридическими лицами / 7.0	0	0	0	3	3	0
Вологодская область	Государственные, муниципальные (без учета организаций в ведении ФСИН); Очная	   полученных от приносящей доход деятельности / 17.0	0	0	0	0	0	0
Вологодская область	Государственные, муниципальные (без учета организаций в ведении ФСИН); Очная	   стипендии Правительства Российской Федерации / 3.0	11	11	0	39	33	6
Вологодская область	Государственные, муниципальные (без учета организаций в ведении ФСИН); Очная	"   стипендии, назначенные физическими лицами (кроме именных,
   указанных в строке 09) / 12.0"	0	0	0	0	0	0
Вологодская область	Государственные, муниципальные (без учета организаций в ведении ФСИН); Очная	"   стипендии, назначенные юридическими лицами (кроме именных,
   указанных в строке 07) / 10.0"	0	0	0	56	56	0
Вологодская область	Государственные, муниципальные (без учета организаций в ведении ФСИН); Очная	Численность студентов, получающих другие формы материальной поддержки / 14.0	713	713	0	3005	2792	213
Вологодская область	Государственные, муниципальные (без учета организаций в ведении ФСИН); Очная	Численность студентов, получающих: государственные академические стипендии / 1.0	3092	2876	216	11949	11211	738
Вологодская область	Частные; Очная	      в том числе студентам, направленным ими на обучение / 11.0	0	0	0	0	0	0
Вологодская область	Частные; Очная	      в том числе студентам, направленным ими на обучение / 13.0	0	0	0	0	0	0
Вологодская область	Частные; Очная	      из них организацией, студентами которой они являются / 8.0	0	0	0	0	0	0
Вологодская область	Частные; Очная	   бюджетных ассигнований бюджета субъекта Российской Федерации / 16.0	0	0	0	4	4	0
Вологодская область	Частные; Очная	   государственные социальные стипендии / 2.0	0	0	0	83	83	0
Вологодская область	Частные; Очная	"   из них за счет средств: 
   стипендиального фонда / 15.0"	0	0	0	0	0	0
Вологодская область	Частные; Очная	"   именные стипендии, учрежденные: 
   органами государственной власти субъекта Российской Федерации / 5.0"	0	0	0	0	0	0
Вологодская область	Частные; Очная	   именные стипендии, учрежденные: органами местного самоуправления / 6.0	0	0	0	0	0	0
Вологодская область	Частные; Очная	   именные стипендии, учрежденные: федеральными государственными органами / 4.0	0	0	0	0	0	0
Вологодская область	Частные; Очная	   именные стипендии, учрежденные: физическими лицами / 9.0	0	0	0	0	0	0
Вологодская область	Частные; Очная	   именные стипендии, учрежденные: юридическими лицами / 7.0	0	0	0	0	0	0
Вологодская область	Частные; Очная	   полученных от приносящей доход деятельности / 17.0	0	0	0	0	0	0
Вологодская область	Частные; Очная	   стипендии Правительства Российской Федерации / 3.0	0	0	0	29	29	0
Вологодская область	Частные; Очная	"   стипендии, назначенные физическими лицами (кроме именных,
   указанных в строке 09) / 12.0"	0	0	0	0	0	0
Вологодская область	Частные; Очная	"   стипендии, назначенные юридическими лицами (кроме именных,
   указанных в строке 07) / 10.0"	0	0	0	0	0	0
Вологодская область	Частные; Очная	Численность студентов, получающих другие формы материальной поддержки / 14.0	0	0	0	4	4	0
Вологодская область	Частные; Очная	Численность студентов, получающих: государственные академические стипендии / 1.0	0	0	0	0	0	0
Воронежская область	Государственные, муниципальные (без учета организаций в ведении ФСИН); Очная	      в том числе студентам, направленным ими на обучение / 11.0	0	0	0	187	187	0
Воронежская область	Государственные, муниципальные (без учета организаций в ведении ФСИН); Очная	      в том числе студентам, направленным ими на обучение / 13.0	0	0	0	0	0	0
Воронежская область	Государственные, муниципальные (без учета организаций в ведении ФСИН); Очная	      из них организацией, студентами которой они являются / 8.0	0	0	0	5	3	2
Воронежская область	Государственные, муниципальные (без учета организаций в ведении ФСИН); Очная	   бюджетных ассигнований бюджета субъекта Российской Федерации / 16.0	179	179	0	187	183	4
Воронежская область	Государственные, муниципальные (без учета организаций в ведении ФСИН); Очная	   государственные социальные стипендии / 2.0	654	650	4	2438	2232	206
Воронежская область	Государственные, муниципальные (без учета организаций в ведении ФСИН); Очная	"   из них за счет средств: 
   стипендиального фонда / 15.0"	0	0	0	583	577	6
Воронежская область	Государственные, муниципальные (без учета организаций в ведении ФСИН); Очная	"   именные стипендии, учрежденные: 
   органами государственной власти субъекта Российской Федерации / 5.0"	8	8	0	48	47	1
Воронежская область	Государственные, муниципальные (без учета организаций в ведении ФСИН); Очная	   именные стипендии, учрежденные: органами местного самоуправления / 6.0	1	1	0	2	2	0
Воронежская область	Государственные, муниципальные (без учета организаций в ведении ФСИН); Очная	   именные стипендии, учрежденные: федеральными государственными органами / 4.0	0	0	0	9	6	3
Воронежская область	Государственные, муниципальные (без учета организаций в ведении ФСИН); Очная	   именные стипендии, учрежденные: физическими лицами / 9.0	0	0	0	1	1	0
Воронежская область	Государственные, муниципальные (без учета организаций в ведении ФСИН); Очная	   именные стипендии, учрежденные: юридическими лицами / 7.0	0	0	0	13	11	2
Воронежская область	Государственные, муниципальные (без учета организаций в ведении ФСИН); Очная	   полученных от приносящей доход деятельности / 17.0	21	21	0	71	69	2
Воронежская область	Государственные, муниципальные (без учета организаций в ведении ФСИН); Очная	   стипендии Правительства Российской Федерации / 3.0	25	25	0	89	79	10
Воронежская область	Государственные, муниципальные (без учета организаций в ведении ФСИН); Очная	"   стипендии, назначенные физическими лицами (кроме именных,
   указанных в строке 09) / 12.0"	0	0	0	0	0	0
Воронежская область	Государственные, муниципальные (без учета организаций в ведении ФСИН); Очная	"   стипендии, назначенные юридическими лицами (кроме именных,
   указанных в строке 07) / 10.0"	4	4	0	190	190	0
Воронежская область	Государственные, муниципальные (без учета организаций в ведении ФСИН); Очная	Численность студентов, получающих другие формы материальной поддержки / 14.0	331	330	1	1869	1856	13
Воронежская область	Государственные, муниципальные (без учета организаций в ведении ФСИН); Очная	Численность студентов, получающих: государственные академические стипендии / 1.0	3132	3049	83	17959	16745	1214
Воронежская область	Частные; Очная	      в том числе студентам, направленным ими на обучение / 11.0	0	0	0	0	0	0
Воронежская область	Частные; Очная	      в том числе студентам, направленным ими на обучение / 13.0	0	0	0	0	0	0
Воронежская область	Частные; Очная	      из них организацией, студентами которой они являются / 8.0	0	0	0	0	0	0
Воронежская область	Частные; Очная	   бюджетных ассигнований бюджета субъекта Российской Федерации / 16.0	0	0	0	0	0	0
Воронежская область	Частные; Очная	   государственные социальные стипендии / 2.0	0	0	0	3	3	0
Воронежская область	Частные; Очная	"   из них за счет средств: 
   стипендиального фонда / 15.0"	0	0	0	0	0	0
Воронежская область	Частные; Очная	"   именные стипендии, учрежденные: 
   органами государственной власти субъекта Российской Федерации / 5.0"	0	0	0	1	1	0
Воронежская область	Частные; Очная	   именные стипендии, учрежденные: органами местного самоуправления / 6.0	0	0	0	0	0	0
Воронежская область	Частные; Очная	   именные стипендии, учрежденные: федеральными государственными органами / 4.0	0	0	0	0	0	0
Воронежская область	Частные; Очная	   именные стипендии, учрежденные: физическими лицами / 9.0	0	0	0	0	0	0
Воронежская область	Частные; Очная	   именные стипендии, учрежденные: юридическими лицами / 7.0	0	0	0	0	0	0
Воронежская область	Частные; Очная	   полученных от приносящей доход деятельности / 17.0	0	0	0	0	0	0
Воронежская область	Частные; Очная	   стипендии Правительства Российской Федерации / 3.0	0	0	0	6	6	0
Воронежская область	Частные; Очная	"   стипендии, назначенные физическими лицами (кроме именных,
   указанных в строке 09) / 12.0"	0	0	0	0	0	0
Воронежская область	Частные; Очная	"   стипендии, назначенные юридическими лицами (кроме именных,
   указанных в строке 07) / 10.0"	0	0	0	0	0	0
Воронежская область	Частные; Очная	Численность студентов, получающих другие формы материальной поддержки / 14.0	0	0	0	0	0	0
Воронежская область	Частные; Очная	Численность студентов, получающих: государственные академические стипендии / 1.0	0	0	0	133	133	0
Еврейская автономная область	Государственные, муниципальные (без учета организаций в ведении ФСИН); Очная	      в том числе студентам, направленным ими на обучение / 11.0	31	31	0	0	0	0
Еврейская автономная область	Государственные, муниципальные (без учета организаций в ведении ФСИН); Очная	      в том числе студентам, направленным ими на обучение / 13.0	0	0	0	0	0	0
Еврейская автономная область	Государственные, муниципальные (без учета организаций в ведении ФСИН); Очная	      из них организацией, студентами которой они являются / 8.0	0	0	0	0	0	0
Еврейская автономная область	Государственные, муниципальные (без учета организаций в ведении ФСИН); Очная	   бюджетных ассигнований бюджета субъекта Российской Федерации / 16.0	19	19	0	17	0	17
Еврейская автономная область	Государственные, муниципальные (без учета организаций в ведении ФСИН); Очная	   государственные социальные стипендии / 2.0	187	187	0	230	151	79
Еврейская автономная область	Государственные, муниципальные (без учета организаций в ведении ФСИН); Очная	"   из них за счет средств: 
   стипендиального фонда / 15.0"	0	0	0	119	119	0
Еврейская автономная область	Государственные, муниципальные (без учета организаций в ведении ФСИН); Очная	"   именные стипендии, учрежденные: 
   органами государственной власти субъекта Российской Федерации / 5.0"	1	1	0	5	4	1
Еврейская автономная область	Государственные, муниципальные (без учета организаций в ведении ФСИН); Очная	   именные стипендии, учрежденные: органами местного самоуправления / 6.0	0	0	0	0	0	0
Еврейская автономная область	Государственные, муниципальные (без учета организаций в ведении ФСИН); Очная	   именные стипендии, учрежденные: федеральными государственными органами / 4.0	0	0	0	1	0	1
Еврейская автономная область	Государственные, муниципальные (без учета организаций в ведении ФСИН); Очная	   именные стипендии, учрежденные: физическими лицами / 9.0	0	0	0	0	0	0
Еврейская автономная область	Государственные, муниципальные (без учета организаций в ведении ФСИН); Очная	   именные стипендии, учрежденные: юридическими лицами / 7.0	0	0	0	1	1	0
Еврейская автономная область	Государственные, муниципальные (без учета организаций в ведении ФСИН); Очная	   полученных от приносящей доход деятельности / 17.0	0	0	0	0	0	0
Еврейская автономная область	Государственные, муниципальные (без учета организаций в ведении ФСИН); Очная	   стипендии Правительства Российской Федерации / 3.0	0	0	0	0	0	0
Еврейская автономная область	Государственные, муниципальные (без учета организаций в ведении ФСИН); Очная	"   стипендии, назначенные физическими лицами (кроме именных,
   указанных в строке 09) / 12.0"	0	0	0	0	0	0
Еврейская автономная область	Государственные, муниципальные (без учета организаций в ведении ФСИН); Очная	"   стипендии, назначенные юридическими лицами (кроме именных,
   указанных в строке 07) / 10.0"	31	31	0	0	0	0
Еврейская автономная область	Государственные, муниципальные (без учета организаций в ведении ФСИН); Очная	Численность студентов, получающих другие формы материальной поддержки / 14.0	19	19	0	136	119	17
Еврейская автономная область	Государственные, муниципальные (без учета организаций в ведении ФСИН); Очная	Численность студентов, получающих: государственные академические стипендии / 1.0	338	333	5	690	313	377
Забайкальский край	Государственные, муниципальные (без учета организаций в ведении ФСИН); Очная	      в том числе студентам, направленным ими на обучение / 11.0	2	2	0	165	155	10
Забайкальский край	Государственные, муниципальные (без учета организаций в ведении ФСИН); Очная	      в том числе студентам, направленным ими на обучение / 13.0	0	0	0	0	0	0
Забайкальский край	Государственные, муниципальные (без учета организаций в ведении ФСИН); Очная	      из них организацией, студентами которой они являются / 8.0	0	0	0	0	0	0
Забайкальский край	Государственные, муниципальные (без учета организаций в ведении ФСИН); Очная	   бюджетных ассигнований бюджета субъекта Российской Федерации / 16.0	51	51	0	52	23	29
Забайкальский край	Государственные, муниципальные (без учета организаций в ведении ФСИН); Очная	   государственные социальные стипендии / 2.0	924	916	8	1127	917	210
Забайкальский край	Государственные, муниципальные (без учета организаций в ведении ФСИН); Очная	"   из них за счет средств: 
   стипендиального фонда / 15.0"	0	0	0	804	732	72
Забайкальский край	Государственные, муниципальные (без учета организаций в ведении ФСИН); Очная	"   именные стипендии, учрежденные: 
   органами государственной власти субъекта Российской Федерации / 5.0"	4	4	0	3	3	0
Забайкальский край	Государственные, муниципальные (без учета организаций в ведении ФСИН); Очная	   именные стипендии, учрежденные: органами местного самоуправления / 6.0	0	0	0	1	1	0
Забайкальский край	Государственные, муниципальные (без учета организаций в ведении ФСИН); Очная	   именные стипендии, учрежденные: федеральными государственными органами / 4.0	3	3	0	0	0	0
Забайкальский край	Государственные, муниципальные (без учета организаций в ведении ФСИН); Очная	   именные стипендии, учрежденные: физическими лицами / 9.0	0	0	0	0	0	0
Забайкальский край	Государственные, муниципальные (без учета организаций в ведении ФСИН); Очная	   именные стипендии, учрежденные: юридическими лицами / 7.0	0	0	0	10	10	0
Забайкальский край	Государственные, муниципальные (без учета организаций в ведении ФСИН); Очная	   полученных от приносящей доход деятельности / 17.0	1	1	0	89	68	21
Забайкальский край	Государственные, муниципальные (без учета организаций в ведении ФСИН); Очная	   стипендии Правительства Российской Федерации / 3.0	10	10	0	29	25	4
Забайкальский край	Государственные, муниципальные (без учета организаций в ведении ФСИН); Очная	"   стипендии, назначенные физическими лицами (кроме именных,
   указанных в строке 09) / 12.0"	0	0	0	0	0	0
Забайкальский край	Государственные, муниципальные (без учета организаций в ведении ФСИН); Очная	"   стипендии, назначенные юридическими лицами (кроме именных,
   указанных в строке 07) / 10.0"	2	2	0	177	160	17
Забайкальский край	Государственные, муниципальные (без учета организаций в ведении ФСИН); Очная	Численность студентов, получающих другие формы материальной поддержки / 14.0	103	103	0	945	823	122
Забайкальский край	Государственные, муниципальные (без учета организаций в ведении ФСИН); Очная	Численность студентов, получающих: государственные академические стипендии / 1.0	2850	2786	64	5429	4376	1053
Забайкальский край	Частные; Очная	      в том числе студентам, направленным ими на обучение / 11.0	0	0	0	0	0	0
Забайкальский край	Частные; Очная	      в том числе студентам, направленным ими на обучение / 13.0	0	0	0	0	0	0
Забайкальский край	Частные; Очная	      из них организацией, студентами которой они являются / 8.0	0	0	0	0	0	0
Забайкальский край	Частные; Очная	   бюджетных ассигнований бюджета субъекта Российской Федерации / 16.0	0	0	0	0	0	0
Забайкальский край	Частные; Очная	   государственные социальные стипендии / 2.0	0	0	0	1	1	0
Забайкальский край	Частные; Очная	"   из них за счет средств: 
   стипендиального фонда / 15.0"	0	0	0	0	0	0
Забайкальский край	Частные; Очная	"   именные стипендии, учрежденные: 
   органами государственной власти субъекта Российской Федерации / 5.0"	0	0	0	44	44	0
Забайкальский край	Частные; Очная	   именные стипендии, учрежденные: органами местного самоуправления / 6.0	0	0	0	0	0	0
Забайкальский край	Частные; Очная	   именные стипендии, учрежденные: федеральными государственными органами / 4.0	0	0	0	0	0	0
Забайкальский край	Частные; Очная	   именные стипендии, учрежденные: физическими лицами / 9.0	0	0	0	0	0	0
Забайкальский край	Частные; Очная	   именные стипендии, учрежденные: юридическими лицами / 7.0	0	0	0	0	0	0
Забайкальский край	Частные; Очная	   полученных от приносящей доход деятельности / 17.0	0	0	0	0	0	0
Забайкальский край	Частные; Очная	   стипендии Правительства Российской Федерации / 3.0	0	0	0	0	0	0
Забайкальский край	Частные; Очная	"   стипендии, назначенные физическими лицами (кроме именных,
   указанных в строке 09) / 12.0"	0	0	0	0	0	0
Забайкальский край	Частные; Очная	"   стипендии, назначенные юридическими лицами (кроме именных,
   указанных в строке 07) / 10.0"	0	0	0	0	0	0
Забайкальский край	Частные; Очная	Численность студентов, получающих другие формы материальной поддержки / 14.0	0	0	0	0	0	0
Забайкальский край	Частные; Очная	Численность студентов, получающих: государственные академические стипендии / 1.0	0	0	0	0	0	0
Ивановская область	Государственные, муниципальные (без учета организаций в ведении ФСИН); Очная	      в том числе студентам, направленным ими на обучение / 11.0	0	0	0	0	0	0
Ивановская область	Государственные, муниципальные (без учета организаций в ведении ФСИН); Очная	      в том числе студентам, направленным ими на обучение / 13.0	0	0	0	0	0	0
Ивановская область	Государственные, муниципальные (без учета организаций в ведении ФСИН); Очная	      из них организацией, студентами которой они являются / 8.0	0	0	0	22	11	11
Ивановская область	Государственные, муниципальные (без учета организаций в ведении ФСИН); Очная	   бюджетных ассигнований бюджета субъекта Российской Федерации / 16.0	75	75	0	124	111	13
Ивановская область	Государственные, муниципальные (без учета организаций в ведении ФСИН); Очная	   государственные социальные стипендии / 2.0	518	463	55	1605	1267	338
Ивановская область	Государственные, муниципальные (без учета организаций в ведении ФСИН); Очная	"   из них за счет средств: 
   стипендиального фонда / 15.0"	147	133	14	384	293	91
Ивановская область	Государственные, муниципальные (без учета организаций в ведении ФСИН); Очная	"   именные стипендии, учрежденные: 
   органами государственной власти субъекта Российской Федерации / 5.0"	0	0	0	0	0	0
Ивановская область	Государственные, муниципальные (без учета организаций в ведении ФСИН); Очная	   именные стипендии, учрежденные: органами местного самоуправления / 6.0	1	1	0	0	0	0
Ивановская область	Государственные, муниципальные (без учета организаций в ведении ФСИН); Очная	   именные стипендии, учрежденные: федеральными государственными органами / 4.0	0	0	0	0	0	0
Ивановская область	Государственные, муниципальные (без учета организаций в ведении ФСИН); Очная	   именные стипендии, учрежденные: физическими лицами / 9.0	0	0	0	0	0	0
Ивановская область	Государственные, муниципальные (без учета организаций в ведении ФСИН); Очная	   именные стипендии, учрежденные: юридическими лицами / 7.0	0	0	0	22	11	11
Ивановская область	Государственные, муниципальные (без учета организаций в ведении ФСИН); Очная	   полученных от приносящей доход деятельности / 17.0	0	0	0	6	5	1
Ивановская область	Государственные, муниципальные (без учета организаций в ведении ФСИН); Очная	   стипендии Правительства Российской Федерации / 3.0	17	16	1	30	24	6
Ивановская область	Государственные, муниципальные (без учета организаций в ведении ФСИН); Очная	"   стипендии, назначенные физическими лицами (кроме именных,
   указанных в строке 09) / 12.0"	0	0	0	0	0	0
Ивановская область	Государственные, муниципальные (без учета организаций в ведении ФСИН); Очная	"   стипендии, назначенные юридическими лицами (кроме именных,
   указанных в строке 07) / 10.0"	0	0	0	9	9	0
Ивановская область	Государственные, муниципальные (без учета организаций в ведении ФСИН); Очная	Численность студентов, получающих другие формы материальной поддержки / 14.0	226	212	14	517	412	105
Ивановская область	Государственные, муниципальные (без учета организаций в ведении ФСИН); Очная	Численность студентов, получающих: государственные академические стипендии / 1.0	2198	2052	146	7102	5936	1166
Ивановская область	Частные; Очная	      в том числе студентам, направленным ими на обучение / 11.0	0	0	0	0	0	0
Ивановская область	Частные; Очная	      в том числе студентам, направленным ими на обучение / 13.0	0	0	0	0	0	0
Ивановская область	Частные; Очная	      из них организацией, студентами которой они являются / 8.0	0	0	0	0	0	0
Ивановская область	Частные; Очная	   бюджетных ассигнований бюджета субъекта Российской Федерации / 16.0	0	0	0	0	0	0
Ивановская область	Частные; Очная	   государственные социальные стипендии / 2.0	0	0	0	23	23	0
Ивановская область	Частные; Очная	"   из них за счет средств: 
   стипендиального фонда / 15.0"	0	0	0	0	0	0
Ивановская область	Частные; Очная	"   именные стипендии, учрежденные: 
   органами государственной власти субъекта Российской Федерации / 5.0"	0	0	0	0	0	0
Ивановская область	Частные; Очная	   именные стипендии, учрежденные: органами местного самоуправления / 6.0	0	0	0	0	0	0
Ивановская область	Частные; Очная	   именные стипендии, учрежденные: федеральными государственными органами / 4.0	0	0	0	0	0	0
Ивановская область	Частные; Очная	   именные стипендии, учрежденные: физическими лицами / 9.0	0	0	0	0	0	0
Ивановская область	Частные; Очная	   именные стипендии, учрежденные: юридическими лицами / 7.0	0	0	0	0	0	0
Ивановская область	Частные; Очная	   полученных от приносящей доход деятельности / 17.0	0	0	0	0	0	0
Ивановская область	Частные; Очная	   стипендии Правительства Российской Федерации / 3.0	0	0	0	2	2	0
Ивановская область	Частные; Очная	"   стипендии, назначенные физическими лицами (кроме именных,
   указанных в строке 09) / 12.0"	0	0	0	0	0	0
Ивановская область	Частные; Очная	"   стипендии, назначенные юридическими лицами (кроме именных,
   указанных в строке 07) / 10.0"	0	0	0	0	0	0
Ивановская область	Частные; Очная	Численность студентов, получающих другие формы материальной поддержки / 14.0	0	0	0	0	0	0
Ивановская область	Частные; Очная	Численность студентов, получающих: государственные академические стипендии / 1.0	0	0	0	95	95	0
Иркутская область	Государственные, муниципальные (без учета организаций в ведении ФСИН); Очная	      в том числе студентам, направленным ими на обучение / 11.0	1	1	0	3	3	0
Иркутская область	Государственные, муниципальные (без учета организаций в ведении ФСИН); Очная	      в том числе студентам, направленным ими на обучение / 13.0	1	1	0	0	0	0
Иркутская область	Государственные, муниципальные (без учета организаций в ведении ФСИН); Очная	      из них организацией, студентами которой они являются / 8.0	0	0	0	1	1	0
Иркутская область	Государственные, муниципальные (без учета организаций в ведении ФСИН); Очная	   бюджетных ассигнований бюджета субъекта Российской Федерации / 16.0	844	842	2	1231	1160	71
Иркутская область	Государственные, муниципальные (без учета организаций в ведении ФСИН); Очная	   государственные социальные стипендии / 2.0	2426	2399	27	4420	3809	611
Иркутская область	Государственные, муниципальные (без учета организаций в ведении ФСИН); Очная	"   из них за счет средств: 
   стипендиального фонда / 15.0"	967	955	12	1699	1572	127
Иркутская область	Государственные, муниципальные (без учета организаций в ведении ФСИН); Очная	"   именные стипендии, учрежденные: 
   органами государственной власти субъекта Российской Федерации / 5.0"	0	0	0	72	53	19
Иркутская область	Государственные, муниципальные (без учета организаций в ведении ФСИН); Очная	   именные стипендии, учрежденные: органами местного самоуправления / 6.0	0	0	0	4	2	2
Иркутская область	Государственные, муниципальные (без учета организаций в ведении ФСИН); Очная	   именные стипендии, учрежденные: федеральными государственными органами / 4.0	0	0	0	0	0	0
Иркутская область	Государственные, муниципальные (без учета организаций в ведении ФСИН); Очная	   именные стипендии, учрежденные: физическими лицами / 9.0	0	0	0	0	0	0
Иркутская область	Государственные, муниципальные (без учета организаций в ведении ФСИН); Очная	   именные стипендии, учрежденные: юридическими лицами / 7.0	10	10	0	139	122	17
Иркутская область	Государственные, муниципальные (без учета организаций в ведении ФСИН); Очная	   полученных от приносящей доход деятельности / 17.0	1	1	0	66	65	1
Иркутская область	Государственные, муниципальные (без учета организаций в ведении ФСИН); Очная	   стипендии Правительства Российской Федерации / 3.0	31	31	0	66	62	4
Иркутская область	Государственные, муниципальные (без учета организаций в ведении ФСИН); Очная	"   стипендии, назначенные физическими лицами (кроме именных,
   указанных в строке 09) / 12.0"	1	1	0	3	3	0
Иркутская область	Государственные, муниципальные (без учета организаций в ведении ФСИН); Очная	"   стипендии, назначенные юридическими лицами (кроме именных,
   указанных в строке 07) / 10.0"	5	5	0	21	18	3
Иркутская область	Государственные, муниципальные (без учета организаций в ведении ФСИН); Очная	Численность студентов, получающих другие формы материальной поддержки / 14.0	1309	1297	12	3007	2816	191
Иркутская область	Государственные, муниципальные (без учета организаций в ведении ФСИН); Очная	Численность студентов, получающих: государственные академические стипендии / 1.0	6742	6581	161	17860	14705	3155
Иркутская область	Частные; Очная	      в том числе студентам, направленным ими на обучение / 11.0	0	0	0	0	0	0
Иркутская область	Частные; Очная	      в том числе студентам, направленным ими на обучение / 13.0	0	0	0	0	0	0
Иркутская область	Частные; Очная	      из них организацией, студентами которой они являются / 8.0	0	0	0	0	0	0
Иркутская область	Частные; Очная	   бюджетных ассигнований бюджета субъекта Российской Федерации / 16.0	0	0	0	0	0	0
Иркутская область	Частные; Очная	   государственные социальные стипендии / 2.0	0	0	0	8	7	1
Иркутская область	Частные; Очная	"   из них за счет средств: 
   стипендиального фонда / 15.0"	0	0	0	0	0	0
Иркутская область	Частные; Очная	"   именные стипендии, учрежденные: 
   органами государственной власти субъекта Российской Федерации / 5.0"	0	0	0	0	0	0
Иркутская область	Частные; Очная	   именные стипендии, учрежденные: органами местного самоуправления / 6.0	0	0	0	0	0	0
Иркутская область	Частные; Очная	   именные стипендии, учрежденные: федеральными государственными органами / 4.0	0	0	0	0	0	0
Иркутская область	Частные; Очная	   именные стипендии, учрежденные: физическими лицами / 9.0	0	0	0	0	0	0
Иркутская область	Частные; Очная	   именные стипендии, учрежденные: юридическими лицами / 7.0	0	0	0	0	0	0
Иркутская область	Частные; Очная	   полученных от приносящей доход деятельности / 17.0	0	0	0	0	0	0
Иркутская область	Частные; Очная	   стипендии Правительства Российской Федерации / 3.0	0	0	0	0	0	0
Иркутская область	Частные; Очная	"   стипендии, назначенные физическими лицами (кроме именных,
   указанных в строке 09) / 12.0"	0	0	0	0	0	0
Иркутская область	Частные; Очная	"   стипендии, назначенные юридическими лицами (кроме именных,
   указанных в строке 07) / 10.0"	0	0	0	0	0	0
Иркутская область	Частные; Очная	Численность студентов, получающих другие формы материальной поддержки / 14.0	0	0	0	0	0	0
Иркутская область	Частные; Очная	Численность студентов, получающих: государственные академические стипендии / 1.0	0	0	0	185	180	5
Кабардино-Балкарская Республика	Государственные, муниципальные (без учета организаций в ведении ФСИН); Очная	      в том числе студентам, направленным ими на обучение / 11.0	0	0	0	0	0	0
Кабардино-Балкарская Республика	Государственные, муниципальные (без учета организаций в ведении ФСИН); Очная	      в том числе студентам, направленным ими на обучение / 13.0	0	0	0	0	0	0
Кабардино-Балкарская Республика	Государственные, муниципальные (без учета организаций в ведении ФСИН); Очная	      из них организацией, студентами которой они являются / 8.0	0	0	0	0	0	0
Кабардино-Балкарская Республика	Государственные, муниципальные (без учета организаций в ведении ФСИН); Очная	   бюджетных ассигнований бюджета субъекта Российской Федерации / 16.0	24	24	0	4	2	2
Кабардино-Балкарская Республика	Государственные, муниципальные (без учета организаций в ведении ФСИН); Очная	   государственные социальные стипендии / 2.0	282	271	11	727	524	203
Кабардино-Балкарская Республика	Государственные, муниципальные (без учета организаций в ведении ФСИН); Очная	"   из них за счет средств: 
   стипендиального фонда / 15.0"	0	0	0	76	57	19
Кабардино-Балкарская Республика	Государственные, муниципальные (без учета организаций в ведении ФСИН); Очная	"   именные стипендии, учрежденные: 
   органами государственной власти субъекта Российской Федерации / 5.0"	0	0	0	0	0	0
Кабардино-Балкарская Республика	Государственные, муниципальные (без учета организаций в ведении ФСИН); Очная	   именные стипендии, учрежденные: органами местного самоуправления / 6.0	0	0	0	0	0	0
Кабардино-Балкарская Республика	Государственные, муниципальные (без учета организаций в ведении ФСИН); Очная	   именные стипендии, учрежденные: федеральными государственными органами / 4.0	0	0	0	0	0	0
Кабардино-Балкарская Республика	Государственные, муниципальные (без учета организаций в ведении ФСИН); Очная	   именные стипендии, учрежденные: физическими лицами / 9.0	0	0	0	0	0	0
Кабардино-Балкарская Республика	Государственные, муниципальные (без учета организаций в ведении ФСИН); Очная	   именные стипендии, учрежденные: юридическими лицами / 7.0	0	0	0	0	0	0
Кабардино-Балкарская Республика	Государственные, муниципальные (без учета организаций в ведении ФСИН); Очная	   полученных от приносящей доход деятельности / 17.0	0	0	0	0	0	0
Кабардино-Балкарская Республика	Государственные, муниципальные (без учета организаций в ведении ФСИН); Очная	   стипендии Правительства Российской Федерации / 3.0	16	15	1	10	10	0
Кабардино-Балкарская Республика	Государственные, муниципальные (без учета организаций в ведении ФСИН); Очная	"   стипендии, назначенные физическими лицами (кроме именных,
   указанных в строке 09) / 12.0"	0	0	0	0	0	0
Кабардино-Балкарская Республика	Государственные, муниципальные (без учета организаций в ведении ФСИН); Очная	"   стипендии, назначенные юридическими лицами (кроме именных,
   указанных в строке 07) / 10.0"	0	0	0	0	0	0
Кабардино-Балкарская Республика	Государственные, муниципальные (без учета организаций в ведении ФСИН); Очная	Численность студентов, получающих другие формы материальной поддержки / 14.0	24	24	0	80	59	21
Кабардино-Балкарская Республика	Государственные, муниципальные (без учета организаций в ведении ФСИН); Очная	Численность студентов, получающих: государственные академические стипендии / 1.0	1741	1560	181	4352	3010	1342
Кабардино-Балкарская Республика	Частные; Очная	      в том числе студентам, направленным ими на обучение / 11.0	0	0	0	0	0	0
Кабардино-Балкарская Республика	Частные; Очная	      в том числе студентам, направленным ими на обучение / 13.0	0	0	0	0	0	0
Кабардино-Балкарская Республика	Частные; Очная	      из них организацией, студентами которой они являются / 8.0	0	0	0	38	17	21
Кабардино-Балкарская Республика	Частные; Очная	   бюджетных ассигнований бюджета субъекта Российской Федерации / 16.0	0	0	0	0	0	0
Кабардино-Балкарская Республика	Частные; Очная	   государственные социальные стипендии / 2.0	0	0	0	0	0	0
Кабардино-Балкарская Республика	Частные; Очная	"   из них за счет средств: 
   стипендиального фонда / 15.0"	0	0	0	0	0	0
Кабардино-Балкарская Республика	Частные; Очная	"   именные стипендии, учрежденные: 
   органами государственной власти субъекта Российской Федерации / 5.0"	0	0	0	0	0	0
Кабардино-Балкарская Республика	Частные; Очная	   именные стипендии, учрежденные: органами местного самоуправления / 6.0	0	0	0	0	0	0
Кабардино-Балкарская Республика	Частные; Очная	   именные стипендии, учрежденные: федеральными государственными органами / 4.0	0	0	0	0	0	0
Кабардино-Балкарская Республика	Частные; Очная	   именные стипендии, учрежденные: физическими лицами / 9.0	0	0	0	0	0	0
Кабардино-Балкарская Республика	Частные; Очная	   именные стипендии, учрежденные: юридическими лицами / 7.0	0	0	0	38	17	21
Кабардино-Балкарская Республика	Частные; Очная	   полученных от приносящей доход деятельности / 17.0	0	0	0	0	0	0
Кабардино-Балкарская Республика	Частные; Очная	   стипендии Правительства Российской Федерации / 3.0	0	0	0	7	3	4
Кабардино-Балкарская Республика	Частные; Очная	"   стипендии, назначенные физическими лицами (кроме именных,
   указанных в строке 09) / 12.0"	0	0	0	0	0	0
Кабардино-Балкарская Республика	Частные; Очная	"   стипендии, назначенные юридическими лицами (кроме именных,
   указанных в строке 07) / 10.0"	0	0	0	0	0	0
Кабардино-Балкарская Республика	Частные; Очная	Численность студентов, получающих другие формы материальной поддержки / 14.0	0	0	0	0	0	0
Кабардино-Балкарская Республика	Частные; Очная	Численность студентов, получающих: государственные академические стипендии / 1.0	0	0	0	0	0	0
Калининградская область	Государственные, муниципальные (без учета организаций в ведении ФСИН); Очная	      в том числе студентам, направленным ими на обучение / 11.0	0	0	0	0	0	0
Калининградская область	Государственные, муниципальные (без учета организаций в ведении ФСИН); Очная	      в том числе студентам, направленным ими на обучение / 13.0	0	0	0	0	0	0
Калининградская область	Государственные, муниципальные (без учета организаций в ведении ФСИН); Очная	      из них организацией, студентами которой они являются / 8.0	0	0	0	0	0	0
Калининградская область	Государственные, муниципальные (без учета организаций в ведении ФСИН); Очная	   бюджетных ассигнований бюджета субъекта Российской Федерации / 16.0	4	4	0	96	92	4
Калининградская область	Государственные, муниципальные (без учета организаций в ведении ФСИН); Очная	   государственные социальные стипендии / 2.0	128	127	1	757	668	89
Калининградская область	Государственные, муниципальные (без учета организаций в ведении ФСИН); Очная	"   из них за счет средств: 
   стипендиального фонда / 15.0"	1	1	0	113	73	40
Калининградская область	Государственные, муниципальные (без учета организаций в ведении ФСИН); Очная	"   именные стипендии, учрежденные: 
   органами государственной власти субъекта Российской Федерации / 5.0"	42	42	0	228	201	27
Калининградская область	Государственные, муниципальные (без учета организаций в ведении ФСИН); Очная	   именные стипендии, учрежденные: органами местного самоуправления / 6.0	19	19	0	41	35	6
Калининградская область	Государственные, муниципальные (без учета организаций в ведении ФСИН); Очная	   именные стипендии, учрежденные: федеральными государственными органами / 4.0	19	19	0	37	31	6
Калининградская область	Государственные, муниципальные (без учета организаций в ведении ФСИН); Очная	   именные стипендии, учрежденные: физическими лицами / 9.0	0	0	0	0	0	0
Калининградская область	Государственные, муниципальные (без учета организаций в ведении ФСИН); Очная	   именные стипендии, учрежденные: юридическими лицами / 7.0	0	0	0	0	0	0
Калининградская область	Государственные, муниципальные (без учета организаций в ведении ФСИН); Очная	   полученных от приносящей доход деятельности / 17.0	28	28	0	89	77	12
Калининградская область	Государственные, муниципальные (без учета организаций в ведении ФСИН); Очная	   стипендии Правительства Российской Федерации / 3.0	7	6	1	26	24	2
Калининградская область	Государственные, муниципальные (без учета организаций в ведении ФСИН); Очная	"   стипендии, назначенные физическими лицами (кроме именных,
   указанных в строке 09) / 12.0"	0	0	0	0	0	0
Калининградская область	Государственные, муниципальные (без учета организаций в ведении ФСИН); Очная	"   стипендии, назначенные юридическими лицами (кроме именных,
   указанных в строке 07) / 10.0"	0	0	0	1	1	0
Калининградская область	Государственные, муниципальные (без учета организаций в ведении ФСИН); Очная	Численность студентов, получающих другие формы материальной поддержки / 14.0	33	33	0	296	240	56
Калининградская область	Государственные, муниципальные (без учета организаций в ведении ФСИН); Очная	Численность студентов, получающих: государственные академические стипендии / 1.0	1040	1006	34	6829	5885	944
Калининградская область	Частные; Очная	      в том числе студентам, направленным ими на обучение / 11.0	0	0	0	0	0	0
Калининградская область	Частные; Очная	      в том числе студентам, направленным ими на обучение / 13.0	0	0	0	0	0	0
Калининградская область	Частные; Очная	      из них организацией, студентами которой они являются / 8.0	0	0	0	0	0	0
Калининградская область	Частные; Очная	   бюджетных ассигнований бюджета субъекта Российской Федерации / 16.0	0	0	0	0	0	0
Калининградская область	Частные; Очная	   государственные социальные стипендии / 2.0	0	0	0	2	1	1
Калининградская область	Частные; Очная	"   из них за счет средств: 
   стипендиального фонда / 15.0"	0	0	0	15	15	0
Калининградская область	Частные; Очная	"   именные стипендии, учрежденные: 
   органами государственной власти субъекта Российской Федерации / 5.0"	0	0	0	1	0	1
Калининградская область	Частные; Очная	   именные стипендии, учрежденные: органами местного самоуправления / 6.0	0	0	0	7	4	3
Калининградская область	Частные; Очная	   именные стипендии, учрежденные: федеральными государственными органами / 4.0	0	0	0	0	0	0
Калининградская область	Частные; Очная	   именные стипендии, учрежденные: физическими лицами / 9.0	0	0	0	0	0	0
Калининградская область	Частные; Очная	   именные стипендии, учрежденные: юридическими лицами / 7.0	0	0	0	0	0	0
Калининградская область	Частные; Очная	   полученных от приносящей доход деятельности / 17.0	0	0	0	0	0	0
Калининградская область	Частные; Очная	   стипендии Правительства Российской Федерации / 3.0	0	0	0	1	1	0
Калининградская область	Частные; Очная	"   стипендии, назначенные физическими лицами (кроме именных,
   указанных в строке 09) / 12.0"	0	0	0	0	0	0
Калининградская область	Частные; Очная	"   стипендии, назначенные юридическими лицами (кроме именных,
   указанных в строке 07) / 10.0"	0	0	0	0	0	0
Калининградская область	Частные; Очная	Численность студентов, получающих другие формы материальной поддержки / 14.0	0	0	0	15	15	0
Калининградская область	Частные; Очная	Численность студентов, получающих: государственные академические стипендии / 1.0	0	0	0	27	23	4
Калужская область	Государственные, муниципальные (без учета организаций в ведении ФСИН); Очная	      в том числе студентам, направленным ими на обучение / 11.0	0	0	0	0	0	0
Калужская область	Государственные, муниципальные (без учета организаций в ведении ФСИН); Очная	      в том числе студентам, направленным ими на обучение / 13.0	0	0	0	0	0	0
Калужская область	Государственные, муниципальные (без учета организаций в ведении ФСИН); Очная	      из них организацией, студентами которой они являются / 8.0	0	0	0	0	0	0
Калужская область	Государственные, муниципальные (без учета организаций в ведении ФСИН); Очная	   бюджетных ассигнований бюджета субъекта Российской Федерации / 16.0	13	13	0	78	68	10
Калужская область	Государственные, муниципальные (без учета организаций в ведении ФСИН); Очная	   государственные социальные стипендии / 2.0	381	381	0	1770	1639	131
Калужская область	Государственные, муниципальные (без учета организаций в ведении ФСИН); Очная	"   из них за счет средств: 
   стипендиального фонда / 15.0"	38	38	0	455	369	86
Калужская область	Государственные, муниципальные (без учета организаций в ведении ФСИН); Очная	"   именные стипендии, учрежденные: 
   органами государственной власти субъекта Российской Федерации / 5.0"	0	0	0	21	21	0
Калужская область	Государственные, муниципальные (без учета организаций в ведении ФСИН); Очная	   именные стипендии, учрежденные: органами местного самоуправления / 6.0	0	0	0	0	0	0
Калужская область	Государственные, муниципальные (без учета организаций в ведении ФСИН); Очная	   именные стипендии, учрежденные: федеральными государственными органами / 4.0	0	0	0	0	0	0
Калужская область	Государственные, муниципальные (без учета организаций в ведении ФСИН); Очная	   именные стипендии, учрежденные: физическими лицами / 9.0	0	0	0	0	0	0
Калужская область	Государственные, муниципальные (без учета организаций в ведении ФСИН); Очная	   именные стипендии, учрежденные: юридическими лицами / 7.0	0	0	0	7	7	0
Калужская область	Государственные, муниципальные (без учета организаций в ведении ФСИН); Очная	   полученных от приносящей доход деятельности / 17.0	0	0	0	52	52	0
Калужская область	Государственные, муниципальные (без учета организаций в ведении ФСИН); Очная	   стипендии Правительства Российской Федерации / 3.0	6	6	0	32	31	1
Калужская область	Государственные, муниципальные (без учета организаций в ведении ФСИН); Очная	"   стипендии, назначенные физическими лицами (кроме именных,
   указанных в строке 09) / 12.0"	0	0	0	0	0	0
Калужская область	Государственные, муниципальные (без учета организаций в ведении ФСИН); Очная	"   стипендии, назначенные юридическими лицами (кроме именных,
   указанных в строке 07) / 10.0"	0	0	0	35	35	0
Калужская область	Государственные, муниципальные (без учета организаций в ведении ФСИН); Очная	Численность студентов, получающих другие формы материальной поддержки / 14.0	77	77	0	794	698	96
Калужская область	Государственные, муниципальные (без учета организаций в ведении ФСИН); Очная	Численность студентов, получающих: государственные академические стипендии / 1.0	1185	1116	69	7036	6482	554
Калужская область	Частные; Очная	      в том числе студентам, направленным ими на обучение / 11.0	0	0	0	0	0	0
Калужская область	Частные; Очная	      в том числе студентам, направленным ими на обучение / 13.0	0	0	0	0	0	0
Калужская область	Частные; Очная	      из них организацией, студентами которой они являются / 8.0	0	0	0	0	0	0
Калужская область	Частные; Очная	   бюджетных ассигнований бюджета субъекта Российской Федерации / 16.0	0	0	0	0	0	0
Калужская область	Частные; Очная	   государственные социальные стипендии / 2.0	0	0	0	0	0	0
Калужская область	Частные; Очная	"   из них за счет средств: 
   стипендиального фонда / 15.0"	0	0	0	0	0	0
Калужская область	Частные; Очная	"   именные стипендии, учрежденные: 
   органами государственной власти субъекта Российской Федерации / 5.0"	0	0	0	0	0	0
Калужская область	Частные; Очная	   именные стипендии, учрежденные: органами местного самоуправления / 6.0	0	0	0	0	0	0
Калужская область	Частные; Очная	   именные стипендии, учрежденные: федеральными государственными органами / 4.0	0	0	0	0	0	0
Калужская область	Частные; Очная	   именные стипендии, учрежденные: физическими лицами / 9.0	0	0	0	0	0	0
Калужская область	Частные; Очная	   именные стипендии, учрежденные: юридическими лицами / 7.0	0	0	0	0	0	0
Калужская область	Частные; Очная	   полученных от приносящей доход деятельности / 17.0	0	0	0	0	0	0
Калужская область	Частные; Очная	   стипендии Правительства Российской Федерации / 3.0	0	0	0	0	0	0
Калужская область	Частные; Очная	"   стипендии, назначенные физическими лицами (кроме именных,
   указанных в строке 09) / 12.0"	0	0	0	0	0	0
Калужская область	Частные; Очная	"   стипендии, назначенные юридическими лицами (кроме именных,
   указанных в строке 07) / 10.0"	0	0	0	0	0	0
Калужская область	Частные; Очная	Численность студентов, получающих другие формы материальной поддержки / 14.0	0	0	0	0	0	0
Калужская область	Частные; Очная	Численность студентов, получающих: государственные академические стипендии / 1.0	0	0	0	0	0	0
Камчатский край	Государственные, муниципальные (без учета организаций в ведении ФСИН); Очная	      в том числе студентам, направленным ими на обучение / 11.0	0	0	0	0	0	0
Камчатский край	Государственные, муниципальные (без учета организаций в ведении ФСИН); Очная	      в том числе студентам, направленным ими на обучение / 13.0	0	0	0	0	0	0
Камчатский край	Государственные, муниципальные (без учета организаций в ведении ФСИН); Очная	      из них организацией, студентами которой они являются / 8.0	0	0	0	0	0	0
Камчатский край	Государственные, муниципальные (без учета организаций в ведении ФСИН); Очная	   бюджетных ассигнований бюджета субъекта Российской Федерации / 16.0	54	54	0	28	15	13
Камчатский край	Государственные, муниципальные (без учета организаций в ведении ФСИН); Очная	   государственные социальные стипендии / 2.0	259	259	0	386	371	15
Камчатский край	Государственные, муниципальные (без учета организаций в ведении ФСИН); Очная	"   из них за счет средств: 
   стипендиального фонда / 15.0"	211	210	1	362	355	7
Камчатский край	Государственные, муниципальные (без учета организаций в ведении ФСИН); Очная	"   именные стипендии, учрежденные: 
   органами государственной власти субъекта Российской Федерации / 5.0"	26	26	0	0	0	0
Камчатский край	Государственные, муниципальные (без учета организаций в ведении ФСИН); Очная	   именные стипендии, учрежденные: органами местного самоуправления / 6.0	0	0	0	0	0	0
Камчатский край	Государственные, муниципальные (без учета организаций в ведении ФСИН); Очная	   именные стипендии, учрежденные: федеральными государственными органами / 4.0	0	0	0	3	3	0
Камчатский край	Государственные, муниципальные (без учета организаций в ведении ФСИН); Очная	   именные стипендии, учрежденные: физическими лицами / 9.0	0	0	0	0	0	0
Камчатский край	Государственные, муниципальные (без учета организаций в ведении ФСИН); Очная	   именные стипендии, учрежденные: юридическими лицами / 7.0	0	0	0	0	0	0
Камчатский край	Государственные, муниципальные (без учета организаций в ведении ФСИН); Очная	   полученных от приносящей доход деятельности / 17.0	0	0	0	0	0	0
Камчатский край	Государственные, муниципальные (без учета организаций в ведении ФСИН); Очная	   стипендии Правительства Российской Федерации / 3.0	3	3	0	4	4	0
Камчатский край	Государственные, муниципальные (без учета организаций в ведении ФСИН); Очная	"   стипендии, назначенные физическими лицами (кроме именных,
   указанных в строке 09) / 12.0"	0	0	0	0	0	0
Камчатский край	Государственные, муниципальные (без учета организаций в ведении ФСИН); Очная	"   стипендии, назначенные юридическими лицами (кроме именных,
   указанных в строке 07) / 10.0"	0	0	0	69	69	0
Камчатский край	Государственные, муниципальные (без учета организаций в ведении ФСИН); Очная	Численность студентов, получающих другие формы материальной поддержки / 14.0	276	275	1	390	370	20
Камчатский край	Государственные, муниципальные (без учета организаций в ведении ФСИН); Очная	Численность студентов, получающих: государственные академические стипендии / 1.0	522	504	18	1506	1412	94
Камчатский край	Частные; Очная	      в том числе студентам, направленным ими на обучение / 11.0	0	0	0	0	0	0
Камчатский край	Частные; Очная	      в том числе студентам, направленным ими на обучение / 13.0	0	0	0	0	0	0
Камчатский край	Частные; Очная	      из них организацией, студентами которой они являются / 8.0	0	0	0	13	8	5
Камчатский край	Частные; Очная	   бюджетных ассигнований бюджета субъекта Российской Федерации / 16.0	0	0	0	0	0	0
Камчатский край	Частные; Очная	   государственные социальные стипендии / 2.0	0	0	0	9	8	1
Камчатский край	Частные; Очная	"   из них за счет средств: 
   стипендиального фонда / 15.0"	0	0	0	0	0	0
Камчатский край	Частные; Очная	"   именные стипендии, учрежденные: 
   органами государственной власти субъекта Российской Федерации / 5.0"	0	0	0	0	0	0
Камчатский край	Частные; Очная	   именные стипендии, учрежденные: органами местного самоуправления / 6.0	0	0	0	0	0	0
Камчатский край	Частные; Очная	   именные стипендии, учрежденные: федеральными государственными органами / 4.0	0	0	0	0	0	0
Камчатский край	Частные; Очная	   именные стипендии, учрежденные: физическими лицами / 9.0	0	0	0	0	0	0
Камчатский край	Частные; Очная	   именные стипендии, учрежденные: юридическими лицами / 7.0	0	0	0	13	8	5
Камчатский край	Частные; Очная	   полученных от приносящей доход деятельности / 17.0	0	0	0	20	10	10
Камчатский край	Частные; Очная	   стипендии Правительства Российской Федерации / 3.0	0	0	0	0	0	0
Камчатский край	Частные; Очная	"   стипендии, назначенные физическими лицами (кроме именных,
   указанных в строке 09) / 12.0"	0	0	0	0	0	0
Камчатский край	Частные; Очная	"   стипендии, назначенные юридическими лицами (кроме именных,
   указанных в строке 07) / 10.0"	0	0	0	0	0	0
Камчатский край	Частные; Очная	Численность студентов, получающих другие формы материальной поддержки / 14.0	0	0	0	20	10	10
Камчатский край	Частные; Очная	Численность студентов, получающих: государственные академические стипендии / 1.0	0	0	0	0	0	0
Карачаево-Черкесская Республика	Государственные, муниципальные (без учета организаций в ведении ФСИН); Очная	      в том числе студентам, направленным ими на обучение / 11.0	0	0	0	0	0	0
Карачаево-Черкесская Республика	Государственные, муниципальные (без учета организаций в ведении ФСИН); Очная	      в том числе студентам, направленным ими на обучение / 13.0	0	0	0	0	0	0
Карачаево-Черкесская Республика	Государственные, муниципальные (без учета организаций в ведении ФСИН); Очная	      из них организацией, студентами которой они являются / 8.0	0	0	0	3	3	0
Карачаево-Черкесская Республика	Государственные, муниципальные (без учета организаций в ведении ФСИН); Очная	   бюджетных ассигнований бюджета субъекта Российской Федерации / 16.0	0	0	0	11	11	0
Карачаево-Черкесская Республика	Государственные, муниципальные (без учета организаций в ведении ФСИН); Очная	   государственные социальные стипендии / 2.0	88	88	0	494	482	12
Карачаево-Черкесская Республика	Государственные, муниципальные (без учета организаций в ведении ФСИН); Очная	"   из них за счет средств: 
   стипендиального фонда / 15.0"	0	0	0	50	50	0
Карачаево-Черкесская Республика	Государственные, муниципальные (без учета организаций в ведении ФСИН); Очная	"   именные стипендии, учрежденные: 
   органами государственной власти субъекта Российской Федерации / 5.0"	0	0	0	3	2	1
Карачаево-Черкесская Республика	Государственные, муниципальные (без учета организаций в ведении ФСИН); Очная	   именные стипендии, учрежденные: органами местного самоуправления / 6.0	0	0	0	30	25	5
Карачаево-Черкесская Республика	Государственные, муниципальные (без учета организаций в ведении ФСИН); Очная	   именные стипендии, учрежденные: федеральными государственными органами / 4.0	0	0	0	0	0	0
Карачаево-Черкесская Республика	Государственные, муниципальные (без учета организаций в ведении ФСИН); Очная	   именные стипендии, учрежденные: физическими лицами / 9.0	0	0	0	0	0	0
Карачаево-Черкесская Республика	Государственные, муниципальные (без учета организаций в ведении ФСИН); Очная	   именные стипендии, учрежденные: юридическими лицами / 7.0	0	0	0	3	3	0
Карачаево-Черкесская Республика	Государственные, муниципальные (без учета организаций в ведении ФСИН); Очная	   полученных от приносящей доход деятельности / 17.0	2	2	0	3	3	0
Карачаево-Черкесская Республика	Государственные, муниципальные (без учета организаций в ведении ФСИН); Очная	   стипендии Правительства Российской Федерации / 3.0	7	7	0	13	12	1
Карачаево-Черкесская Республика	Государственные, муниципальные (без учета организаций в ведении ФСИН); Очная	"   стипендии, назначенные физическими лицами (кроме именных,
   указанных в строке 09) / 12.0"	0	0	0	0	0	0
Карачаево-Черкесская Республика	Государственные, муниципальные (без учета организаций в ведении ФСИН); Очная	"   стипендии, назначенные юридическими лицами (кроме именных,
   указанных в строке 07) / 10.0"	0	0	0	0	0	0
Карачаево-Черкесская Республика	Государственные, муниципальные (без учета организаций в ведении ФСИН); Очная	Численность студентов, получающих другие формы материальной поддержки / 14.0	2	2	0	64	64	0
Карачаево-Черкесская Республика	Государственные, муниципальные (без учета организаций в ведении ФСИН); Очная	Численность студентов, получающих: государственные академические стипендии / 1.0	1042	996	46	4531	4385	146
Кемеровская область	Государственные, муниципальные (без учета организаций в ведении ФСИН); Очная	      в том числе студентам, направленным ими на обучение / 11.0	0	0	0	95	95	0
Кемеровская область	Государственные, муниципальные (без учета организаций в ведении ФСИН); Очная	      в том числе студентам, направленным ими на обучение / 13.0	0	0	0	0	0	0
Кемеровская область	Государственные, муниципальные (без учета организаций в ведении ФСИН); Очная	      из них организацией, студентами которой они являются / 8.0	2	2	0	19	13	6
Кемеровская область	Государственные, муниципальные (без учета организаций в ведении ФСИН); Очная	   бюджетных ассигнований бюджета субъекта Российской Федерации / 16.0	370	370	0	1441	1331	110
Кемеровская область	Государственные, муниципальные (без учета организаций в ведении ФСИН); Очная	   государственные социальные стипендии / 2.0	1409	1399	10	5186	4819	367
Кемеровская область	Государственные, муниципальные (без учета организаций в ведении ФСИН); Очная	"   из них за счет средств: 
   стипендиального фонда / 15.0"	667	657	10	3709	3441	268
Кемеровская область	Государственные, муниципальные (без учета организаций в ведении ФСИН); Очная	"   именные стипендии, учрежденные: 
   органами государственной власти субъекта Российской Федерации / 5.0"	0	0	0	42	40	2
Кемеровская область	Государственные, муниципальные (без учета организаций в ведении ФСИН); Очная	   именные стипендии, учрежденные: органами местного самоуправления / 6.0	0	0	0	46	46	0
Кемеровская область	Государственные, муниципальные (без учета организаций в ведении ФСИН); Очная	   именные стипендии, учрежденные: федеральными государственными органами / 4.0	0	0	0	0	0	0
Кемеровская область	Государственные, муниципальные (без учета организаций в ведении ФСИН); Очная	   именные стипендии, учрежденные: физическими лицами / 9.0	0	0	0	0	0	0
Кемеровская область	Государственные, муниципальные (без учета организаций в ведении ФСИН); Очная	   именные стипендии, учрежденные: юридическими лицами / 7.0	2	2	0	46	40	6
Кемеровская область	Государственные, муниципальные (без учета организаций в ведении ФСИН); Очная	   полученных от приносящей доход деятельности / 17.0	6	6	0	108	89	19
Кемеровская область	Государственные, муниципальные (без учета организаций в ведении ФСИН); Очная	   стипендии Правительства Российской Федерации / 3.0	23	23	0	148	143	5
Кемеровская область	Государственные, муниципальные (без учета организаций в ведении ФСИН); Очная	"   стипендии, назначенные физическими лицами (кроме именных,
   указанных в строке 09) / 12.0"	0	0	0	0	0	0
Кемеровская область	Государственные, муниципальные (без учета организаций в ведении ФСИН); Очная	"   стипендии, назначенные юридическими лицами (кроме именных,
   указанных в строке 07) / 10.0"	25	25	0	427	427	0
Кемеровская область	Государственные, муниципальные (без учета организаций в ведении ФСИН); Очная	Численность студентов, получающих другие формы материальной поддержки / 14.0	1026	1015	11	5345	4952	393
Кемеровская область	Государственные, муниципальные (без учета организаций в ведении ФСИН); Очная	Численность студентов, получающих: государственные академические стипендии / 1.0	4416	4349	67	25516	23661	1855
Кемеровская область	Частные; Очная	      в том числе студентам, направленным ими на обучение / 11.0	0	0	0	0	0	0
Кемеровская область	Частные; Очная	      в том числе студентам, направленным ими на обучение / 13.0	0	0	0	0	0	0
Кемеровская область	Частные; Очная	      из них организацией, студентами которой они являются / 8.0	0	0	0	0	0	0
Кемеровская область	Частные; Очная	   бюджетных ассигнований бюджета субъекта Российской Федерации / 16.0	0	0	0	0	0	0
Кемеровская область	Частные; Очная	   государственные социальные стипендии / 2.0	0	0	0	15	15	0
Кемеровская область	Частные; Очная	"   из них за счет средств: 
   стипендиального фонда / 15.0"	0	0	0	13	13	0
Кемеровская область	Частные; Очная	"   именные стипендии, учрежденные: 
   органами государственной власти субъекта Российской Федерации / 5.0"	0	0	0	0	0	0
Кемеровская область	Частные; Очная	   именные стипендии, учрежденные: органами местного самоуправления / 6.0	0	0	0	0	0	0
Кемеровская область	Частные; Очная	   именные стипендии, учрежденные: федеральными государственными органами / 4.0	0	0	0	0	0	0
Кемеровская область	Частные; Очная	   именные стипендии, учрежденные: физическими лицами / 9.0	0	0	0	0	0	0
Кемеровская область	Частные; Очная	   именные стипендии, учрежденные: юридическими лицами / 7.0	0	0	0	0	0	0
Кемеровская область	Частные; Очная	   полученных от приносящей доход деятельности / 17.0	0	0	0	0	0	0
Кемеровская область	Частные; Очная	   стипендии Правительства Российской Федерации / 3.0	0	0	0	0	0	0
Кемеровская область	Частные; Очная	"   стипендии, назначенные физическими лицами (кроме именных,
   указанных в строке 09) / 12.0"	0	0	0	0	0	0
Кемеровская область	Частные; Очная	"   стипендии, назначенные юридическими лицами (кроме именных,
   указанных в строке 07) / 10.0"	0	0	0	0	0	0
Кемеровская область	Частные; Очная	Численность студентов, получающих другие формы материальной поддержки / 14.0	0	0	0	13	13	0
Кемеровская область	Частные; Очная	Численность студентов, получающих: государственные академические стипендии / 1.0	0	0	0	172	172	0
Кировская область	Государственные, муниципальные (без учета организаций в ведении ФСИН); Очная	      в том числе студентам, направленным ими на обучение / 11.0	0	0	0	11	10	1
Кировская область	Государственные, муниципальные (без учета организаций в ведении ФСИН); Очная	      в том числе студентам, направленным ими на обучение / 13.0	0	0	0	0	0	0
Кировская область	Государственные, муниципальные (без учета организаций в ведении ФСИН); Очная	      из них организацией, студентами которой они являются / 8.0	0	0	0	1	1	0
Кировская область	Государственные, муниципальные (без учета организаций в ведении ФСИН); Очная	   бюджетных ассигнований бюджета субъекта Российской Федерации / 16.0	82	82	0	716	715	1
Кировская область	Государственные, муниципальные (без учета организаций в ведении ФСИН); Очная	   государственные социальные стипендии / 2.0	627	627	0	1864	1719	145
Кировская область	Государственные, муниципальные (без учета организаций в ведении ФСИН); Очная	"   из них за счет средств: 
   стипендиального фонда / 15.0"	639	639	0	2877	2734	143
Кировская область	Государственные, муниципальные (без учета организаций в ведении ФСИН); Очная	"   именные стипендии, учрежденные: 
   органами государственной власти субъекта Российской Федерации / 5.0"	1	1	0	18	18	0
Кировская область	Государственные, муниципальные (без учета организаций в ведении ФСИН); Очная	   именные стипендии, учрежденные: органами местного самоуправления / 6.0	0	0	0	0	0	0
Кировская область	Государственные, муниципальные (без учета организаций в ведении ФСИН); Очная	   именные стипендии, учрежденные: федеральными государственными органами / 4.0	5	5	0	4	4	0
Кировская область	Государственные, муниципальные (без учета организаций в ведении ФСИН); Очная	   именные стипендии, учрежденные: физическими лицами / 9.0	0	0	0	0	0	0
Кировская область	Государственные, муниципальные (без учета организаций в ведении ФСИН); Очная	   именные стипендии, учрежденные: юридическими лицами / 7.0	0	0	0	16	15	1
Кировская область	Государственные, муниципальные (без учета организаций в ведении ФСИН); Очная	   полученных от приносящей доход деятельности / 17.0	3	3	0	132	96	36
Кировская область	Государственные, муниципальные (без учета организаций в ведении ФСИН); Очная	   стипендии Правительства Российской Федерации / 3.0	4	4	0	22	22	0
Кировская область	Государственные, муниципальные (без учета организаций в ведении ФСИН); Очная	"   стипендии, назначенные физическими лицами (кроме именных,
   указанных в строке 09) / 12.0"	0	0	0	0	0	0
Кировская область	Государственные, муниципальные (без учета организаций в ведении ФСИН); Очная	"   стипендии, назначенные юридическими лицами (кроме именных,
   указанных в строке 07) / 10.0"	0	0	0	11	10	1
Кировская область	Государственные, муниципальные (без учета организаций в ведении ФСИН); Очная	Численность студентов, получающих другие формы материальной поддержки / 14.0	639	639	0	3152	2958	194
Кировская область	Государственные, муниципальные (без учета организаций в ведении ФСИН); Очная	Численность студентов, получающих: государственные академические стипендии / 1.0	3848	3827	21	9222	8197	1025
Кировская область	Частные; Очная	      в том числе студентам, направленным ими на обучение / 11.0	0	0	0	0	0	0
Кировская область	Частные; Очная	      в том числе студентам, направленным ими на обучение / 13.0	0	0	0	0	0	0
Кировская область	Частные; Очная	      из них организацией, студентами которой они являются / 8.0	0	0	0	0	0	0
Кировская область	Частные; Очная	   бюджетных ассигнований бюджета субъекта Российской Федерации / 16.0	0	0	0	0	0	0
Кировская область	Частные; Очная	   государственные социальные стипендии / 2.0	0	0	0	0	0	0
Кировская область	Частные; Очная	"   из них за счет средств: 
   стипендиального фонда / 15.0"	0	0	0	0	0	0
Кировская область	Частные; Очная	"   именные стипендии, учрежденные: 
   органами государственной власти субъекта Российской Федерации / 5.0"	0	0	0	0	0	0
Кировская область	Частные; Очная	   именные стипендии, учрежденные: органами местного самоуправления / 6.0	0	0	0	0	0	0
Кировская область	Частные; Очная	   именные стипендии, учрежденные: федеральными государственными органами / 4.0	0	0	0	0	0	0
Кировская область	Частные; Очная	   именные стипендии, учрежденные: физическими лицами / 9.0	0	0	0	0	0	0
Кировская область	Частные; Очная	   именные стипендии, учрежденные: юридическими лицами / 7.0	0	0	0	0	0	0
Кировская область	Частные; Очная	   полученных от приносящей доход деятельности / 17.0	0	0	0	0	0	0
Кировская область	Частные; Очная	   стипендии Правительства Российской Федерации / 3.0	0	0	0	0	0	0
Кировская область	Частные; Очная	"   стипендии, назначенные физическими лицами (кроме именных,
   указанных в строке 09) / 12.0"	0	0	0	0	0	0
Кировская область	Частные; Очная	"   стипендии, назначенные юридическими лицами (кроме именных,
   указанных в строке 07) / 10.0"	0	0	0	0	0	0
Кировская область	Частные; Очная	Численность студентов, получающих другие формы материальной поддержки / 14.0	0	0	0	1	1	0
Кировская область	Частные; Очная	Численность студентов, получающих: государственные академические стипендии / 1.0	0	0	0	0	0	0
Костромская область	Государственные, муниципальные (без учета организаций в ведении ФСИН); Очная	      в том числе студентам, направленным ими на обучение / 11.0	0	0	0	0	0	0
Костромская область	Государственные, муниципальные (без учета организаций в ведении ФСИН); Очная	      в том числе студентам, направленным ими на обучение / 13.0	0	0	0	0	0	0
Костромская область	Государственные, муниципальные (без учета организаций в ведении ФСИН); Очная	      из них организацией, студентами которой они являются / 8.0	0	0	0	6	5	1
Костромская область	Государственные, муниципальные (без учета организаций в ведении ФСИН); Очная	   бюджетных ассигнований бюджета субъекта Российской Федерации / 16.0	308	296	12	90	89	1
Костромская область	Государственные, муниципальные (без учета организаций в ведении ФСИН); Очная	   государственные социальные стипендии / 2.0	497	476	21	1032	945	87
Костромская область	Государственные, муниципальные (без учета организаций в ведении ФСИН); Очная	"   из них за счет средств: 
   стипендиального фонда / 15.0"	46	46	0	237	209	28
Костромская область	Государственные, муниципальные (без учета организаций в ведении ФСИН); Очная	"   именные стипендии, учрежденные: 
   органами государственной власти субъекта Российской Федерации / 5.0"	3	3	0	8	8	0
Костромская область	Государственные, муниципальные (без учета организаций в ведении ФСИН); Очная	   именные стипендии, учрежденные: органами местного самоуправления / 6.0	0	0	0	0	0	0
Костромская область	Государственные, муниципальные (без учета организаций в ведении ФСИН); Очная	   именные стипендии, учрежденные: федеральными государственными органами / 4.0	1	1	0	6	6	0
Костромская область	Государственные, муниципальные (без учета организаций в ведении ФСИН); Очная	   именные стипендии, учрежденные: физическими лицами / 9.0	0	0	0	0	0	0
Костромская область	Государственные, муниципальные (без учета организаций в ведении ФСИН); Очная	   именные стипендии, учрежденные: юридическими лицами / 7.0	0	0	0	6	5	1
Костромская область	Государственные, муниципальные (без учета организаций в ведении ФСИН); Очная	   полученных от приносящей доход деятельности / 17.0	0	0	0	2	2	0
Костромская область	Государственные, муниципальные (без учета организаций в ведении ФСИН); Очная	   стипендии Правительства Российской Федерации / 3.0	11	10	1	19	18	1
Костромская область	Государственные, муниципальные (без учета организаций в ведении ФСИН); Очная	"   стипендии, назначенные физическими лицами (кроме именных,
   указанных в строке 09) / 12.0"	0	0	0	0	0	0
Костромская область	Государственные, муниципальные (без учета организаций в ведении ФСИН); Очная	"   стипендии, назначенные юридическими лицами (кроме именных,
   указанных в строке 07) / 10.0"	0	0	0	0	0	0
Костромская область	Государственные, муниципальные (без учета организаций в ведении ФСИН); Очная	Численность студентов, получающих другие формы материальной поддержки / 14.0	328	316	12	326	297	29
Костромская область	Государственные, муниципальные (без учета организаций в ведении ФСИН); Очная	Численность студентов, получающих: государственные академические стипендии / 1.0	1370	1337	33	4608	4087	521
Костромская область	Частные; Очная	      в том числе студентам, направленным ими на обучение / 11.0	0	0	0	0	0	0
Костромская область	Частные; Очная	      в том числе студентам, направленным ими на обучение / 13.0	0	0	0	0	0	0
Костромская область	Частные; Очная	      из них организацией, студентами которой они являются / 8.0	0	0	0	0	0	0
Костромская область	Частные; Очная	   бюджетных ассигнований бюджета субъекта Российской Федерации / 16.0	0	0	0	0	0	0
Костромская область	Частные; Очная	   государственные социальные стипендии / 2.0	0	0	0	29	26	3
Костромская область	Частные; Очная	"   из них за счет средств: 
   стипендиального фонда / 15.0"	0	0	0	0	0	0
Костромская область	Частные; Очная	"   именные стипендии, учрежденные: 
   органами государственной власти субъекта Российской Федерации / 5.0"	0	0	0	0	0	0
Костромская область	Частные; Очная	   именные стипендии, учрежденные: органами местного самоуправления / 6.0	0	0	0	0	0	0
Костромская область	Частные; Очная	   именные стипендии, учрежденные: федеральными государственными органами / 4.0	0	0	0	0	0	0
Костромская область	Частные; Очная	   именные стипендии, учрежденные: физическими лицами / 9.0	0	0	0	0	0	0
Костромская область	Частные; Очная	   именные стипендии, учрежденные: юридическими лицами / 7.0	0	0	0	0	0	0
Костромская область	Частные; Очная	   полученных от приносящей доход деятельности / 17.0	0	0	0	0	0	0
Костромская область	Частные; Очная	   стипендии Правительства Российской Федерации / 3.0	0	0	0	0	0	0
Костромская область	Частные; Очная	"   стипендии, назначенные физическими лицами (кроме именных,
   указанных в строке 09) / 12.0"	0	0	0	0	0	0
Костромская область	Частные; Очная	"   стипендии, назначенные юридическими лицами (кроме именных,
   указанных в строке 07) / 10.0"	0	0	0	0	0	0
Костромская область	Частные; Очная	Численность студентов, получающих другие формы материальной поддержки / 14.0	0	0	0	44	44	0
Костромская область	Частные; Очная	Численность студентов, получающих: государственные академические стипендии / 1.0	0	0	0	244	207	37
Краснодарский край	Государственные, муниципальные (без учета организаций в ведении ФСИН); Очная	      в том числе студентам, направленным ими на обучение / 11.0	0	0	0	122	122	0
Краснодарский край	Государственные, муниципальные (без учета организаций в ведении ФСИН); Очная	      в том числе студентам, направленным ими на обучение / 13.0	0	0	0	0	0	0
Краснодарский край	Государственные, муниципальные (без учета организаций в ведении ФСИН); Очная	      из них организацией, студентами которой они являются / 8.0	0	0	0	2	1	1
Краснодарский край	Государственные, муниципальные (без учета организаций в ведении ФСИН); Очная	   бюджетных ассигнований бюджета субъекта Российской Федерации / 16.0	608	608	0	695	655	40
Краснодарский край	Государственные, муниципальные (без учета организаций в ведении ФСИН); Очная	   государственные социальные стипендии / 2.0	2812	2751	61	4847	4385	462
Краснодарский край	Государственные, муниципальные (без учета организаций в ведении ФСИН); Очная	"   из них за счет средств: 
   стипендиального фонда / 15.0"	156	156	0	563	555	8
Краснодарский край	Государственные, муниципальные (без учета организаций в ведении ФСИН); Очная	"   именные стипендии, учрежденные: 
   органами государственной власти субъекта Российской Федерации / 5.0"	449	449	0	67	64	3
Краснодарский край	Государственные, муниципальные (без учета организаций в ведении ФСИН); Очная	   именные стипендии, учрежденные: органами местного самоуправления / 6.0	0	0	0	2	2	0
Краснодарский край	Государственные, муниципальные (без учета организаций в ведении ФСИН); Очная	   именные стипендии, учрежденные: федеральными государственными органами / 4.0	3	3	0	13	12	1
Краснодарский край	Государственные, муниципальные (без учета организаций в ведении ФСИН); Очная	   именные стипендии, учрежденные: физическими лицами / 9.0	0	0	0	0	0	0
Краснодарский край	Государственные, муниципальные (без учета организаций в ведении ФСИН); Очная	   именные стипендии, учрежденные: юридическими лицами / 7.0	0	0	0	6	5	1
Краснодарский край	Государственные, муниципальные (без учета организаций в ведении ФСИН); Очная	   полученных от приносящей доход деятельности / 17.0	5	4	1	112	110	2
Краснодарский край	Государственные, муниципальные (без учета организаций в ведении ФСИН); Очная	   стипендии Правительства Российской Федерации / 3.0	23	23	0	72	64	8
Краснодарский край	Государственные, муниципальные (без учета организаций в ведении ФСИН); Очная	"   стипендии, назначенные физическими лицами (кроме именных,
   указанных в строке 09) / 12.0"	0	0	0	0	0	0
Краснодарский край	Государственные, муниципальные (без учета организаций в ведении ФСИН); Очная	"   стипендии, назначенные юридическими лицами (кроме именных,
   указанных в строке 07) / 10.0"	0	0	0	122	122	0
Краснодарский край	Государственные, муниципальные (без учета организаций в ведении ФСИН); Очная	Численность студентов, получающих другие формы материальной поддержки / 14.0	764	763	1	1392	1339	53
Краснодарский край	Государственные, муниципальные (без учета организаций в ведении ФСИН); Очная	Численность студентов, получающих: государственные академические стипендии / 1.0	21336	20686	650	34909	31495	3414
Краснодарский край	Частные; Очная	      в том числе студентам, направленным ими на обучение / 11.0	0	0	0	0	0	0
Краснодарский край	Частные; Очная	      в том числе студентам, направленным ими на обучение / 13.0	0	0	0	0	0	0
Краснодарский край	Частные; Очная	      из них организацией, студентами которой они являются / 8.0	0	0	0	0	0	0
Краснодарский край	Частные; Очная	   бюджетных ассигнований бюджета субъекта Российской Федерации / 16.0	0	0	0	4	4	0
Краснодарский край	Частные; Очная	   государственные социальные стипендии / 2.0	3	3	0	44	35	9
Краснодарский край	Частные; Очная	"   из них за счет средств: 
   стипендиального фонда / 15.0"	0	0	0	40	40	0
Краснодарский край	Частные; Очная	"   именные стипендии, учрежденные: 
   органами государственной власти субъекта Российской Федерации / 5.0"	0	0	0	2	2	0
Краснодарский край	Частные; Очная	   именные стипендии, учрежденные: органами местного самоуправления / 6.0	0	0	0	8	8	0
Краснодарский край	Частные; Очная	   именные стипендии, учрежденные: федеральными государственными органами / 4.0	0	0	0	0	0	0
Краснодарский край	Частные; Очная	   именные стипендии, учрежденные: физическими лицами / 9.0	0	0	0	0	0	0
Краснодарский край	Частные; Очная	   именные стипендии, учрежденные: юридическими лицами / 7.0	0	0	0	0	0	0
Краснодарский край	Частные; Очная	   полученных от приносящей доход деятельности / 17.0	2	2	0	48	41	7
Краснодарский край	Частные; Очная	   стипендии Правительства Российской Федерации / 3.0	7	7	0	16	16	0
Краснодарский край	Частные; Очная	"   стипендии, назначенные физическими лицами (кроме именных,
   указанных в строке 09) / 12.0"	0	0	0	0	0	0
Краснодарский край	Частные; Очная	"   стипендии, назначенные юридическими лицами (кроме именных,
   указанных в строке 07) / 10.0"	0	0	0	283	225	58
Краснодарский край	Частные; Очная	Численность студентов, получающих другие формы материальной поддержки / 14.0	2	2	0	92	85	7
Краснодарский край	Частные; Очная	Численность студентов, получающих: государственные академические стипендии / 1.0	39	39	0	576	465	111
Красноярский край	Государственные, муниципальные (без учета организаций в ведении ФСИН); Очная	      в том числе студентам, направленным ими на обучение / 11.0	0	0	0	54	33	21
Красноярский край	Государственные, муниципальные (без учета организаций в ведении ФСИН); Очная	      в том числе студентам, направленным ими на обучение / 13.0	0	0	0	0	0	0
Красноярский край	Государственные, муниципальные (без учета организаций в ведении ФСИН); Очная	      из них организацией, студентами которой они являются / 8.0	0	0	0	0	0	0
Красноярский край	Государственные, муниципальные (без учета организаций в ведении ФСИН); Очная	   бюджетных ассигнований бюджета субъекта Российской Федерации / 16.0	375	370	5	834	687	147
Красноярский край	Государственные, муниципальные (без учета организаций в ведении ФСИН); Очная	   государственные социальные стипендии / 2.0	2406	2371	35	4608	3410	1198
Красноярский край	Государственные, муниципальные (без учета организаций в ведении ФСИН); Очная	"   из них за счет средств: 
   стипендиального фонда / 15.0"	560	557	3	2626	2256	370
Красноярский край	Государственные, муниципальные (без учета организаций в ведении ФСИН); Очная	"   именные стипендии, учрежденные: 
   органами государственной власти субъекта Российской Федерации / 5.0"	9	9	0	6	5	1
Красноярский край	Государственные, муниципальные (без учета организаций в ведении ФСИН); Очная	   именные стипендии, учрежденные: органами местного самоуправления / 6.0	0	0	0	5	5	0
Красноярский край	Государственные, муниципальные (без учета организаций в ведении ФСИН); Очная	   именные стипендии, учрежденные: федеральными государственными органами / 4.0	1	1	0	3	3	0
Красноярский край	Государственные, муниципальные (без учета организаций в ведении ФСИН); Очная	   именные стипендии, учрежденные: физическими лицами / 9.0	0	0	0	5	5	0
Красноярский край	Государственные, муниципальные (без учета организаций в ведении ФСИН); Очная	   именные стипендии, учрежденные: юридическими лицами / 7.0	16	16	0	192	180	12
Красноярский край	Государственные, муниципальные (без учета организаций в ведении ФСИН); Очная	   полученных от приносящей доход деятельности / 17.0	62	62	0	167	83	84
Красноярский край	Государственные, муниципальные (без учета организаций в ведении ФСИН); Очная	   стипендии Правительства Российской Федерации / 3.0	32	32	0	76	65	11
Красноярский край	Государственные, муниципальные (без учета организаций в ведении ФСИН); Очная	"   стипендии, назначенные физическими лицами (кроме именных,
   указанных в строке 09) / 12.0"	0	0	0	0	0	0
Красноярский край	Государственные, муниципальные (без учета организаций в ведении ФСИН); Очная	"   стипендии, назначенные юридическими лицами (кроме именных,
   указанных в строке 07) / 10.0"	5	5	0	153	125	28
Красноярский край	Государственные, муниципальные (без учета организаций в ведении ФСИН); Очная	Численность студентов, получающих другие формы материальной поддержки / 14.0	840	832	8	3139	2574	565
Красноярский край	Государственные, муниципальные (без учета организаций в ведении ФСИН); Очная	Численность студентов, получающих: государственные академические стипендии / 1.0	7583	7202	381	22859	15776	7083
Красноярский край	Частные; Очная	      в том числе студентам, направленным ими на обучение / 11.0	0	0	0	0	0	0
Красноярский край	Частные; Очная	      в том числе студентам, направленным ими на обучение / 13.0	0	0	0	0	0	0
Красноярский край	Частные; Очная	      из них организацией, студентами которой они являются / 8.0	0	0	0	2	1	1
Красноярский край	Частные; Очная	   бюджетных ассигнований бюджета субъекта Российской Федерации / 16.0	0	0	0	0	0	0
Красноярский край	Частные; Очная	   государственные социальные стипендии / 2.0	0	0	0	21	18	3
Красноярский край	Частные; Очная	"   из них за счет средств: 
   стипендиального фонда / 15.0"	0	0	0	0	0	0
Красноярский край	Частные; Очная	"   именные стипендии, учрежденные: 
   органами государственной власти субъекта Российской Федерации / 5.0"	0	0	0	0	0	0
Красноярский край	Частные; Очная	   именные стипендии, учрежденные: органами местного самоуправления / 6.0	0	0	0	0	0	0
Красноярский край	Частные; Очная	   именные стипендии, учрежденные: федеральными государственными органами / 4.0	0	0	0	0	0	0
Красноярский край	Частные; Очная	   именные стипендии, учрежденные: физическими лицами / 9.0	0	0	0	0	0	0
Красноярский край	Частные; Очная	   именные стипендии, учрежденные: юридическими лицами / 7.0	0	0	0	2	1	1
Красноярский край	Частные; Очная	   полученных от приносящей доход деятельности / 17.0	0	0	0	0	0	0
Красноярский край	Частные; Очная	   стипендии Правительства Российской Федерации / 3.0	0	0	0	0	0	0
Красноярский край	Частные; Очная	"   стипендии, назначенные физическими лицами (кроме именных,
   указанных в строке 09) / 12.0"	0	0	0	0	0	0
Красноярский край	Частные; Очная	"   стипендии, назначенные юридическими лицами (кроме именных,
   указанных в строке 07) / 10.0"	0	0	0	0	0	0
Красноярский край	Частные; Очная	Численность студентов, получающих другие формы материальной поддержки / 14.0	0	0	0	0	0	0
Красноярский край	Частные; Очная	Численность студентов, получающих: государственные академические стипендии / 1.0	0	0	0	126	84	42
Курганская область	Государственные, муниципальные (без учета организаций в ведении ФСИН); Очная	      в том числе студентам, направленным ими на обучение / 11.0	0	0	0	1	1	0
Курганская область	Государственные, муниципальные (без учета организаций в ведении ФСИН); Очная	      в том числе студентам, направленным ими на обучение / 13.0	0	0	0	0	0	0
Курганская область	Государственные, муниципальные (без учета организаций в ведении ФСИН); Очная	      из них организацией, студентами которой они являются / 8.0	0	0	0	0	0	0
Курганская область	Государственные, муниципальные (без учета организаций в ведении ФСИН); Очная	   бюджетных ассигнований бюджета субъекта Российской Федерации / 16.0	631	631	0	1204	1164	40
Курганская область	Государственные, муниципальные (без учета организаций в ведении ФСИН); Очная	   государственные социальные стипендии / 2.0	952	952	0	1771	1649	122
Курганская область	Государственные, муниципальные (без учета организаций в ведении ФСИН); Очная	"   из них за счет средств: 
   стипендиального фонда / 15.0"	492	492	0	1660	1546	114
Курганская область	Государственные, муниципальные (без учета организаций в ведении ФСИН); Очная	"   именные стипендии, учрежденные: 
   органами государственной власти субъекта Российской Федерации / 5.0"	1	1	0	8	8	0
Курганская область	Государственные, муниципальные (без учета организаций в ведении ФСИН); Очная	   именные стипендии, учрежденные: органами местного самоуправления / 6.0	0	0	0	0	0	0
Курганская область	Государственные, муниципальные (без учета организаций в ведении ФСИН); Очная	   именные стипендии, учрежденные: федеральными государственными органами / 4.0	2	2	0	2	2	0
Курганская область	Государственные, муниципальные (без учета организаций в ведении ФСИН); Очная	   именные стипендии, учрежденные: физическими лицами / 9.0	0	0	0	0	0	0
Курганская область	Государственные, муниципальные (без учета организаций в ведении ФСИН); Очная	   именные стипендии, учрежденные: юридическими лицами / 7.0	0	0	0	6	6	0
Курганская область	Государственные, муниципальные (без учета организаций в ведении ФСИН); Очная	   полученных от приносящей доход деятельности / 17.0	272	272	0	115	114	1
Курганская область	Государственные, муниципальные (без учета организаций в ведении ФСИН); Очная	   стипендии Правительства Российской Федерации / 3.0	19	19	0	23	23	0
Курганская область	Государственные, муниципальные (без учета организаций в ведении ФСИН); Очная	"   стипендии, назначенные физическими лицами (кроме именных,
   указанных в строке 09) / 12.0"	0	0	0	0	0	0
Курганская область	Государственные, муниципальные (без учета организаций в ведении ФСИН); Очная	"   стипендии, назначенные юридическими лицами (кроме именных,
   указанных в строке 07) / 10.0"	0	0	0	1	1	0
Курганская область	Государственные, муниципальные (без учета организаций в ведении ФСИН); Очная	Численность студентов, получающих другие формы материальной поддержки / 14.0	972	972	0	2221	2104	117
Курганская область	Государственные, муниципальные (без учета организаций в ведении ФСИН); Очная	Численность студентов, получающих: государственные академические стипендии / 1.0	2255	2255	0	6249	5697	552
Курская область	Государственные, муниципальные (без учета организаций в ведении ФСИН); Очная	      в том числе студентам, направленным ими на обучение / 11.0	3	3	0	56	56	0
Курская область	Государственные, муниципальные (без учета организаций в ведении ФСИН); Очная	      в том числе студентам, направленным ими на обучение / 13.0	58	58	0	133	133	0
Курская область	Государственные, муниципальные (без учета организаций в ведении ФСИН); Очная	      из них организацией, студентами которой они являются / 8.0	4	4	0	13	12	1
Курская область	Государственные, муниципальные (без учета организаций в ведении ФСИН); Очная	   бюджетных ассигнований бюджета субъекта Российской Федерации / 16.0	89	89	0	515	509	6
Курская область	Государственные, муниципальные (без учета организаций в ведении ФСИН); Очная	   государственные социальные стипендии / 2.0	846	830	16	2663	2502	161
Курская область	Государственные, муниципальные (без учета организаций в ведении ФСИН); Очная	"   из них за счет средств: 
   стипендиального фонда / 15.0"	58	57	1	1129	1076	53
Курская область	Государственные, муниципальные (без учета организаций в ведении ФСИН); Очная	"   именные стипендии, учрежденные: 
   органами государственной власти субъекта Российской Федерации / 5.0"	0	0	0	6	6	0
Курская область	Государственные, муниципальные (без учета организаций в ведении ФСИН); Очная	   именные стипендии, учрежденные: органами местного самоуправления / 6.0	0	0	0	6	5	1
Курская область	Государственные, муниципальные (без учета организаций в ведении ФСИН); Очная	   именные стипендии, учрежденные: федеральными государственными органами / 4.0	1	1	0	5	4	1
Курская область	Государственные, муниципальные (без учета организаций в ведении ФСИН); Очная	   именные стипендии, учрежденные: физическими лицами / 9.0	0	0	0	3	3	0
Курская область	Государственные, муниципальные (без учета организаций в ведении ФСИН); Очная	   именные стипендии, учрежденные: юридическими лицами / 7.0	4	4	0	18	16	2
Курская область	Государственные, муниципальные (без учета организаций в ведении ФСИН); Очная	   полученных от приносящей доход деятельности / 17.0	38	38	0	85	85	0
Курская область	Государственные, муниципальные (без учета организаций в ведении ФСИН); Очная	   стипендии Правительства Российской Федерации / 3.0	9	7	2	33	26	7
Курская область	Государственные, муниципальные (без учета организаций в ведении ФСИН); Очная	"   стипендии, назначенные физическими лицами (кроме именных,
   указанных в строке 09) / 12.0"	58	58	0	133	133	0
Курская область	Государственные, муниципальные (без учета организаций в ведении ФСИН); Очная	"   стипендии, назначенные юридическими лицами (кроме именных,
   указанных в строке 07) / 10.0"	3	3	0	64	64	0
Курская область	Государственные, муниципальные (без учета организаций в ведении ФСИН); Очная	Численность студентов, получающих другие формы материальной поддержки / 14.0	166	165	1	1369	1301	68
Курская область	Государственные, муниципальные (без учета организаций в ведении ФСИН); Очная	Численность студентов, получающих: государственные академические стипендии / 1.0	2361	2226	135	9529	8683	846
Ленинградская область	Государственные, муниципальные (без учета организаций в ведении ФСИН); Очная	      в том числе студентам, направленным ими на обучение / 11.0	0	0	0	19	16	3
Ленинградская область	Государственные, муниципальные (без учета организаций в ведении ФСИН); Очная	      в том числе студентам, направленным ими на обучение / 13.0	0	0	0	0	0	0
Ленинградская область	Государственные, муниципальные (без учета организаций в ведении ФСИН); Очная	      из них организацией, студентами которой они являются / 8.0	0	0	0	0	0	0
Ленинградская область	Государственные, муниципальные (без учета организаций в ведении ФСИН); Очная	   бюджетных ассигнований бюджета субъекта Российской Федерации / 16.0	21	21	0	155	155	0
Ленинградская область	Государственные, муниципальные (без учета организаций в ведении ФСИН); Очная	   государственные социальные стипендии / 2.0	672	632	40	1287	1236	51
Ленинградская область	Государственные, муниципальные (без учета организаций в ведении ФСИН); Очная	"   из них за счет средств: 
   стипендиального фонда / 15.0"	373	373	0	819	810	9
Ленинградская область	Государственные, муниципальные (без учета организаций в ведении ФСИН); Очная	"   именные стипендии, учрежденные: 
   органами государственной власти субъекта Российской Федерации / 5.0"	13	13	0	89	80	9
Ленинградская область	Государственные, муниципальные (без учета организаций в ведении ФСИН); Очная	   именные стипендии, учрежденные: органами местного самоуправления / 6.0	0	0	0	0	0	0
Ленинградская область	Государственные, муниципальные (без учета организаций в ведении ФСИН); Очная	   именные стипендии, учрежденные: федеральными государственными органами / 4.0	2	2	0	6	6	0
Ленинградская область	Государственные, муниципальные (без учета организаций в ведении ФСИН); Очная	   именные стипендии, учрежденные: физическими лицами / 9.0	0	0	0	0	0	0
Ленинградская область	Государственные, муниципальные (без учета организаций в ведении ФСИН); Очная	   именные стипендии, учрежденные: юридическими лицами / 7.0	0	0	0	34	34	0
Ленинградская область	Государственные, муниципальные (без учета организаций в ведении ФСИН); Очная	   полученных от приносящей доход деятельности / 17.0	0	0	0	17	17	0
Ленинградская область	Государственные, муниципальные (без учета организаций в ведении ФСИН); Очная	   стипендии Правительства Российской Федерации / 3.0	7	7	0	34	28	6
Ленинградская область	Государственные, муниципальные (без учета организаций в ведении ФСИН); Очная	"   стипендии, назначенные физическими лицами (кроме именных,
   указанных в строке 09) / 12.0"	0	0	0	0	0	0
Ленинградская область	Государственные, муниципальные (без учета организаций в ведении ФСИН); Очная	"   стипендии, назначенные юридическими лицами (кроме именных,
   указанных в строке 07) / 10.0"	35	35	0	71	68	3
Ленинградская область	Государственные, муниципальные (без учета организаций в ведении ФСИН); Очная	Численность студентов, получающих другие формы материальной поддержки / 14.0	403	403	0	993	984	9
Ленинградская область	Государственные, муниципальные (без учета организаций в ведении ФСИН); Очная	Численность студентов, получающих: государственные академические стипендии / 1.0	2132	2008	124	7285	6839	446
Липецкая область	Государственные, муниципальные (без учета организаций в ведении ФСИН); Очная	      в том числе студентам, направленным ими на обучение / 11.0	0	0	0	49	40	9
Липецкая область	Государственные, муниципальные (без учета организаций в ведении ФСИН); Очная	      в том числе студентам, направленным ими на обучение / 13.0	0	0	0	0	0	0
Липецкая область	Государственные, муниципальные (без учета организаций в ведении ФСИН); Очная	      из них организацией, студентами которой они являются / 8.0	0	0	0	0	0	0
Липецкая область	Государственные, муниципальные (без учета организаций в ведении ФСИН); Очная	   бюджетных ассигнований бюджета субъекта Российской Федерации / 16.0	19	19	0	253	244	9
Липецкая область	Государственные, муниципальные (без учета организаций в ведении ФСИН); Очная	   государственные социальные стипендии / 2.0	442	440	2	1413	1377	36
Липецкая область	Государственные, муниципальные (без учета организаций в ведении ФСИН); Очная	"   из них за счет средств: 
   стипендиального фонда / 15.0"	240	240	0	448	428	20
Липецкая область	Государственные, муниципальные (без учета организаций в ведении ФСИН); Очная	"   именные стипендии, учрежденные: 
   органами государственной власти субъекта Российской Федерации / 5.0"	4	4	0	11	9	2
Липецкая область	Государственные, муниципальные (без учета организаций в ведении ФСИН); Очная	   именные стипендии, учрежденные: органами местного самоуправления / 6.0	0	0	0	0	0	0
Липецкая область	Государственные, муниципальные (без учета организаций в ведении ФСИН); Очная	   именные стипендии, учрежденные: федеральными государственными органами / 4.0	0	0	0	1	1	0
Липецкая область	Государственные, муниципальные (без учета организаций в ведении ФСИН); Очная	   именные стипендии, учрежденные: физическими лицами / 9.0	0	0	0	0	0	0
Липецкая область	Государственные, муниципальные (без учета организаций в ведении ФСИН); Очная	   именные стипендии, учрежденные: юридическими лицами / 7.0	297	297	0	323	323	0
Липецкая область	Государственные, муниципальные (без учета организаций в ведении ФСИН); Очная	   полученных от приносящей доход деятельности / 17.0	0	0	0	9	9	0
Липецкая область	Государственные, муниципальные (без учета организаций в ведении ФСИН); Очная	   стипендии Правительства Российской Федерации / 3.0	5	5	0	27	25	2
Липецкая область	Государственные, муниципальные (без учета организаций в ведении ФСИН); Очная	"   стипендии, назначенные физическими лицами (кроме именных,
   указанных в строке 09) / 12.0"	0	0	0	0	0	0
Липецкая область	Государственные, муниципальные (без учета организаций в ведении ФСИН); Очная	"   стипендии, назначенные юридическими лицами (кроме именных,
   указанных в строке 07) / 10.0"	0	0	0	744	735	9
Липецкая область	Государственные, муниципальные (без учета организаций в ведении ФСИН); Очная	Численность студентов, получающих другие формы материальной поддержки / 14.0	319	317	2	873	844	29
Липецкая область	Государственные, муниципальные (без учета организаций в ведении ФСИН); Очная	Численность студентов, получающих: государственные академические стипендии / 1.0	2371	2339	32	8848	8470	378
Магаданская область	Государственные, муниципальные (без учета организаций в ведении ФСИН); Очная	      в том числе студентам, направленным ими на обучение / 11.0	0	0	0	30	0	30
Магаданская область	Государственные, муниципальные (без учета организаций в ведении ФСИН); Очная	      в том числе студентам, направленным ими на обучение / 13.0	0	0	0	0	0	0
Магаданская область	Государственные, муниципальные (без учета организаций в ведении ФСИН); Очная	      из них организацией, студентами которой они являются / 8.0	0	0	0	0	0	0
Магаданская область	Государственные, муниципальные (без учета организаций в ведении ФСИН); Очная	   бюджетных ассигнований бюджета субъекта Российской Федерации / 16.0	1	1	0	8	7	1
Магаданская область	Государственные, муниципальные (без учета организаций в ведении ФСИН); Очная	   государственные социальные стипендии / 2.0	117	117	0	158	142	16
Магаданская область	Государственные, муниципальные (без учета организаций в ведении ФСИН); Очная	"   из них за счет средств: 
   стипендиального фонда / 15.0"	0	0	0	0	0	0
Магаданская область	Государственные, муниципальные (без учета организаций в ведении ФСИН); Очная	"   именные стипендии, учрежденные: 
   органами государственной власти субъекта Российской Федерации / 5.0"	20	20	0	42	37	5
Магаданская область	Государственные, муниципальные (без учета организаций в ведении ФСИН); Очная	   именные стипендии, учрежденные: органами местного самоуправления / 6.0	1	1	0	4	4	0
Магаданская область	Государственные, муниципальные (без учета организаций в ведении ФСИН); Очная	   именные стипендии, учрежденные: федеральными государственными органами / 4.0	0	0	0	0	0	0
Магаданская область	Государственные, муниципальные (без учета организаций в ведении ФСИН); Очная	   именные стипендии, учрежденные: физическими лицами / 9.0	0	0	0	0	0	0
Магаданская область	Государственные, муниципальные (без учета организаций в ведении ФСИН); Очная	   именные стипендии, учрежденные: юридическими лицами / 7.0	0	0	0	3	3	0
Магаданская область	Государственные, муниципальные (без учета организаций в ведении ФСИН); Очная	   полученных от приносящей доход деятельности / 17.0	0	0	0	0	0	0
Магаданская область	Государственные, муниципальные (без учета организаций в ведении ФСИН); Очная	   стипендии Правительства Российской Федерации / 3.0	3	3	0	6	5	1
Магаданская область	Государственные, муниципальные (без учета организаций в ведении ФСИН); Очная	"   стипендии, назначенные физическими лицами (кроме именных,
   указанных в строке 09) / 12.0"	0	0	0	0	0	0
Магаданская область	Государственные, муниципальные (без учета организаций в ведении ФСИН); Очная	"   стипендии, назначенные юридическими лицами (кроме именных,
   указанных в строке 07) / 10.0"	0	0	0	30	0	30
Магаданская область	Государственные, муниципальные (без учета организаций в ведении ФСИН); Очная	Численность студентов, получающих другие формы материальной поддержки / 14.0	1	1	0	8	7	1
Магаданская область	Государственные, муниципальные (без учета организаций в ведении ФСИН); Очная	Численность студентов, получающих: государственные академические стипендии / 1.0	550	540	10	1293	1059	234
Московская область	Государственные, муниципальные (без учета организаций в ведении ФСИН); Очная	      в том числе студентам, направленным ими на обучение / 11.0	0	0	0	51	42	9
Московская область	Государственные, муниципальные (без учета организаций в ведении ФСИН); Очная	      в том числе студентам, направленным ими на обучение / 13.0	0	0	0	0	0	0
Московская область	Государственные, муниципальные (без учета организаций в ведении ФСИН); Очная	      из них организацией, студентами которой они являются / 8.0	0	0	0	1	1	0
Московская область	Государственные, муниципальные (без учета организаций в ведении ФСИН); Очная	   бюджетных ассигнований бюджета субъекта Российской Федерации / 16.0	827	827	0	5359	5356	3
Московская область	Государственные, муниципальные (без учета организаций в ведении ФСИН); Очная	   государственные социальные стипендии / 2.0	2103	2077	26	4106	3940	166
Московская область	Государственные, муниципальные (без учета организаций в ведении ФСИН); Очная	"   из них за счет средств: 
   стипендиального фонда / 15.0"	3322	3237	85	9469	9355	114
Московская область	Государственные, муниципальные (без учета организаций в ведении ФСИН); Очная	"   именные стипендии, учрежденные: 
   органами государственной власти субъекта Российской Федерации / 5.0"	11	11	0	352	236	116
Московская область	Государственные, муниципальные (без учета организаций в ведении ФСИН); Очная	   именные стипендии, учрежденные: органами местного самоуправления / 6.0	0	0	0	0	0	0
Московская область	Государственные, муниципальные (без учета организаций в ведении ФСИН); Очная	   именные стипендии, учрежденные: федеральными государственными органами / 4.0	1	1	0	20	20	0
Московская область	Государственные, муниципальные (без учета организаций в ведении ФСИН); Очная	   именные стипендии, учрежденные: физическими лицами / 9.0	0	0	0	0	0	0
Московская область	Государственные, муниципальные (без учета организаций в ведении ФСИН); Очная	   именные стипендии, учрежденные: юридическими лицами / 7.0	3	3	0	55	55	0
Московская область	Государственные, муниципальные (без учета организаций в ведении ФСИН); Очная	   полученных от приносящей доход деятельности / 17.0	3	3	0	73	70	3
Московская область	Государственные, муниципальные (без учета организаций в ведении ФСИН); Очная	   стипендии Правительства Российской Федерации / 3.0	147	147	0	164	162	2
Московская область	Государственные, муниципальные (без учета организаций в ведении ФСИН); Очная	"   стипендии, назначенные физическими лицами (кроме именных,
   указанных в строке 09) / 12.0"	0	0	0	0	0	0
Московская область	Государственные, муниципальные (без учета организаций в ведении ФСИН); Очная	"   стипендии, назначенные юридическими лицами (кроме именных,
   указанных в строке 07) / 10.0"	0	0	0	110	99	11
Московская область	Государственные, муниципальные (без учета организаций в ведении ФСИН); Очная	Численность студентов, получающих другие формы материальной поддержки / 14.0	4336	4251	85	14570	14436	134
Московская область	Государственные, муниципальные (без учета организаций в ведении ФСИН); Очная	Численность студентов, получающих: государственные академические стипендии / 1.0	8710	8684	26	38208	36462	1746
Московская область	Частные; Очная	      в том числе студентам, направленным ими на обучение / 11.0	0	0	0	0	0	0
Московская область	Частные; Очная	      в том числе студентам, направленным ими на обучение / 13.0	0	0	0	0	0	0
Московская область	Частные; Очная	      из них организацией, студентами которой они являются / 8.0	0	0	0	0	0	0
Московская область	Частные; Очная	   бюджетных ассигнований бюджета субъекта Российской Федерации / 16.0	0	0	0	0	0	0
Московская область	Частные; Очная	   государственные социальные стипендии / 2.0	0	0	0	0	0	0
Московская область	Частные; Очная	"   из них за счет средств: 
   стипендиального фонда / 15.0"	0	0	0	84	84	0
Московская область	Частные; Очная	"   именные стипендии, учрежденные: 
   органами государственной власти субъекта Российской Федерации / 5.0"	0	0	0	0	0	0
Московская область	Частные; Очная	   именные стипендии, учрежденные: органами местного самоуправления / 6.0	0	0	0	0	0	0
Московская область	Частные; Очная	   именные стипендии, учрежденные: федеральными государственными органами / 4.0	0	0	0	0	0	0
Московская область	Частные; Очная	   именные стипендии, учрежденные: физическими лицами / 9.0	0	0	0	0	0	0
Московская область	Частные; Очная	   именные стипендии, учрежденные: юридическими лицами / 7.0	0	0	0	0	0	0
Московская область	Частные; Очная	   полученных от приносящей доход деятельности / 17.0	0	0	0	180	169	11
Московская область	Частные; Очная	   стипендии Правительства Российской Федерации / 3.0	0	0	0	6	6	0
Московская область	Частные; Очная	"   стипендии, назначенные физическими лицами (кроме именных,
   указанных в строке 09) / 12.0"	0	0	0	0	0	0
Московская область	Частные; Очная	"   стипендии, назначенные юридическими лицами (кроме именных,
   указанных в строке 07) / 10.0"	0	0	0	0	0	0
Московская область	Частные; Очная	Численность студентов, получающих другие формы материальной поддержки / 14.0	0	0	0	264	253	11
Московская область	Частные; Очная	Численность студентов, получающих: государственные академические стипендии / 1.0	0	0	0	61	61	0
Мурманская область	Государственные, муниципальные (без учета организаций в ведении ФСИН); Очная	      в том числе студентам, направленным ими на обучение / 11.0	0	0	0	0	0	0
Мурманская область	Государственные, муниципальные (без учета организаций в ведении ФСИН); Очная	      в том числе студентам, направленным ими на обучение / 13.0	16	16	0	5	5	0
Мурманская область	Государственные, муниципальные (без учета организаций в ведении ФСИН); Очная	      из них организацией, студентами которой они являются / 8.0	0	0	0	0	0	0
Мурманская область	Государственные, муниципальные (без учета организаций в ведении ФСИН); Очная	   бюджетных ассигнований бюджета субъекта Российской Федерации / 16.0	84	84	0	251	250	1
Мурманская область	Государственные, муниципальные (без учета организаций в ведении ФСИН); Очная	   государственные социальные стипендии / 2.0	631	629	2	1397	1343	54
Мурманская область	Государственные, муниципальные (без учета организаций в ведении ФСИН); Очная	"   из них за счет средств: 
   стипендиального фонда / 15.0"	2	2	0	185	178	7
Мурманская область	Государственные, муниципальные (без учета организаций в ведении ФСИН); Очная	"   именные стипендии, учрежденные: 
   органами государственной власти субъекта Российской Федерации / 5.0"	10	10	0	214	173	41
Мурманская область	Государственные, муниципальные (без учета организаций в ведении ФСИН); Очная	   именные стипендии, учрежденные: органами местного самоуправления / 6.0	0	0	0	52	50	2
Мурманская область	Государственные, муниципальные (без учета организаций в ведении ФСИН); Очная	   именные стипендии, учрежденные: федеральными государственными органами / 4.0	0	0	0	54	46	8
Мурманская область	Государственные, муниципальные (без учета организаций в ведении ФСИН); Очная	   именные стипендии, учрежденные: физическими лицами / 9.0	0	0	0	0	0	0
Мурманская область	Государственные, муниципальные (без учета организаций в ведении ФСИН); Очная	   именные стипендии, учрежденные: юридическими лицами / 7.0	0	0	0	0	0	0
Мурманская область	Государственные, муниципальные (без учета организаций в ведении ФСИН); Очная	   полученных от приносящей доход деятельности / 17.0	18	18	0	79	55	24
Мурманская область	Государственные, муниципальные (без учета организаций в ведении ФСИН); Очная	   стипендии Правительства Российской Федерации / 3.0	7	7	0	11	10	1
Мурманская область	Государственные, муниципальные (без учета организаций в ведении ФСИН); Очная	"   стипендии, назначенные физическими лицами (кроме именных,
   указанных в строке 09) / 12.0"	24	24	0	14	14	0
Мурманская область	Государственные, муниципальные (без учета организаций в ведении ФСИН); Очная	"   стипендии, назначенные юридическими лицами (кроме именных,
   указанных в строке 07) / 10.0"	0	0	0	0	0	0
Мурманская область	Государственные, муниципальные (без учета организаций в ведении ФСИН); Очная	Численность студентов, получающих другие формы материальной поддержки / 14.0	86	86	0	501	469	32
Мурманская область	Государственные, муниципальные (без учета организаций в ведении ФСИН); Очная	Численность студентов, получающих: государственные академические стипендии / 1.0	1232	1199	33	4964	4677	287
Мурманская область	Частные; Очная	      в том числе студентам, направленным ими на обучение / 11.0	0	0	0	0	0	0
Мурманская область	Частные; Очная	      в том числе студентам, направленным ими на обучение / 13.0	0	0	0	0	0	0
Мурманская область	Частные; Очная	      из них организацией, студентами которой они являются / 8.0	0	0	0	0	0	0
Мурманская область	Частные; Очная	   бюджетных ассигнований бюджета субъекта Российской Федерации / 16.0	0	0	0	0	0	0
Мурманская область	Частные; Очная	   государственные социальные стипендии / 2.0	0	0	0	0	0	0
Мурманская область	Частные; Очная	"   из них за счет средств: 
   стипендиального фонда / 15.0"	0	0	0	0	0	0
Мурманская область	Частные; Очная	"   именные стипендии, учрежденные: 
   органами государственной власти субъекта Российской Федерации / 5.0"	0	0	0	0	0	0
Мурманская область	Частные; Очная	   именные стипендии, учрежденные: органами местного самоуправления / 6.0	0	0	0	0	0	0
Мурманская область	Частные; Очная	   именные стипендии, учрежденные: федеральными государственными органами / 4.0	0	0	0	0	0	0
Мурманская область	Частные; Очная	   именные стипендии, учрежденные: физическими лицами / 9.0	0	0	0	0	0	0
Мурманская область	Частные; Очная	   именные стипендии, учрежденные: юридическими лицами / 7.0	0	0	0	0	0	0
Мурманская область	Частные; Очная	   полученных от приносящей доход деятельности / 17.0	0	0	0	0	0	0
Мурманская область	Частные; Очная	   стипендии Правительства Российской Федерации / 3.0	0	0	0	0	0	0
Мурманская область	Частные; Очная	"   стипендии, назначенные физическими лицами (кроме именных,
   указанных в строке 09) / 12.0"	0	0	0	0	0	0
Мурманская область	Частные; Очная	"   стипендии, назначенные юридическими лицами (кроме именных,
   указанных в строке 07) / 10.0"	0	0	0	0	0	0
Мурманская область	Частные; Очная	Численность студентов, получающих другие формы материальной поддержки / 14.0	0	0	0	0	0	0
Мурманская область	Частные; Очная	Численность студентов, получающих: государственные академические стипендии / 1.0	0	0	0	10	10	0
Ненецкий автономный округ	Государственные, муниципальные (без учета организаций в ведении ФСИН); Очная	      в том числе студентам, направленным ими на обучение / 11.0	0	0	0	0	0	0
Ненецкий автономный округ	Государственные, муниципальные (без учета организаций в ведении ФСИН); Очная	      в том числе студентам, направленным ими на обучение / 13.0	0	0	0	0	0	0
Ненецкий автономный округ	Государственные, муниципальные (без учета организаций в ведении ФСИН); Очная	      из них организацией, студентами которой они являются / 8.0	0	0	0	0	0	0
Ненецкий автономный округ	Государственные, муниципальные (без учета организаций в ведении ФСИН); Очная	   бюджетных ассигнований бюджета субъекта Российской Федерации / 16.0	0	0	0	11	9	2
Ненецкий автономный округ	Государственные, муниципальные (без учета организаций в ведении ФСИН); Очная	   государственные социальные стипендии / 2.0	60	60	0	115	107	8
Ненецкий автономный округ	Государственные, муниципальные (без учета организаций в ведении ФСИН); Очная	"   из них за счет средств: 
   стипендиального фонда / 15.0"	0	0	0	0	0	0
Ненецкий автономный округ	Государственные, муниципальные (без учета организаций в ведении ФСИН); Очная	"   именные стипендии, учрежденные: 
   органами государственной власти субъекта Российской Федерации / 5.0"	0	0	0	0	0	0
Ненецкий автономный округ	Государственные, муниципальные (без учета организаций в ведении ФСИН); Очная	   именные стипендии, учрежденные: органами местного самоуправления / 6.0	0	0	0	0	0	0
Ненецкий автономный округ	Государственные, муниципальные (без учета организаций в ведении ФСИН); Очная	   именные стипендии, учрежденные: федеральными государственными органами / 4.0	0	0	0	0	0	0
Ненецкий автономный округ	Государственные, муниципальные (без учета организаций в ведении ФСИН); Очная	   именные стипендии, учрежденные: физическими лицами / 9.0	0	0	0	0	0	0
Ненецкий автономный округ	Государственные, муниципальные (без учета организаций в ведении ФСИН); Очная	   именные стипендии, учрежденные: юридическими лицами / 7.0	0	0	0	0	0	0
Ненецкий автономный округ	Государственные, муниципальные (без учета организаций в ведении ФСИН); Очная	   полученных от приносящей доход деятельности / 17.0	0	0	0	0	0	0
Ненецкий автономный округ	Государственные, муниципальные (без учета организаций в ведении ФСИН); Очная	   стипендии Правительства Российской Федерации / 3.0	0	0	0	1	1	0
Ненецкий автономный округ	Государственные, муниципальные (без учета организаций в ведении ФСИН); Очная	"   стипендии, назначенные физическими лицами (кроме именных,
   указанных в строке 09) / 12.0"	0	0	0	0	0	0
Ненецкий автономный округ	Государственные, муниципальные (без учета организаций в ведении ФСИН); Очная	"   стипендии, назначенные юридическими лицами (кроме именных,
   указанных в строке 07) / 10.0"	0	0	0	0	0	0
Ненецкий автономный округ	Государственные, муниципальные (без учета организаций в ведении ФСИН); Очная	Численность студентов, получающих другие формы материальной поддержки / 14.0	0	0	0	11	9	2
Ненецкий автономный округ	Государственные, муниципальные (без учета организаций в ведении ФСИН); Очная	Численность студентов, получающих: государственные академические стипендии / 1.0	109	109	0	342	312	30
Нижегородская область	Государственные, муниципальные (без учета организаций в ведении ФСИН); Очная	      в том числе студентам, направленным ими на обучение / 11.0	0	0	0	52	52	0
Нижегородская область	Государственные, муниципальные (без учета организаций в ведении ФСИН); Очная	      в том числе студентам, направленным ими на обучение / 13.0	0	0	0	0	0	0
Нижегородская область	Государственные, муниципальные (без учета организаций в ведении ФСИН); Очная	      из них организацией, студентами которой они являются / 8.0	0	0	0	18	18	0
Нижегородская область	Государственные, муниципальные (без учета организаций в ведении ФСИН); Очная	   бюджетных ассигнований бюджета субъекта Российской Федерации / 16.0	965	932	33	2042	2003	39
Нижегородская область	Государственные, муниципальные (без учета организаций в ведении ФСИН); Очная	   государственные социальные стипендии / 2.0	1184	1131	53	3419	3221	198
Нижегородская область	Государственные, муниципальные (без учета организаций в ведении ФСИН); Очная	"   из них за счет средств: 
   стипендиального фонда / 15.0"	3398	3215	183	5663	5202	461
Нижегородская область	Государственные, муниципальные (без учета организаций в ведении ФСИН); Очная	"   именные стипендии, учрежденные: 
   органами государственной власти субъекта Российской Федерации / 5.0"	0	0	0	29	29	0
Нижегородская область	Государственные, муниципальные (без учета организаций в ведении ФСИН); Очная	   именные стипендии, учрежденные: органами местного самоуправления / 6.0	1	1	0	5	5	0
Нижегородская область	Государственные, муниципальные (без учета организаций в ведении ФСИН); Очная	   именные стипендии, учрежденные: федеральными государственными органами / 4.0	0	0	0	0	0	0
Нижегородская область	Государственные, муниципальные (без учета организаций в ведении ФСИН); Очная	   именные стипендии, учрежденные: физическими лицами / 9.0	0	0	0	0	0	0
Нижегородская область	Государственные, муниципальные (без учета организаций в ведении ФСИН); Очная	   именные стипендии, учрежденные: юридическими лицами / 7.0	212	212	0	41	41	0
Нижегородская область	Государственные, муниципальные (без учета организаций в ведении ФСИН); Очная	   полученных от приносящей доход деятельности / 17.0	14	7	7	83	83	0
Нижегородская область	Государственные, муниципальные (без учета организаций в ведении ФСИН); Очная	   стипендии Правительства Российской Федерации / 3.0	39	39	0	98	93	5
Нижегородская область	Государственные, муниципальные (без учета организаций в ведении ФСИН); Очная	"   стипендии, назначенные физическими лицами (кроме именных,
   указанных в строке 09) / 12.0"	0	0	0	1	1	0
Нижегородская область	Государственные, муниципальные (без учета организаций в ведении ФСИН); Очная	"   стипендии, назначенные юридическими лицами (кроме именных,
   указанных в строке 07) / 10.0"	664	664	0	319	315	4
Нижегородская область	Государственные, муниципальные (без учета организаций в ведении ФСИН); Очная	Численность студентов, получающих другие формы материальной поддержки / 14.0	4639	4418	221	6955	6457	498
Нижегородская область	Государственные, муниципальные (без учета организаций в ведении ФСИН); Очная	Численность студентов, получающих: государственные академические стипендии / 1.0	6655	6344	311	25434	23632	1802
Нижегородская область	Частные; Очная	      в том числе студентам, направленным ими на обучение / 11.0	0	0	0	0	0	0
Нижегородская область	Частные; Очная	      в том числе студентам, направленным ими на обучение / 13.0	0	0	0	0	0	0
Нижегородская область	Частные; Очная	      из них организацией, студентами которой они являются / 8.0	0	0	0	0	0	0
Нижегородская область	Частные; Очная	   бюджетных ассигнований бюджета субъекта Российской Федерации / 16.0	0	0	0	0	0	0
Нижегородская область	Частные; Очная	   государственные социальные стипендии / 2.0	0	0	0	2	2	0
Нижегородская область	Частные; Очная	"   из них за счет средств: 
   стипендиального фонда / 15.0"	0	0	0	0	0	0
Нижегородская область	Частные; Очная	"   именные стипендии, учрежденные: 
   органами государственной власти субъекта Российской Федерации / 5.0"	0	0	0	0	0	0
Нижегородская область	Частные; Очная	   именные стипендии, учрежденные: органами местного самоуправления / 6.0	0	0	0	0	0	0
Нижегородская область	Частные; Очная	   именные стипендии, учрежденные: федеральными государственными органами / 4.0	0	0	0	0	0	0
Нижегородская область	Частные; Очная	   именные стипендии, учрежденные: физическими лицами / 9.0	0	0	0	0	0	0
Нижегородская область	Частные; Очная	   именные стипендии, учрежденные: юридическими лицами / 7.0	0	0	0	5	5	0
Нижегородская область	Частные; Очная	   полученных от приносящей доход деятельности / 17.0	0	0	0	0	0	0
Нижегородская область	Частные; Очная	   стипендии Правительства Российской Федерации / 3.0	0	0	0	1	1	0
Нижегородская область	Частные; Очная	"   стипендии, назначенные физическими лицами (кроме именных,
   указанных в строке 09) / 12.0"	0	0	0	0	0	0
Нижегородская область	Частные; Очная	"   стипендии, назначенные юридическими лицами (кроме именных,
   указанных в строке 07) / 10.0"	0	0	0	0	0	0
Нижегородская область	Частные; Очная	Численность студентов, получающих другие формы материальной поддержки / 14.0	0	0	0	0	0	0
Нижегородская область	Частные; Очная	Численность студентов, получающих: государственные академические стипендии / 1.0	0	0	0	25	25	0
Новгородская область	Государственные, муниципальные (без учета организаций в ведении ФСИН); Очная	      в том числе студентам, направленным ими на обучение / 11.0	0	0	0	7	7	0
Новгородская область	Государственные, муниципальные (без учета организаций в ведении ФСИН); Очная	      в том числе студентам, направленным ими на обучение / 13.0	0	0	0	0	0	0
Новгородская область	Государственные, муниципальные (без учета организаций в ведении ФСИН); Очная	      из них организацией, студентами которой они являются / 8.0	0	0	0	2	1	1
Новгородская область	Государственные, муниципальные (без учета организаций в ведении ФСИН); Очная	   бюджетных ассигнований бюджета субъекта Российской Федерации / 16.0	523	487	36	180	163	17
Новгородская область	Государственные, муниципальные (без учета организаций в ведении ФСИН); Очная	   государственные социальные стипендии / 2.0	320	309	11	842	762	80
Новгородская область	Государственные, муниципальные (без учета организаций в ведении ФСИН); Очная	"   из них за счет средств: 
   стипендиального фонда / 15.0"	0	0	0	316	237	79
Новгородская область	Государственные, муниципальные (без учета организаций в ведении ФСИН); Очная	"   именные стипендии, учрежденные: 
   органами государственной власти субъекта Российской Федерации / 5.0"	2	2	0	7	7	0
Новгородская область	Государственные, муниципальные (без учета организаций в ведении ФСИН); Очная	   именные стипендии, учрежденные: органами местного самоуправления / 6.0	0	0	0	47	47	0
Новгородская область	Государственные, муниципальные (без учета организаций в ведении ФСИН); Очная	   именные стипендии, учрежденные: федеральными государственными органами / 4.0	0	0	0	4	4	0
Новгородская область	Государственные, муниципальные (без учета организаций в ведении ФСИН); Очная	   именные стипендии, учрежденные: физическими лицами / 9.0	0	0	0	0	0	0
Новгородская область	Государственные, муниципальные (без учета организаций в ведении ФСИН); Очная	   именные стипендии, учрежденные: юридическими лицами / 7.0	0	0	0	5	4	1
Новгородская область	Государственные, муниципальные (без учета организаций в ведении ФСИН); Очная	   полученных от приносящей доход деятельности / 17.0	0	0	0	3	3	0
Новгородская область	Государственные, муниципальные (без учета организаций в ведении ФСИН); Очная	   стипендии Правительства Российской Федерации / 3.0	15	13	2	16	14	2
Новгородская область	Государственные, муниципальные (без учета организаций в ведении ФСИН); Очная	"   стипендии, назначенные физическими лицами (кроме именных,
   указанных в строке 09) / 12.0"	0	0	0	0	0	0
Новгородская область	Государственные, муниципальные (без учета организаций в ведении ФСИН); Очная	"   стипендии, назначенные юридическими лицами (кроме именных,
   указанных в строке 07) / 10.0"	0	0	0	7	7	0
Новгородская область	Государственные, муниципальные (без учета организаций в ведении ФСИН); Очная	Численность студентов, получающих другие формы материальной поддержки / 14.0	615	571	44	748	627	121
Новгородская область	Государственные, муниципальные (без учета организаций в ведении ФСИН); Очная	Численность студентов, получающих: государственные академические стипендии / 1.0	1396	1340	56	5291	4790	501
Новосибирская область	Государственные, муниципальные (без учета организаций в ведении ФСИН); Очная	      в том числе студентам, направленным ими на обучение / 11.0	0	0	0	0	0	0
Новосибирская область	Государственные, муниципальные (без учета организаций в ведении ФСИН); Очная	      в том числе студентам, направленным ими на обучение / 13.0	0	0	0	0	0	0
Новосибирская область	Государственные, муниципальные (без учета организаций в ведении ФСИН); Очная	      из них организацией, студентами которой они являются / 8.0	0	0	0	12	11	1
Новосибирская область	Государственные, муниципальные (без учета организаций в ведении ФСИН); Очная	   бюджетных ассигнований бюджета субъекта Российской Федерации / 16.0	210	203	7	322	205	117
Новосибирская область	Государственные, муниципальные (без учета организаций в ведении ФСИН); Очная	   государственные социальные стипендии / 2.0	1975	1748	227	4057	3066	991
Новосибирская область	Государственные, муниципальные (без учета организаций в ведении ФСИН); Очная	"   из них за счет средств: 
   стипендиального фонда / 15.0"	12	12	0	1643	1371	272
Новосибирская область	Государственные, муниципальные (без учета организаций в ведении ФСИН); Очная	"   именные стипендии, учрежденные: 
   органами государственной власти субъекта Российской Федерации / 5.0"	139	126	13	571	462	109
Новосибирская область	Государственные, муниципальные (без учета организаций в ведении ФСИН); Очная	   именные стипендии, учрежденные: органами местного самоуправления / 6.0	2	2	0	13	9	4
Новосибирская область	Государственные, муниципальные (без учета организаций в ведении ФСИН); Очная	   именные стипендии, учрежденные: федеральными государственными органами / 4.0	0	0	0	3	2	1
Новосибирская область	Государственные, муниципальные (без учета организаций в ведении ФСИН); Очная	   именные стипендии, учрежденные: физическими лицами / 9.0	0	0	0	3	3	0
Новосибирская область	Государственные, муниципальные (без учета организаций в ведении ФСИН); Очная	   именные стипендии, учрежденные: юридическими лицами / 7.0	6	6	0	30	26	4
Новосибирская область	Государственные, муниципальные (без учета организаций в ведении ФСИН); Очная	   полученных от приносящей доход деятельности / 17.0	47	20	27	619	350	269
Новосибирская область	Государственные, муниципальные (без учета организаций в ведении ФСИН); Очная	   стипендии Правительства Российской Федерации / 3.0	54	53	1	129	107	22
Новосибирская область	Государственные, муниципальные (без учета организаций в ведении ФСИН); Очная	"   стипендии, назначенные физическими лицами (кроме именных,
   указанных в строке 09) / 12.0"	0	0	0	0	0	0
Новосибирская область	Государственные, муниципальные (без учета организаций в ведении ФСИН); Очная	"   стипендии, назначенные юридическими лицами (кроме именных,
   указанных в строке 07) / 10.0"	0	0	0	10	6	4
Новосибирская область	Государственные, муниципальные (без учета организаций в ведении ФСИН); Очная	Численность студентов, получающих другие формы материальной поддержки / 14.0	269	235	34	2591	1916	675
Новосибирская область	Государственные, муниципальные (без учета организаций в ведении ФСИН); Очная	Численность студентов, получающих: государственные академические стипендии / 1.0	5355	4835	520	19546	14094	5452
Новосибирская область	Частные; Очная	      в том числе студентам, направленным ими на обучение / 11.0	0	0	0	0	0	0
Новосибирская область	Частные; Очная	      в том числе студентам, направленным ими на обучение / 13.0	0	0	0	0	0	0
Новосибирская область	Частные; Очная	      из них организацией, студентами которой они являются / 8.0	0	0	0	0	0	0
Новосибирская область	Частные; Очная	   бюджетных ассигнований бюджета субъекта Российской Федерации / 16.0	0	0	0	0	0	0
Новосибирская область	Частные; Очная	   государственные социальные стипендии / 2.0	0	0	0	0	0	0
Новосибирская область	Частные; Очная	"   из них за счет средств: 
   стипендиального фонда / 15.0"	0	0	0	0	0	0
Новосибирская область	Частные; Очная	"   именные стипендии, учрежденные: 
   органами государственной власти субъекта Российской Федерации / 5.0"	0	0	0	3	2	1
Новосибирская область	Частные; Очная	   именные стипендии, учрежденные: органами местного самоуправления / 6.0	0	0	0	0	0	0
Новосибирская область	Частные; Очная	   именные стипендии, учрежденные: федеральными государственными органами / 4.0	0	0	0	0	0	0
Новосибирская область	Частные; Очная	   именные стипендии, учрежденные: физическими лицами / 9.0	0	0	0	0	0	0
Новосибирская область	Частные; Очная	   именные стипендии, учрежденные: юридическими лицами / 7.0	0	0	0	6	5	1
Новосибирская область	Частные; Очная	   полученных от приносящей доход деятельности / 17.0	0	0	0	0	0	0
Новосибирская область	Частные; Очная	   стипендии Правительства Российской Федерации / 3.0	0	0	0	2	2	0
Новосибирская область	Частные; Очная	"   стипендии, назначенные физическими лицами (кроме именных,
   указанных в строке 09) / 12.0"	0	0	0	0	0	0
Новосибирская область	Частные; Очная	"   стипендии, назначенные юридическими лицами (кроме именных,
   указанных в строке 07) / 10.0"	0	0	0	0	0	0
Новосибирская область	Частные; Очная	Численность студентов, получающих другие формы материальной поддержки / 14.0	0	0	0	0	0	0
Новосибирская область	Частные; Очная	Численность студентов, получающих: государственные академические стипендии / 1.0	0	0	0	9	6	3
Омская область	Государственные, муниципальные (без учета организаций в ведении ФСИН); Очная	      в том числе студентам, направленным ими на обучение / 11.0	22	0	22	117	111	6
Омская область	Государственные, муниципальные (без учета организаций в ведении ФСИН); Очная	      в том числе студентам, направленным ими на обучение / 13.0	0	0	0	0	0	0
Омская область	Государственные, муниципальные (без учета организаций в ведении ФСИН); Очная	      из них организацией, студентами которой они являются / 8.0	0	0	0	1	1	0
Омская область	Государственные, муниципальные (без учета организаций в ведении ФСИН); Очная	   бюджетных ассигнований бюджета субъекта Российской Федерации / 16.0	137	137	0	236	207	29
Омская область	Государственные, муниципальные (без учета организаций в ведении ФСИН); Очная	   государственные социальные стипендии / 2.0	1121	1116	5	2446	2009	437
Омская область	Государственные, муниципальные (без учета организаций в ведении ФСИН); Очная	"   из них за счет средств: 
   стипендиального фонда / 15.0"	5	3	2	703	408	295
Омская область	Государственные, муниципальные (без учета организаций в ведении ФСИН); Очная	"   именные стипендии, учрежденные: 
   органами государственной власти субъекта Российской Федерации / 5.0"	0	0	0	1	1	0
Омская область	Государственные, муниципальные (без учета организаций в ведении ФСИН); Очная	   именные стипендии, учрежденные: органами местного самоуправления / 6.0	0	0	0	0	0	0
Омская область	Государственные, муниципальные (без учета организаций в ведении ФСИН); Очная	   именные стипендии, учрежденные: федеральными государственными органами / 4.0	0	0	0	2	2	0
Омская область	Государственные, муниципальные (без учета организаций в ведении ФСИН); Очная	   именные стипендии, учрежденные: физическими лицами / 9.0	0	0	0	0	0	0
Омская область	Государственные, муниципальные (без учета организаций в ведении ФСИН); Очная	   именные стипендии, учрежденные: юридическими лицами / 7.0	0	0	0	19	10	9
Омская область	Государственные, муниципальные (без учета организаций в ведении ФСИН); Очная	   полученных от приносящей доход деятельности / 17.0	0	0	0	0	0	0
Омская область	Государственные, муниципальные (без учета организаций в ведении ФСИН); Очная	   стипендии Правительства Российской Федерации / 3.0	9	9	0	56	49	7
Омская область	Государственные, муниципальные (без учета организаций в ведении ФСИН); Очная	"   стипендии, назначенные физическими лицами (кроме именных,
   указанных в строке 09) / 12.0"	0	0	0	0	0	0
Омская область	Государственные, муниципальные (без учета организаций в ведении ФСИН); Очная	"   стипендии, назначенные юридическими лицами (кроме именных,
   указанных в строке 07) / 10.0"	37	15	22	117	111	6
Омская область	Государственные, муниципальные (без учета организаций в ведении ФСИН); Очная	Численность студентов, получающих другие формы материальной поддержки / 14.0	230	228	2	1189	792	397
Омская область	Государственные, муниципальные (без учета организаций в ведении ФСИН); Очная	Численность студентов, получающих: государственные академические стипендии / 1.0	4293	4184	109	16439	13376	3063
Омская область	Частные; Очная	      в том числе студентам, направленным ими на обучение / 11.0	0	0	0	0	0	0
Омская область	Частные; Очная	      в том числе студентам, направленным ими на обучение / 13.0	0	0	0	0	0	0
Омская область	Частные; Очная	      из них организацией, студентами которой они являются / 8.0	0	0	0	0	0	0
Омская область	Частные; Очная	   бюджетных ассигнований бюджета субъекта Российской Федерации / 16.0	0	0	0	11	11	0
Омская область	Частные; Очная	   государственные социальные стипендии / 2.0	0	0	0	18	18	0
Омская область	Частные; Очная	"   из них за счет средств: 
   стипендиального фонда / 15.0"	0	0	0	0	0	0
Омская область	Частные; Очная	"   именные стипендии, учрежденные: 
   органами государственной власти субъекта Российской Федерации / 5.0"	0	0	0	0	0	0
Омская область	Частные; Очная	   именные стипендии, учрежденные: органами местного самоуправления / 6.0	0	0	0	0	0	0
Омская область	Частные; Очная	   именные стипендии, учрежденные: федеральными государственными органами / 4.0	0	0	0	0	0	0
Омская область	Частные; Очная	   именные стипендии, учрежденные: физическими лицами / 9.0	0	0	0	0	0	0
Омская область	Частные; Очная	   именные стипендии, учрежденные: юридическими лицами / 7.0	0	0	0	0	0	0
Омская область	Частные; Очная	   полученных от приносящей доход деятельности / 17.0	0	0	0	0	0	0
Омская область	Частные; Очная	   стипендии Правительства Российской Федерации / 3.0	0	0	0	0	0	0
Омская область	Частные; Очная	"   стипендии, назначенные физическими лицами (кроме именных,
   указанных в строке 09) / 12.0"	0	0	0	0	0	0
Омская область	Частные; Очная	"   стипендии, назначенные юридическими лицами (кроме именных,
   указанных в строке 07) / 10.0"	0	0	0	0	0	0
Омская область	Частные; Очная	Численность студентов, получающих другие формы материальной поддержки / 14.0	0	0	0	11	11	0
Омская область	Частные; Очная	Численность студентов, получающих: государственные академические стипендии / 1.0	0	0	0	243	243	0
Оренбургская область	Государственные, муниципальные (без учета организаций в ведении ФСИН); Очная	      в том числе студентам, направленным ими на обучение / 11.0	0	0	0	123	122	1
Оренбургская область	Государственные, муниципальные (без учета организаций в ведении ФСИН); Очная	      в том числе студентам, направленным ими на обучение / 13.0	0	0	0	0	0	0
Оренбургская область	Государственные, муниципальные (без учета организаций в ведении ФСИН); Очная	      из них организацией, студентами которой они являются / 8.0	0	0	0	0	0	0
Оренбургская область	Государственные, муниципальные (без учета организаций в ведении ФСИН); Очная	   бюджетных ассигнований бюджета субъекта Российской Федерации / 16.0	139	138	1	298	244	54
Оренбургская область	Государственные, муниципальные (без учета организаций в ведении ФСИН); Очная	   государственные социальные стипендии / 2.0	1279	1279	0	4444	4181	263
Оренбургская область	Государственные, муниципальные (без учета организаций в ведении ФСИН); Очная	"   из них за счет средств: 
   стипендиального фонда / 15.0"	1	1	0	694	640	54
Оренбургская область	Государственные, муниципальные (без учета организаций в ведении ФСИН); Очная	"   именные стипендии, учрежденные: 
   органами государственной власти субъекта Российской Федерации / 5.0"	1	1	0	11	11	0
Оренбургская область	Государственные, муниципальные (без учета организаций в ведении ФСИН); Очная	   именные стипендии, учрежденные: органами местного самоуправления / 6.0	0	0	0	2	2	0
Оренбургская область	Государственные, муниципальные (без учета организаций в ведении ФСИН); Очная	   именные стипендии, учрежденные: федеральными государственными органами / 4.0	0	0	0	3	1	2
Оренбургская область	Государственные, муниципальные (без учета организаций в ведении ФСИН); Очная	   именные стипендии, учрежденные: физическими лицами / 9.0	0	0	0	4	4	0
Оренбургская область	Государственные, муниципальные (без учета организаций в ведении ФСИН); Очная	   именные стипендии, учрежденные: юридическими лицами / 7.0	0	0	0	11	11	0
Оренбургская область	Государственные, муниципальные (без учета организаций в ведении ФСИН); Очная	   полученных от приносящей доход деятельности / 17.0	23	23	0	255	222	33
Оренбургская область	Государственные, муниципальные (без учета организаций в ведении ФСИН); Очная	   стипендии Правительства Российской Федерации / 3.0	10	10	0	47	47	0
Оренбургская область	Государственные, муниципальные (без учета организаций в ведении ФСИН); Очная	"   стипендии, назначенные физическими лицами (кроме именных,
   указанных в строке 09) / 12.0"	0	0	0	18	18	0
Оренбургская область	Государственные, муниципальные (без учета организаций в ведении ФСИН); Очная	"   стипендии, назначенные юридическими лицами (кроме именных,
   указанных в строке 07) / 10.0"	123	123	0	201	200	1
Оренбургская область	Государственные, муниципальные (без учета организаций в ведении ФСИН); Очная	Численность студентов, получающих другие формы материальной поддержки / 14.0	163	162	1	1290	1150	140
Оренбургская область	Государственные, муниципальные (без учета организаций в ведении ФСИН); Очная	Численность студентов, получающих: государственные академические стипендии / 1.0	3261	3261	0	19235	17750	1485
Орловская область	Государственные, муниципальные (без учета организаций в ведении ФСИН); Очная	      в том числе студентам, направленным ими на обучение / 11.0	0	0	0	42	42	0
Орловская область	Государственные, муниципальные (без учета организаций в ведении ФСИН); Очная	      в том числе студентам, направленным ими на обучение / 13.0	0	0	0	0	0	0
Орловская область	Государственные, муниципальные (без учета организаций в ведении ФСИН); Очная	      из них организацией, студентами которой они являются / 8.0	0	0	0	8	8	0
Орловская область	Государственные, муниципальные (без учета организаций в ведении ФСИН); Очная	   бюджетных ассигнований бюджета субъекта Российской Федерации / 16.0	5	5	0	78	78	0
Орловская область	Государственные, муниципальные (без учета организаций в ведении ФСИН); Очная	   государственные социальные стипендии / 2.0	660	634	26	2782	2737	45
Орловская область	Государственные, муниципальные (без учета организаций в ведении ФСИН); Очная	"   из них за счет средств: 
   стипендиального фонда / 15.0"	283	283	0	2554	2552	2
Орловская область	Государственные, муниципальные (без учета организаций в ведении ФСИН); Очная	"   именные стипендии, учрежденные: 
   органами государственной власти субъекта Российской Федерации / 5.0"	4	4	0	80	78	2
Орловская область	Государственные, муниципальные (без учета организаций в ведении ФСИН); Очная	   именные стипендии, учрежденные: органами местного самоуправления / 6.0	1	1	0	14	14	0
Орловская область	Государственные, муниципальные (без учета организаций в ведении ФСИН); Очная	   именные стипендии, учрежденные: федеральными государственными органами / 4.0	0	0	0	0	0	0
Орловская область	Государственные, муниципальные (без учета организаций в ведении ФСИН); Очная	   именные стипендии, учрежденные: физическими лицами / 9.0	0	0	0	0	0	0
Орловская область	Государственные, муниципальные (без учета организаций в ведении ФСИН); Очная	   именные стипендии, учрежденные: юридическими лицами / 7.0	0	0	0	14	14	0
Орловская область	Государственные, муниципальные (без учета организаций в ведении ФСИН); Очная	   полученных от приносящей доход деятельности / 17.0	1	1	0	58	58	0
Орловская область	Государственные, муниципальные (без учета организаций в ведении ФСИН); Очная	   стипендии Правительства Российской Федерации / 3.0	2	2	0	29	29	0
Орловская область	Государственные, муниципальные (без учета организаций в ведении ФСИН); Очная	"   стипендии, назначенные физическими лицами (кроме именных,
   указанных в строке 09) / 12.0"	0	0	0	0	0	0
Орловская область	Государственные, муниципальные (без учета организаций в ведении ФСИН); Очная	"   стипендии, назначенные юридическими лицами (кроме именных,
   указанных в строке 07) / 10.0"	0	0	0	42	42	0
Орловская область	Государственные, муниципальные (без учета организаций в ведении ФСИН); Очная	Численность студентов, получающих другие формы материальной поддержки / 14.0	288	288	0	2676	2674	2
Орловская область	Государственные, муниципальные (без учета организаций в ведении ФСИН); Очная	Численность студентов, получающих: государственные академические стипендии / 1.0	958	907	51	6747	6577	170
Пензенская область	Государственные, муниципальные (без учета организаций в ведении ФСИН); Очная	      в том числе студентам, направленным ими на обучение / 11.0	0	0	0	64	64	0
Пензенская область	Государственные, муниципальные (без учета организаций в ведении ФСИН); Очная	      в том числе студентам, направленным ими на обучение / 13.0	0	0	0	0	0	0
Пензенская область	Государственные, муниципальные (без учета организаций в ведении ФСИН); Очная	      из них организацией, студентами которой они являются / 8.0	0	0	0	0	0	0
Пензенская область	Государственные, муниципальные (без учета организаций в ведении ФСИН); Очная	   бюджетных ассигнований бюджета субъекта Российской Федерации / 16.0	32	32	0	563	562	1
Пензенская область	Государственные, муниципальные (без учета организаций в ведении ФСИН); Очная	   государственные социальные стипендии / 2.0	978	960	18	3014	2790	224
Пензенская область	Государственные, муниципальные (без учета организаций в ведении ФСИН); Очная	"   из них за счет средств: 
   стипендиального фонда / 15.0"	988	972	16	2579	2479	100
Пензенская область	Государственные, муниципальные (без учета организаций в ведении ФСИН); Очная	"   именные стипендии, учрежденные: 
   органами государственной власти субъекта Российской Федерации / 5.0"	0	0	0	0	0	0
Пензенская область	Государственные, муниципальные (без учета организаций в ведении ФСИН); Очная	   именные стипендии, учрежденные: органами местного самоуправления / 6.0	0	0	0	0	0	0
Пензенская область	Государственные, муниципальные (без учета организаций в ведении ФСИН); Очная	   именные стипендии, учрежденные: федеральными государственными органами / 4.0	0	0	0	5	5	0
Пензенская область	Государственные, муниципальные (без учета организаций в ведении ФСИН); Очная	   именные стипендии, учрежденные: физическими лицами / 9.0	0	0	0	0	0	0
Пензенская область	Государственные, муниципальные (без учета организаций в ведении ФСИН); Очная	   именные стипендии, учрежденные: юридическими лицами / 7.0	0	0	0	6	6	0
Пензенская область	Государственные, муниципальные (без учета организаций в ведении ФСИН); Очная	   полученных от приносящей доход деятельности / 17.0	4	4	0	8	6	2
Пензенская область	Государственные, муниципальные (без учета организаций в ведении ФСИН); Очная	   стипендии Правительства Российской Федерации / 3.0	34	34	0	56	56	0
Пензенская область	Государственные, муниципальные (без учета организаций в ведении ФСИН); Очная	"   стипендии, назначенные физическими лицами (кроме именных,
   указанных в строке 09) / 12.0"	0	0	0	0	0	0
Пензенская область	Государственные, муниципальные (без учета организаций в ведении ФСИН); Очная	"   стипендии, назначенные юридическими лицами (кроме именных,
   указанных в строке 07) / 10.0"	0	0	0	64	64	0
Пензенская область	Государственные, муниципальные (без учета организаций в ведении ФСИН); Очная	Численность студентов, получающих другие формы материальной поддержки / 14.0	1058	1042	16	3012	2909	103
Пензенская область	Государственные, муниципальные (без учета организаций в ведении ФСИН); Очная	Численность студентов, получающих: государственные академические стипендии / 1.0	2856	2774	82	11564	10790	774
Пермский край	Государственные, муниципальные (без учета организаций в ведении ФСИН); Очная	      в том числе студентам, направленным ими на обучение / 11.0	0	0	0	98	98	0
Пермский край	Государственные, муниципальные (без учета организаций в ведении ФСИН); Очная	      в том числе студентам, направленным ими на обучение / 13.0	0	0	0	0	0	0
Пермский край	Государственные, муниципальные (без учета организаций в ведении ФСИН); Очная	      из них организацией, студентами которой они являются / 8.0	0	0	0	11	11	0
Пермский край	Государственные, муниципальные (без учета организаций в ведении ФСИН); Очная	   бюджетных ассигнований бюджета субъекта Российской Федерации / 16.0	469	445	24	999	834	165
Пермский край	Государственные, муниципальные (без учета организаций в ведении ФСИН); Очная	   государственные социальные стипендии / 2.0	2410	2378	32	6779	5964	815
Пермский край	Государственные, муниципальные (без учета организаций в ведении ФСИН); Очная	"   из них за счет средств: 
   стипендиального фонда / 15.0"	560	560	0	2259	2050	209
Пермский край	Государственные, муниципальные (без учета организаций в ведении ФСИН); Очная	"   именные стипендии, учрежденные: 
   органами государственной власти субъекта Российской Федерации / 5.0"	0	0	0	0	0	0
Пермский край	Государственные, муниципальные (без учета организаций в ведении ФСИН); Очная	   именные стипендии, учрежденные: органами местного самоуправления / 6.0	0	0	0	0	0	0
Пермский край	Государственные, муниципальные (без учета организаций в ведении ФСИН); Очная	   именные стипендии, учрежденные: федеральными государственными органами / 4.0	0	0	0	0	0	0
Пермский край	Государственные, муниципальные (без учета организаций в ведении ФСИН); Очная	   именные стипендии, учрежденные: физическими лицами / 9.0	0	0	0	10	10	0
Пермский край	Государственные, муниципальные (без учета организаций в ведении ФСИН); Очная	   именные стипендии, учрежденные: юридическими лицами / 7.0	14	14	0	22	22	0
Пермский край	Государственные, муниципальные (без учета организаций в ведении ФСИН); Очная	   полученных от приносящей доход деятельности / 17.0	0	0	0	140	122	18
Пермский край	Государственные, муниципальные (без учета организаций в ведении ФСИН); Очная	   стипендии Правительства Российской Федерации / 3.0	14	14	0	43	43	0
Пермский край	Государственные, муниципальные (без учета организаций в ведении ФСИН); Очная	"   стипендии, назначенные физическими лицами (кроме именных,
   указанных в строке 09) / 12.0"	0	0	0	0	0	0
Пермский край	Государственные, муниципальные (без учета организаций в ведении ФСИН); Очная	"   стипендии, назначенные юридическими лицами (кроме именных,
   указанных в строке 07) / 10.0"	0	0	0	120	120	0
Пермский край	Государственные, муниципальные (без учета организаций в ведении ФСИН); Очная	Численность студентов, получающих другие формы материальной поддержки / 14.0	1115	1091	24	3298	2909	389
Пермский край	Государственные, муниципальные (без учета организаций в ведении ФСИН); Очная	Численность студентов, получающих: государственные академические стипендии / 1.0	5870	5804	66	16210	14351	1859
Пермский край	Частные; Очная	      в том числе студентам, направленным ими на обучение / 11.0	0	0	0	0	0	0
Пермский край	Частные; Очная	      в том числе студентам, направленным ими на обучение / 13.0	0	0	0	0	0	0
Пермский край	Частные; Очная	      из них организацией, студентами которой они являются / 8.0	0	0	0	0	0	0
Пермский край	Частные; Очная	   бюджетных ассигнований бюджета субъекта Российской Федерации / 16.0	0	0	0	0	0	0
Пермский край	Частные; Очная	   государственные социальные стипендии / 2.0	0	0	0	0	0	0
Пермский край	Частные; Очная	"   из них за счет средств: 
   стипендиального фонда / 15.0"	0	0	0	0	0	0
Пермский край	Частные; Очная	"   именные стипендии, учрежденные: 
   органами государственной власти субъекта Российской Федерации / 5.0"	0	0	0	0	0	0
Пермский край	Частные; Очная	   именные стипендии, учрежденные: органами местного самоуправления / 6.0	0	0	0	0	0	0
Пермский край	Частные; Очная	   именные стипендии, учрежденные: федеральными государственными органами / 4.0	0	0	0	0	0	0
Пермский край	Частные; Очная	   именные стипендии, учрежденные: физическими лицами / 9.0	0	0	0	0	0	0
Пермский край	Частные; Очная	   именные стипендии, учрежденные: юридическими лицами / 7.0	0	0	0	0	0	0
Пермский край	Частные; Очная	   полученных от приносящей доход деятельности / 17.0	0	0	0	15	13	2
Пермский край	Частные; Очная	   стипендии Правительства Российской Федерации / 3.0	0	0	0	0	0	0
Пермский край	Частные; Очная	"   стипендии, назначенные физическими лицами (кроме именных,
   указанных в строке 09) / 12.0"	0	0	0	0	0	0
Пермский край	Частные; Очная	"   стипендии, назначенные юридическими лицами (кроме именных,
   указанных в строке 07) / 10.0"	0	0	0	0	0	0
Пермский край	Частные; Очная	Численность студентов, получающих другие формы материальной поддержки / 14.0	0	0	0	15	13	2
Пермский край	Частные; Очная	Численность студентов, получающих: государственные академические стипендии / 1.0	0	0	0	0	0	0
Приморский край	Государственные, муниципальные (без учета организаций в ведении ФСИН); Очная	      в том числе студентам, направленным ими на обучение / 11.0	0	0	0	53	52	1
Приморский край	Государственные, муниципальные (без учета организаций в ведении ФСИН); Очная	      в том числе студентам, направленным ими на обучение / 13.0	0	0	0	0	0	0
Приморский край	Государственные, муниципальные (без учета организаций в ведении ФСИН); Очная	      из них организацией, студентами которой они являются / 8.0	0	0	0	138	97	41
Приморский край	Государственные, муниципальные (без учета организаций в ведении ФСИН); Очная	   бюджетных ассигнований бюджета субъекта Российской Федерации / 16.0	216	211	5	251	204	47
Приморский край	Государственные, муниципальные (без учета организаций в ведении ФСИН); Очная	   государственные социальные стипендии / 2.0	752	737	15	1657	1440	217
Приморский край	Государственные, муниципальные (без учета организаций в ведении ФСИН); Очная	"   из них за счет средств: 
   стипендиального фонда / 15.0"	257	252	5	637	632	5
Приморский край	Государственные, муниципальные (без учета организаций в ведении ФСИН); Очная	"   именные стипендии, учрежденные: 
   органами государственной власти субъекта Российской Федерации / 5.0"	23	22	1	124	104	20
Приморский край	Государственные, муниципальные (без учета организаций в ведении ФСИН); Очная	   именные стипендии, учрежденные: органами местного самоуправления / 6.0	6	6	0	12	12	0
Приморский край	Государственные, муниципальные (без учета организаций в ведении ФСИН); Очная	   именные стипендии, учрежденные: федеральными государственными органами / 4.0	0	0	0	5	5	0
Приморский край	Государственные, муниципальные (без учета организаций в ведении ФСИН); Очная	   именные стипендии, учрежденные: физическими лицами / 9.0	0	0	0	0	0	0
Приморский край	Государственные, муниципальные (без учета организаций в ведении ФСИН); Очная	   именные стипендии, учрежденные: юридическими лицами / 7.0	1	1	0	147	106	41
Приморский край	Государственные, муниципальные (без учета организаций в ведении ФСИН); Очная	   полученных от приносящей доход деятельности / 17.0	0	0	0	274	232	42
Приморский край	Государственные, муниципальные (без учета организаций в ведении ФСИН); Очная	   стипендии Правительства Российской Федерации / 3.0	13	13	0	45	36	9
Приморский край	Государственные, муниципальные (без учета организаций в ведении ФСИН); Очная	"   стипендии, назначенные физическими лицами (кроме именных,
   указанных в строке 09) / 12.0"	0	0	0	0	0	0
Приморский край	Государственные, муниципальные (без учета организаций в ведении ФСИН); Очная	"   стипендии, назначенные юридическими лицами (кроме именных,
   указанных в строке 07) / 10.0"	3	3	0	53	52	1
Приморский край	Государственные, муниципальные (без учета организаций в ведении ФСИН); Очная	Численность студентов, получающих другие формы материальной поддержки / 14.0	368	363	5	1115	1021	94
Приморский край	Государственные, муниципальные (без учета организаций в ведении ФСИН); Очная	Численность студентов, получающих: государственные академические стипендии / 1.0	2970	2817	153	13091	10559	2532
Приморский край	Частные; Очная	      в том числе студентам, направленным ими на обучение / 11.0	0	0	0	0	0	0
Приморский край	Частные; Очная	      в том числе студентам, направленным ими на обучение / 13.0	0	0	0	0	0	0
Приморский край	Частные; Очная	      из них организацией, студентами которой они являются / 8.0	0	0	0	0	0	0
Приморский край	Частные; Очная	   бюджетных ассигнований бюджета субъекта Российской Федерации / 16.0	0	0	0	0	0	0
Приморский край	Частные; Очная	   государственные социальные стипендии / 2.0	0	0	0	1	0	1
Приморский край	Частные; Очная	"   из них за счет средств: 
   стипендиального фонда / 15.0"	0	0	0	0	0	0
Приморский край	Частные; Очная	"   именные стипендии, учрежденные: 
   органами государственной власти субъекта Российской Федерации / 5.0"	0	0	0	0	0	0
Приморский край	Частные; Очная	   именные стипендии, учрежденные: органами местного самоуправления / 6.0	0	0	0	0	0	0
Приморский край	Частные; Очная	   именные стипендии, учрежденные: федеральными государственными органами / 4.0	0	0	0	0	0	0
Приморский край	Частные; Очная	   именные стипендии, учрежденные: физическими лицами / 9.0	0	0	0	0	0	0
Приморский край	Частные; Очная	   именные стипендии, учрежденные: юридическими лицами / 7.0	0	0	0	0	0	0
Приморский край	Частные; Очная	   полученных от приносящей доход деятельности / 17.0	0	0	0	0	0	0
Приморский край	Частные; Очная	   стипендии Правительства Российской Федерации / 3.0	0	0	0	0	0	0
Приморский край	Частные; Очная	"   стипендии, назначенные физическими лицами (кроме именных,
   указанных в строке 09) / 12.0"	0	0	0	0	0	0
Приморский край	Частные; Очная	"   стипендии, назначенные юридическими лицами (кроме именных,
   указанных в строке 07) / 10.0"	0	0	0	0	0	0
Приморский край	Частные; Очная	Численность студентов, получающих другие формы материальной поддержки / 14.0	0	0	0	0	0	0
Приморский край	Частные; Очная	Численность студентов, получающих: государственные академические стипендии / 1.0	0	0	0	87	67	20
Псковская область	Государственные, муниципальные (без учета организаций в ведении ФСИН); Очная	      в том числе студентам, направленным ими на обучение / 11.0	0	0	0	39	16	23
Псковская область	Государственные, муниципальные (без учета организаций в ведении ФСИН); Очная	      в том числе студентам, направленным ими на обучение / 13.0	0	0	0	0	0	0
Псковская область	Государственные, муниципальные (без учета организаций в ведении ФСИН); Очная	      из них организацией, студентами которой они являются / 8.0	0	0	0	0	0	0
Псковская область	Государственные, муниципальные (без учета организаций в ведении ФСИН); Очная	   бюджетных ассигнований бюджета субъекта Российской Федерации / 16.0	62	62	0	155	144	11
Псковская область	Государственные, муниципальные (без учета организаций в ведении ФСИН); Очная	   государственные социальные стипендии / 2.0	616	535	81	1169	934	235
Псковская область	Государственные, муниципальные (без учета организаций в ведении ФСИН); Очная	"   из них за счет средств: 
   стипендиального фонда / 15.0"	975	704	271	1211	940	271
Псковская область	Государственные, муниципальные (без учета организаций в ведении ФСИН); Очная	"   именные стипендии, учрежденные: 
   органами государственной власти субъекта Российской Федерации / 5.0"	1	1	0	5	4	1
Псковская область	Государственные, муниципальные (без учета организаций в ведении ФСИН); Очная	   именные стипендии, учрежденные: органами местного самоуправления / 6.0	0	0	0	0	0	0
Псковская область	Государственные, муниципальные (без учета организаций в ведении ФСИН); Очная	   именные стипендии, учрежденные: федеральными государственными органами / 4.0	0	0	0	0	0	0
Псковская область	Государственные, муниципальные (без учета организаций в ведении ФСИН); Очная	   именные стипендии, учрежденные: физическими лицами / 9.0	0	0	0	0	0	0
Псковская область	Государственные, муниципальные (без учета организаций в ведении ФСИН); Очная	   именные стипендии, учрежденные: юридическими лицами / 7.0	0	0	0	0	0	0
Псковская область	Государственные, муниципальные (без учета организаций в ведении ФСИН); Очная	   полученных от приносящей доход деятельности / 17.0	43	32	11	124	75	49
Псковская область	Государственные, муниципальные (без учета организаций в ведении ФСИН); Очная	   стипендии Правительства Российской Федерации / 3.0	2	1	1	9	5	4
Псковская область	Государственные, муниципальные (без учета организаций в ведении ФСИН); Очная	"   стипендии, назначенные физическими лицами (кроме именных,
   указанных в строке 09) / 12.0"	0	0	0	0	0	0
Псковская область	Государственные, муниципальные (без учета организаций в ведении ФСИН); Очная	"   стипендии, назначенные юридическими лицами (кроме именных,
   указанных в строке 07) / 10.0"	0	0	0	39	16	23
Псковская область	Государственные, муниципальные (без учета организаций в ведении ФСИН); Очная	Численность студентов, получающих другие формы материальной поддержки / 14.0	1080	798	282	1362	1031	331
Псковская область	Государственные, муниципальные (без учета организаций в ведении ФСИН); Очная	Численность студентов, получающих: государственные академические стипендии / 1.0	1643	1271	372	4703	3815	888
Псковская область	Частные; Очная	      в том числе студентам, направленным ими на обучение / 11.0	0	0	0	0	0	0
Псковская область	Частные; Очная	      в том числе студентам, направленным ими на обучение / 13.0	0	0	0	0	0	0
Псковская область	Частные; Очная	      из них организацией, студентами которой они являются / 8.0	0	0	0	0	0	0
Псковская область	Частные; Очная	   бюджетных ассигнований бюджета субъекта Российской Федерации / 16.0	0	0	0	0	0	0
Псковская область	Частные; Очная	   государственные социальные стипендии / 2.0	0	0	0	1	1	0
Псковская область	Частные; Очная	"   из них за счет средств: 
   стипендиального фонда / 15.0"	0	0	0	0	0	0
Псковская область	Частные; Очная	"   именные стипендии, учрежденные: 
   органами государственной власти субъекта Российской Федерации / 5.0"	0	0	0	0	0	0
Псковская область	Частные; Очная	   именные стипендии, учрежденные: органами местного самоуправления / 6.0	0	0	0	0	0	0
Псковская область	Частные; Очная	   именные стипендии, учрежденные: федеральными государственными органами / 4.0	0	0	0	0	0	0
Псковская область	Частные; Очная	   именные стипендии, учрежденные: физическими лицами / 9.0	0	0	0	0	0	0
Псковская область	Частные; Очная	   именные стипендии, учрежденные: юридическими лицами / 7.0	0	0	0	0	0	0
Псковская область	Частные; Очная	   полученных от приносящей доход деятельности / 17.0	0	0	0	0	0	0
Псковская область	Частные; Очная	   стипендии Правительства Российской Федерации / 3.0	0	0	0	1	1	0
Псковская область	Частные; Очная	"   стипендии, назначенные физическими лицами (кроме именных,
   указанных в строке 09) / 12.0"	0	0	0	0	0	0
Псковская область	Частные; Очная	"   стипендии, назначенные юридическими лицами (кроме именных,
   указанных в строке 07) / 10.0"	0	0	0	0	0	0
Псковская область	Частные; Очная	Численность студентов, получающих другие формы материальной поддержки / 14.0	0	0	0	0	0	0
Псковская область	Частные; Очная	Численность студентов, получающих: государственные академические стипендии / 1.0	0	0	0	29	29	0
Республика Адыгея	Государственные, муниципальные (без учета организаций в ведении ФСИН); Очная	      в том числе студентам, направленным ими на обучение / 11.0	0	0	0	0	0	0
Республика Адыгея	Государственные, муниципальные (без учета организаций в ведении ФСИН); Очная	      в том числе студентам, направленным ими на обучение / 13.0	0	0	0	0	0	0
Республика Адыгея	Государственные, муниципальные (без учета организаций в ведении ФСИН); Очная	      из них организацией, студентами которой они являются / 8.0	0	0	0	0	0	0
Республика Адыгея	Государственные, муниципальные (без учета организаций в ведении ФСИН); Очная	   бюджетных ассигнований бюджета субъекта Российской Федерации / 16.0	58	58	0	41	37	4
Республика Адыгея	Государственные, муниципальные (без учета организаций в ведении ФСИН); Очная	   государственные социальные стипендии / 2.0	274	274	0	787	728	59
Республика Адыгея	Государственные, муниципальные (без учета организаций в ведении ФСИН); Очная	"   из них за счет средств: 
   стипендиального фонда / 15.0"	21	21	0	576	460	116
Республика Адыгея	Государственные, муниципальные (без учета организаций в ведении ФСИН); Очная	"   именные стипендии, учрежденные: 
   органами государственной власти субъекта Российской Федерации / 5.0"	0	0	0	12	12	0
Республика Адыгея	Государственные, муниципальные (без учета организаций в ведении ФСИН); Очная	   именные стипендии, учрежденные: органами местного самоуправления / 6.0	0	0	0	0	0	0
Республика Адыгея	Государственные, муниципальные (без учета организаций в ведении ФСИН); Очная	   именные стипендии, учрежденные: федеральными государственными органами / 4.0	0	0	0	0	0	0
Республика Адыгея	Государственные, муниципальные (без учета организаций в ведении ФСИН); Очная	   именные стипендии, учрежденные: физическими лицами / 9.0	0	0	0	0	0	0
Республика Адыгея	Государственные, муниципальные (без учета организаций в ведении ФСИН); Очная	   именные стипендии, учрежденные: юридическими лицами / 7.0	0	0	0	0	0	0
Республика Адыгея	Государственные, муниципальные (без учета организаций в ведении ФСИН); Очная	   полученных от приносящей доход деятельности / 17.0	0	0	0	10	8	2
Республика Адыгея	Государственные, муниципальные (без учета организаций в ведении ФСИН); Очная	   стипендии Правительства Российской Федерации / 3.0	4	4	0	6	6	0
Республика Адыгея	Государственные, муниципальные (без учета организаций в ведении ФСИН); Очная	"   стипендии, назначенные физическими лицами (кроме именных,
   указанных в строке 09) / 12.0"	0	0	0	0	0	0
Республика Адыгея	Государственные, муниципальные (без учета организаций в ведении ФСИН); Очная	"   стипендии, назначенные юридическими лицами (кроме именных,
   указанных в строке 07) / 10.0"	0	0	0	0	0	0
Республика Адыгея	Государственные, муниципальные (без учета организаций в ведении ФСИН); Очная	Численность студентов, получающих другие формы материальной поддержки / 14.0	79	79	0	628	506	122
Республика Адыгея	Государственные, муниципальные (без учета организаций в ведении ФСИН); Очная	Численность студентов, получающих: государственные академические стипендии / 1.0	812	812	0	2992	2815	177
Республика Алтай	Государственные, муниципальные (без учета организаций в ведении ФСИН); Очная	      в том числе студентам, направленным ими на обучение / 11.0	0	0	0	0	0	0
Республика Алтай	Государственные, муниципальные (без учета организаций в ведении ФСИН); Очная	      в том числе студентам, направленным ими на обучение / 13.0	0	0	0	0	0	0
Республика Алтай	Государственные, муниципальные (без учета организаций в ведении ФСИН); Очная	      из них организацией, студентами которой они являются / 8.0	0	0	0	0	0	0
Республика Алтай	Государственные, муниципальные (без учета организаций в ведении ФСИН); Очная	   бюджетных ассигнований бюджета субъекта Российской Федерации / 16.0	0	0	0	622	452	170
Республика Алтай	Государственные, муниципальные (без учета организаций в ведении ФСИН); Очная	   государственные социальные стипендии / 2.0	210	210	0	931	818	113
Республика Алтай	Государственные, муниципальные (без учета организаций в ведении ФСИН); Очная	"   из них за счет средств: 
   стипендиального фонда / 15.0"	158	156	2	1237	988	249
Республика Алтай	Государственные, муниципальные (без учета организаций в ведении ФСИН); Очная	"   именные стипендии, учрежденные: 
   органами государственной власти субъекта Российской Федерации / 5.0"	0	0	0	0	0	0
Республика Алтай	Государственные, муниципальные (без учета организаций в ведении ФСИН); Очная	   именные стипендии, учрежденные: органами местного самоуправления / 6.0	0	0	0	0	0	0
Республика Алтай	Государственные, муниципальные (без учета организаций в ведении ФСИН); Очная	   именные стипендии, учрежденные: федеральными государственными органами / 4.0	0	0	0	0	0	0
Республика Алтай	Государственные, муниципальные (без учета организаций в ведении ФСИН); Очная	   именные стипендии, учрежденные: физическими лицами / 9.0	0	0	0	0	0	0
Республика Алтай	Государственные, муниципальные (без учета организаций в ведении ФСИН); Очная	   именные стипендии, учрежденные: юридическими лицами / 7.0	0	0	0	0	0	0
Республика Алтай	Государственные, муниципальные (без учета организаций в ведении ФСИН); Очная	   полученных от приносящей доход деятельности / 17.0	0	0	0	0	0	0
Республика Алтай	Государственные, муниципальные (без учета организаций в ведении ФСИН); Очная	   стипендии Правительства Российской Федерации / 3.0	5	5	0	16	13	3
Республика Алтай	Государственные, муниципальные (без учета организаций в ведении ФСИН); Очная	"   стипендии, назначенные физическими лицами (кроме именных,
   указанных в строке 09) / 12.0"	0	0	0	0	0	0
Республика Алтай	Государственные, муниципальные (без учета организаций в ведении ФСИН); Очная	"   стипендии, назначенные юридическими лицами (кроме именных,
   указанных в строке 07) / 10.0"	0	0	0	0	0	0
Республика Алтай	Государственные, муниципальные (без учета организаций в ведении ФСИН); Очная	Численность студентов, получающих другие формы материальной поддержки / 14.0	158	156	2	1237	988	249
Республика Алтай	Государственные, муниципальные (без учета организаций в ведении ФСИН); Очная	Численность студентов, получающих: государственные академические стипендии / 1.0	615	582	33	2056	1805	251
Республика Башкортостан	Государственные, муниципальные (без учета организаций в ведении ФСИН); Очная	      в том числе студентам, направленным ими на обучение / 11.0	0	0	0	414	272	142
Республика Башкортостан	Государственные, муниципальные (без учета организаций в ведении ФСИН); Очная	      в том числе студентам, направленным ими на обучение / 13.0	0	0	0	0	0	0
Республика Башкортостан	Государственные, муниципальные (без учета организаций в ведении ФСИН); Очная	      из них организацией, студентами которой они являются / 8.0	0	0	0	3	3	0
Республика Башкортостан	Государственные, муниципальные (без учета организаций в ведении ФСИН); Очная	   бюджетных ассигнований бюджета субъекта Российской Федерации / 16.0	482	479	3	1866	1793	73
Республика Башкортостан	Государственные, муниципальные (без учета организаций в ведении ФСИН); Очная	   государственные социальные стипендии / 2.0	2353	2278	75	4401	3765	636
Республика Башкортостан	Государственные, муниципальные (без учета организаций в ведении ФСИН); Очная	"   из них за счет средств: 
   стипендиального фонда / 15.0"	3210	3102	108	6037	4598	1439
Республика Башкортостан	Государственные, муниципальные (без учета организаций в ведении ФСИН); Очная	"   именные стипендии, учрежденные: 
   органами государственной власти субъекта Российской Федерации / 5.0"	10	10	0	50	47	3
Республика Башкортостан	Государственные, муниципальные (без учета организаций в ведении ФСИН); Очная	   именные стипендии, учрежденные: органами местного самоуправления / 6.0	1	1	0	0	0	0
Республика Башкортостан	Государственные, муниципальные (без учета организаций в ведении ФСИН); Очная	   именные стипендии, учрежденные: федеральными государственными органами / 4.0	9	9	0	7	7	0
Республика Башкортостан	Государственные, муниципальные (без учета организаций в ведении ФСИН); Очная	   именные стипендии, учрежденные: физическими лицами / 9.0	0	0	0	0	0	0
Республика Башкортостан	Государственные, муниципальные (без учета организаций в ведении ФСИН); Очная	   именные стипендии, учрежденные: юридическими лицами / 7.0	4	4	0	60	42	18
Республика Башкортостан	Государственные, муниципальные (без учета организаций в ведении ФСИН); Очная	   полученных от приносящей доход деятельности / 17.0	5	5	0	510	442	68
Республика Башкортостан	Государственные, муниципальные (без учета организаций в ведении ФСИН); Очная	   стипендии Правительства Российской Федерации / 3.0	90	87	3	110	95	15
Республика Башкортостан	Государственные, муниципальные (без учета организаций в ведении ФСИН); Очная	"   стипендии, назначенные физическими лицами (кроме именных,
   указанных в строке 09) / 12.0"	0	0	0	79	24	55
Республика Башкортостан	Государственные, муниципальные (без учета организаций в ведении ФСИН); Очная	"   стипендии, назначенные юридическими лицами (кроме именных,
   указанных в строке 07) / 10.0"	4	4	0	417	275	142
Республика Башкортостан	Государственные, муниципальные (без учета организаций в ведении ФСИН); Очная	Численность студентов, получающих другие формы материальной поддержки / 14.0	3836	3691	145	8274	6625	1649
Республика Башкортостан	Государственные, муниципальные (без учета организаций в ведении ФСИН); Очная	Численность студентов, получающих: государственные академические стипендии / 1.0	12908	12177	731	33448	29703	3745
Республика Башкортостан	Частные; Очная	      в том числе студентам, направленным ими на обучение / 11.0	0	0	0	0	0	0
Республика Башкортостан	Частные; Очная	      в том числе студентам, направленным ими на обучение / 13.0	0	0	0	0	0	0
Республика Башкортостан	Частные; Очная	      из них организацией, студентами которой они являются / 8.0	0	0	0	0	0	0
Республика Башкортостан	Частные; Очная	   бюджетных ассигнований бюджета субъекта Российской Федерации / 16.0	0	0	0	0	0	0
Республика Башкортостан	Частные; Очная	   государственные социальные стипендии / 2.0	0	0	0	38	38	0
Республика Башкортостан	Частные; Очная	"   из них за счет средств: 
   стипендиального фонда / 15.0"	0	0	0	19	19	0
Республика Башкортостан	Частные; Очная	"   именные стипендии, учрежденные: 
   органами государственной власти субъекта Российской Федерации / 5.0"	0	0	0	25	25	0
Республика Башкортостан	Частные; Очная	   именные стипендии, учрежденные: органами местного самоуправления / 6.0	0	0	0	0	0	0
Республика Башкортостан	Частные; Очная	   именные стипендии, учрежденные: федеральными государственными органами / 4.0	0	0	0	0	0	0
Республика Башкортостан	Частные; Очная	   именные стипендии, учрежденные: физическими лицами / 9.0	0	0	0	0	0	0
Республика Башкортостан	Частные; Очная	   именные стипендии, учрежденные: юридическими лицами / 7.0	0	0	0	1	1	0
Республика Башкортостан	Частные; Очная	   полученных от приносящей доход деятельности / 17.0	0	0	0	0	0	0
Республика Башкортостан	Частные; Очная	   стипендии Правительства Российской Федерации / 3.0	0	0	0	1	1	0
Республика Башкортостан	Частные; Очная	"   стипендии, назначенные физическими лицами (кроме именных,
   указанных в строке 09) / 12.0"	0	0	0	0	0	0
Республика Башкортостан	Частные; Очная	"   стипендии, назначенные юридическими лицами (кроме именных,
   указанных в строке 07) / 10.0"	0	0	0	0	0	0
Республика Башкортостан	Частные; Очная	Численность студентов, получающих другие формы материальной поддержки / 14.0	0	0	0	19	19	0
Республика Башкортостан	Частные; Очная	Численность студентов, получающих: государственные академические стипендии / 1.0	0	0	0	202	202	0
Республика Бурятия	Государственные, муниципальные (без учета организаций в ведении ФСИН); Очная	      в том числе студентам, направленным ими на обучение / 11.0	0	0	0	81	81	0
Республика Бурятия	Государственные, муниципальные (без учета организаций в ведении ФСИН); Очная	      в том числе студентам, направленным ими на обучение / 13.0	0	0	0	0	0	0
Республика Бурятия	Государственные, муниципальные (без учета организаций в ведении ФСИН); Очная	      из них организацией, студентами которой они являются / 8.0	0	0	0	1	0	1
Республика Бурятия	Государственные, муниципальные (без учета организаций в ведении ФСИН); Очная	   бюджетных ассигнований бюджета субъекта Российской Федерации / 16.0	1	1	0	32	8	24
Республика Бурятия	Государственные, муниципальные (без учета организаций в ведении ФСИН); Очная	   государственные социальные стипендии / 2.0	1579	1553	26	3598	3089	509
Республика Бурятия	Государственные, муниципальные (без учета организаций в ведении ФСИН); Очная	"   из них за счет средств: 
   стипендиального фонда / 15.0"	117	117	0	1634	1385	249
Республика Бурятия	Государственные, муниципальные (без учета организаций в ведении ФСИН); Очная	"   именные стипендии, учрежденные: 
   органами государственной власти субъекта Российской Федерации / 5.0"	0	0	0	0	0	0
Республика Бурятия	Государственные, муниципальные (без учета организаций в ведении ФСИН); Очная	   именные стипендии, учрежденные: органами местного самоуправления / 6.0	0	0	0	0	0	0
Республика Бурятия	Государственные, муниципальные (без учета организаций в ведении ФСИН); Очная	   именные стипендии, учрежденные: федеральными государственными органами / 4.0	0	0	0	2	2	0
Республика Бурятия	Государственные, муниципальные (без учета организаций в ведении ФСИН); Очная	   именные стипендии, учрежденные: физическими лицами / 9.0	0	0	0	3	0	3
Республика Бурятия	Государственные, муниципальные (без учета организаций в ведении ФСИН); Очная	   именные стипендии, учрежденные: юридическими лицами / 7.0	0	0	0	26	25	1
Республика Бурятия	Государственные, муниципальные (без учета организаций в ведении ФСИН); Очная	   полученных от приносящей доход деятельности / 17.0	0	0	0	156	77	79
Республика Бурятия	Государственные, муниципальные (без учета организаций в ведении ФСИН); Очная	   стипендии Правительства Российской Федерации / 3.0	8	8	0	151	145	6
Республика Бурятия	Государственные, муниципальные (без учета организаций в ведении ФСИН); Очная	"   стипендии, назначенные физическими лицами (кроме именных,
   указанных в строке 09) / 12.0"	0	0	0	0	0	0
Республика Бурятия	Государственные, муниципальные (без учета организаций в ведении ФСИН); Очная	"   стипендии, назначенные юридическими лицами (кроме именных,
   указанных в строке 07) / 10.0"	0	0	0	93	93	0
Республика Бурятия	Государственные, муниципальные (без учета организаций в ведении ФСИН); Очная	Численность студентов, получающих другие формы материальной поддержки / 14.0	308	308	0	2435	2107	328
Республика Бурятия	Государственные, муниципальные (без учета организаций в ведении ФСИН); Очная	Численность студентов, получающих: государственные академические стипендии / 1.0	3027	2947	80	8279	6830	1449
Республика Дагестан	Государственные, муниципальные (без учета организаций в ведении ФСИН); Очная	      в том числе студентам, направленным ими на обучение / 11.0	0	0	0	0	0	0
Республика Дагестан	Государственные, муниципальные (без учета организаций в ведении ФСИН); Очная	      в том числе студентам, направленным ими на обучение / 13.0	0	0	0	0	0	0
Республика Дагестан	Государственные, муниципальные (без учета организаций в ведении ФСИН); Очная	      из них организацией, студентами которой они являются / 8.0	0	0	0	7	5	2
Республика Дагестан	Государственные, муниципальные (без учета организаций в ведении ФСИН); Очная	   бюджетных ассигнований бюджета субъекта Российской Федерации / 16.0	63	63	0	672	565	107
Республика Дагестан	Государственные, муниципальные (без учета организаций в ведении ФСИН); Очная	   государственные социальные стипендии / 2.0	1512	1334	178	7273	5870	1403
Республика Дагестан	Государственные, муниципальные (без учета организаций в ведении ФСИН); Очная	"   из них за счет средств: 
   стипендиального фонда / 15.0"	256	106	150	1783	1487	296
Республика Дагестан	Государственные, муниципальные (без учета организаций в ведении ФСИН); Очная	"   именные стипендии, учрежденные: 
   органами государственной власти субъекта Российской Федерации / 5.0"	0	0	0	9	8	1
Республика Дагестан	Государственные, муниципальные (без учета организаций в ведении ФСИН); Очная	   именные стипендии, учрежденные: органами местного самоуправления / 6.0	0	0	0	0	0	0
Республика Дагестан	Государственные, муниципальные (без учета организаций в ведении ФСИН); Очная	   именные стипендии, учрежденные: федеральными государственными органами / 4.0	13	0	13	5	0	5
Республика Дагестан	Государственные, муниципальные (без учета организаций в ведении ФСИН); Очная	   именные стипендии, учрежденные: физическими лицами / 9.0	0	0	0	0	0	0
Республика Дагестан	Государственные, муниципальные (без учета организаций в ведении ФСИН); Очная	   именные стипендии, учрежденные: юридическими лицами / 7.0	0	0	0	7	5	2
Республика Дагестан	Государственные, муниципальные (без учета организаций в ведении ФСИН); Очная	   полученных от приносящей доход деятельности / 17.0	0	0	0	691	686	5
Республика Дагестан	Государственные, муниципальные (без учета организаций в ведении ФСИН); Очная	   стипендии Правительства Российской Федерации / 3.0	2	2	0	21	17	4
Республика Дагестан	Государственные, муниципальные (без учета организаций в ведении ФСИН); Очная	"   стипендии, назначенные физическими лицами (кроме именных,
   указанных в строке 09) / 12.0"	0	0	0	0	0	0
Республика Дагестан	Государственные, муниципальные (без учета организаций в ведении ФСИН); Очная	"   стипендии, назначенные юридическими лицами (кроме именных,
   указанных в строке 07) / 10.0"	0	0	0	0	0	0
Республика Дагестан	Государственные, муниципальные (без учета организаций в ведении ФСИН); Очная	Численность студентов, получающих другие формы материальной поддержки / 14.0	361	211	150	2491	2190	301
Республика Дагестан	Государственные, муниципальные (без учета организаций в ведении ФСИН); Очная	Численность студентов, получающих: государственные академические стипендии / 1.0	2655	2017	638	13048	10494	2554
Республика Дагестан	Частные; Очная	      в том числе студентам, направленным ими на обучение / 11.0	0	0	0	0	0	0
Республика Дагестан	Частные; Очная	      в том числе студентам, направленным ими на обучение / 13.0	0	0	0	0	0	0
Республика Дагестан	Частные; Очная	      из них организацией, студентами которой они являются / 8.0	0	0	0	6	6	0
Республика Дагестан	Частные; Очная	   бюджетных ассигнований бюджета субъекта Российской Федерации / 16.0	85	85	0	137	137	0
Республика Дагестан	Частные; Очная	   государственные социальные стипендии / 2.0	32	32	0	57	57	0
Республика Дагестан	Частные; Очная	"   из них за счет средств: 
   стипендиального фонда / 15.0"	0	0	0	0	0	0
Республика Дагестан	Частные; Очная	"   именные стипендии, учрежденные: 
   органами государственной власти субъекта Российской Федерации / 5.0"	0	0	0	0	0	0
Республика Дагестан	Частные; Очная	   именные стипендии, учрежденные: органами местного самоуправления / 6.0	0	0	0	0	0	0
Республика Дагестан	Частные; Очная	   именные стипендии, учрежденные: федеральными государственными органами / 4.0	0	0	0	0	0	0
Республика Дагестан	Частные; Очная	   именные стипендии, учрежденные: физическими лицами / 9.0	0	0	0	0	0	0
Республика Дагестан	Частные; Очная	   именные стипендии, учрежденные: юридическими лицами / 7.0	0	0	0	6	6	0
Республика Дагестан	Частные; Очная	   полученных от приносящей доход деятельности / 17.0	0	0	0	2	2	0
Республика Дагестан	Частные; Очная	   стипендии Правительства Российской Федерации / 3.0	0	0	0	0	0	0
Республика Дагестан	Частные; Очная	"   стипендии, назначенные физическими лицами (кроме именных,
   указанных в строке 09) / 12.0"	0	0	0	0	0	0
Республика Дагестан	Частные; Очная	"   стипендии, назначенные юридическими лицами (кроме именных,
   указанных в строке 07) / 10.0"	0	0	0	0	0	0
Республика Дагестан	Частные; Очная	Численность студентов, получающих другие формы материальной поддержки / 14.0	85	85	0	139	139	0
Республика Дагестан	Частные; Очная	Численность студентов, получающих: государственные академические стипендии / 1.0	94	94	0	501	476	25
Республика Ингушетия	Государственные, муниципальные (без учета организаций в ведении ФСИН); Очная	      в том числе студентам, направленным ими на обучение / 11.0	0	0	0	0	0	0
Республика Ингушетия	Государственные, муниципальные (без учета организаций в ведении ФСИН); Очная	      в том числе студентам, направленным ими на обучение / 13.0	0	0	0	0	0	0
Республика Ингушетия	Государственные, муниципальные (без учета организаций в ведении ФСИН); Очная	      из них организацией, студентами которой они являются / 8.0	0	0	0	0	0	0
Республика Ингушетия	Государственные, муниципальные (без учета организаций в ведении ФСИН); Очная	   бюджетных ассигнований бюджета субъекта Российской Федерации / 16.0	0	0	0	0	0	0
Республика Ингушетия	Государственные, муниципальные (без учета организаций в ведении ФСИН); Очная	   государственные социальные стипендии / 2.0	364	253	111	1806	1177	629
Республика Ингушетия	Государственные, муниципальные (без учета организаций в ведении ФСИН); Очная	"   из них за счет средств: 
   стипендиального фонда / 15.0"	0	0	0	16	14	2
Республика Ингушетия	Государственные, муниципальные (без учета организаций в ведении ФСИН); Очная	"   именные стипендии, учрежденные: 
   органами государственной власти субъекта Российской Федерации / 5.0"	0	0	0	9	9	0
Республика Ингушетия	Государственные, муниципальные (без учета организаций в ведении ФСИН); Очная	   именные стипендии, учрежденные: органами местного самоуправления / 6.0	0	0	0	0	0	0
Республика Ингушетия	Государственные, муниципальные (без учета организаций в ведении ФСИН); Очная	   именные стипендии, учрежденные: федеральными государственными органами / 4.0	0	0	0	0	0	0
Республика Ингушетия	Государственные, муниципальные (без учета организаций в ведении ФСИН); Очная	   именные стипендии, учрежденные: физическими лицами / 9.0	0	0	0	0	0	0
Республика Ингушетия	Государственные, муниципальные (без учета организаций в ведении ФСИН); Очная	   именные стипендии, учрежденные: юридическими лицами / 7.0	0	0	0	0	0	0
Республика Ингушетия	Государственные, муниципальные (без учета организаций в ведении ФСИН); Очная	   полученных от приносящей доход деятельности / 17.0	0	0	0	0	0	0
Республика Ингушетия	Государственные, муниципальные (без учета организаций в ведении ФСИН); Очная	   стипендии Правительства Российской Федерации / 3.0	3	3	0	1	0	1
Республика Ингушетия	Государственные, муниципальные (без учета организаций в ведении ФСИН); Очная	"   стипендии, назначенные физическими лицами (кроме именных,
   указанных в строке 09) / 12.0"	0	0	0	0	0	0
Республика Ингушетия	Государственные, муниципальные (без учета организаций в ведении ФСИН); Очная	"   стипендии, назначенные юридическими лицами (кроме именных,
   указанных в строке 07) / 10.0"	0	0	0	0	0	0
Республика Ингушетия	Государственные, муниципальные (без учета организаций в ведении ФСИН); Очная	Численность студентов, получающих другие формы материальной поддержки / 14.0	0	0	0	16	14	2
Республика Ингушетия	Государственные, муниципальные (без учета организаций в ведении ФСИН); Очная	Численность студентов, получающих: государственные академические стипендии / 1.0	1013	836	177	4679	3860	819
Республика Калмыкия	Государственные, муниципальные (без учета организаций в ведении ФСИН); Очная	      в том числе студентам, направленным ими на обучение / 11.0	0	0	0	0	0	0
Республика Калмыкия	Государственные, муниципальные (без учета организаций в ведении ФСИН); Очная	      в том числе студентам, направленным ими на обучение / 13.0	0	0	0	0	0	0
Республика Калмыкия	Государственные, муниципальные (без учета организаций в ведении ФСИН); Очная	      из них организацией, студентами которой они являются / 8.0	0	0	0	1	1	0
Республика Калмыкия	Государственные, муниципальные (без учета организаций в ведении ФСИН); Очная	   бюджетных ассигнований бюджета субъекта Российской Федерации / 16.0	1	1	0	14	14	0
Республика Калмыкия	Государственные, муниципальные (без учета организаций в ведении ФСИН); Очная	   государственные социальные стипендии / 2.0	67	67	0	704	617	87
Республика Калмыкия	Государственные, муниципальные (без учета организаций в ведении ФСИН); Очная	"   из них за счет средств: 
   стипендиального фонда / 15.0"	72	72	0	108	93	15
Республика Калмыкия	Государственные, муниципальные (без учета организаций в ведении ФСИН); Очная	"   именные стипендии, учрежденные: 
   органами государственной власти субъекта Российской Федерации / 5.0"	0	0	0	0	0	0
Республика Калмыкия	Государственные, муниципальные (без учета организаций в ведении ФСИН); Очная	   именные стипендии, учрежденные: органами местного самоуправления / 6.0	5	5	0	36	34	2
Республика Калмыкия	Государственные, муниципальные (без учета организаций в ведении ФСИН); Очная	   именные стипендии, учрежденные: федеральными государственными органами / 4.0	0	0	0	0	0	0
Республика Калмыкия	Государственные, муниципальные (без учета организаций в ведении ФСИН); Очная	   именные стипендии, учрежденные: физическими лицами / 9.0	0	0	0	0	0	0
Республика Калмыкия	Государственные, муниципальные (без учета организаций в ведении ФСИН); Очная	   именные стипендии, учрежденные: юридическими лицами / 7.0	0	0	0	1	1	0
Республика Калмыкия	Государственные, муниципальные (без учета организаций в ведении ФСИН); Очная	   полученных от приносящей доход деятельности / 17.0	0	0	0	2	2	0
Республика Калмыкия	Государственные, муниципальные (без учета организаций в ведении ФСИН); Очная	   стипендии Правительства Российской Федерации / 3.0	4	4	0	4	3	1
Республика Калмыкия	Государственные, муниципальные (без учета организаций в ведении ФСИН); Очная	"   стипендии, назначенные физическими лицами (кроме именных,
   указанных в строке 09) / 12.0"	0	0	0	0	0	0
Республика Калмыкия	Государственные, муниципальные (без учета организаций в ведении ФСИН); Очная	"   стипендии, назначенные юридическими лицами (кроме именных,
   указанных в строке 07) / 10.0"	0	0	0	0	0	0
Республика Калмыкия	Государственные, муниципальные (без учета организаций в ведении ФСИН); Очная	Численность студентов, получающих другие формы материальной поддержки / 14.0	73	73	0	124	108	16
Республика Калмыкия	Государственные, муниципальные (без учета организаций в ведении ФСИН); Очная	Численность студентов, получающих: государственные академические стипендии / 1.0	243	208	35	2471	2239	232
Республика Карелия	Государственные, муниципальные (без учета организаций в ведении ФСИН); Очная	      в том числе студентам, направленным ими на обучение / 11.0	0	0	0	42	22	20
Республика Карелия	Государственные, муниципальные (без учета организаций в ведении ФСИН); Очная	      в том числе студентам, направленным ими на обучение / 13.0	0	0	0	0	0	0
Республика Карелия	Государственные, муниципальные (без учета организаций в ведении ФСИН); Очная	      из них организацией, студентами которой они являются / 8.0	2	2	0	19	16	3
Республика Карелия	Государственные, муниципальные (без учета организаций в ведении ФСИН); Очная	   бюджетных ассигнований бюджета субъекта Российской Федерации / 16.0	0	0	0	57	28	29
Республика Карелия	Государственные, муниципальные (без учета организаций в ведении ФСИН); Очная	   государственные социальные стипендии / 2.0	378	370	8	928	675	253
Республика Карелия	Государственные, муниципальные (без учета организаций в ведении ФСИН); Очная	"   из них за счет средств: 
   стипендиального фонда / 15.0"	0	0	0	6	5	1
Республика Карелия	Государственные, муниципальные (без учета организаций в ведении ФСИН); Очная	"   именные стипендии, учрежденные: 
   органами государственной власти субъекта Российской Федерации / 5.0"	10	10	0	15	11	4
Республика Карелия	Государственные, муниципальные (без учета организаций в ведении ФСИН); Очная	   именные стипендии, учрежденные: органами местного самоуправления / 6.0	0	0	0	0	0	0
Республика Карелия	Государственные, муниципальные (без учета организаций в ведении ФСИН); Очная	   именные стипендии, учрежденные: федеральными государственными органами / 4.0	0	0	0	2	2	0
Республика Карелия	Государственные, муниципальные (без учета организаций в ведении ФСИН); Очная	   именные стипендии, учрежденные: физическими лицами / 9.0	0	0	0	0	0	0
Республика Карелия	Государственные, муниципальные (без учета организаций в ведении ФСИН); Очная	   именные стипендии, учрежденные: юридическими лицами / 7.0	2	2	0	27	19	8
Республика Карелия	Государственные, муниципальные (без учета организаций в ведении ФСИН); Очная	   полученных от приносящей доход деятельности / 17.0	9	9	0	58	45	13
Республика Карелия	Государственные, муниципальные (без учета организаций в ведении ФСИН); Очная	   стипендии Правительства Российской Федерации / 3.0	10	10	0	19	16	3
Республика Карелия	Государственные, муниципальные (без учета организаций в ведении ФСИН); Очная	"   стипендии, назначенные физическими лицами (кроме именных,
   указанных в строке 09) / 12.0"	0	0	0	5	5	0
Республика Карелия	Государственные, муниципальные (без учета организаций в ведении ФСИН); Очная	"   стипендии, назначенные юридическими лицами (кроме именных,
   указанных в строке 07) / 10.0"	20	20	0	82	62	20
Республика Карелия	Государственные, муниципальные (без учета организаций в ведении ФСИН); Очная	Численность студентов, получающих другие формы материальной поддержки / 14.0	9	9	0	121	78	43
Республика Карелия	Государственные, муниципальные (без учета организаций в ведении ФСИН); Очная	Численность студентов, получающих: государственные академические стипендии / 1.0	1000	966	34	4122	3142	980
Республика Карелия	Частные; Очная	      в том числе студентам, направленным ими на обучение / 11.0	0	0	0	0	0	0
Республика Карелия	Частные; Очная	      в том числе студентам, направленным ими на обучение / 13.0	0	0	0	0	0	0
Республика Карелия	Частные; Очная	      из них организацией, студентами которой они являются / 8.0	0	0	0	0	0	0
Республика Карелия	Частные; Очная	   бюджетных ассигнований бюджета субъекта Российской Федерации / 16.0	0	0	0	0	0	0
Республика Карелия	Частные; Очная	   государственные социальные стипендии / 2.0	0	0	0	0	0	0
Республика Карелия	Частные; Очная	"   из них за счет средств: 
   стипендиального фонда / 15.0"	0	0	0	0	0	0
Республика Карелия	Частные; Очная	"   именные стипендии, учрежденные: 
   органами государственной власти субъекта Российской Федерации / 5.0"	0	0	0	2	2	0
Республика Карелия	Частные; Очная	   именные стипендии, учрежденные: органами местного самоуправления / 6.0	0	0	0	0	0	0
Республика Карелия	Частные; Очная	   именные стипендии, учрежденные: федеральными государственными органами / 4.0	0	0	0	0	0	0
Республика Карелия	Частные; Очная	   именные стипендии, учрежденные: физическими лицами / 9.0	0	0	0	0	0	0
Республика Карелия	Частные; Очная	   именные стипендии, учрежденные: юридическими лицами / 7.0	0	0	0	0	0	0
Республика Карелия	Частные; Очная	   полученных от приносящей доход деятельности / 17.0	0	0	0	0	0	0
Республика Карелия	Частные; Очная	   стипендии Правительства Российской Федерации / 3.0	0	0	0	1	0	1
Республика Карелия	Частные; Очная	"   стипендии, назначенные физическими лицами (кроме именных,
   указанных в строке 09) / 12.0"	0	0	0	0	0	0
Республика Карелия	Частные; Очная	"   стипендии, назначенные юридическими лицами (кроме именных,
   указанных в строке 07) / 10.0"	0	0	0	0	0	0
Республика Карелия	Частные; Очная	Численность студентов, получающих другие формы материальной поддержки / 14.0	0	0	0	0	0	0
Республика Карелия	Частные; Очная	Численность студентов, получающих: государственные академические стипендии / 1.0	0	0	0	0	0	0
Республика Коми	Государственные, муниципальные (без учета организаций в ведении ФСИН); Очная	      в том числе студентам, направленным ими на обучение / 11.0	0	0	0	21	21	0
Республика Коми	Государственные, муниципальные (без учета организаций в ведении ФСИН); Очная	      в том числе студентам, направленным ими на обучение / 13.0	0	0	0	0	0	0
Республика Коми	Государственные, муниципальные (без учета организаций в ведении ФСИН); Очная	      из них организацией, студентами которой они являются / 8.0	0	0	0	0	0	0
Республика Коми	Государственные, муниципальные (без учета организаций в ведении ФСИН); Очная	   бюджетных ассигнований бюджета субъекта Российской Федерации / 16.0	206	205	1	449	426	23
Республика Коми	Государственные, муниципальные (без учета организаций в ведении ФСИН); Очная	   государственные социальные стипендии / 2.0	1212	1202	10	2737	2432	305
Республика Коми	Государственные, муниципальные (без учета организаций в ведении ФСИН); Очная	"   из них за счет средств: 
   стипендиального фонда / 15.0"	37	37	0	377	349	28
Республика Коми	Государственные, муниципальные (без учета организаций в ведении ФСИН); Очная	"   именные стипендии, учрежденные: 
   органами государственной власти субъекта Российской Федерации / 5.0"	0	0	0	7	7	0
Республика Коми	Государственные, муниципальные (без учета организаций в ведении ФСИН); Очная	   именные стипендии, учрежденные: органами местного самоуправления / 6.0	0	0	0	0	0	0
Республика Коми	Государственные, муниципальные (без учета организаций в ведении ФСИН); Очная	   именные стипендии, учрежденные: федеральными государственными органами / 4.0	6	6	0	6	6	0
Республика Коми	Государственные, муниципальные (без учета организаций в ведении ФСИН); Очная	   именные стипендии, учрежденные: физическими лицами / 9.0	0	0	0	0	0	0
Республика Коми	Государственные, муниципальные (без учета организаций в ведении ФСИН); Очная	   именные стипендии, учрежденные: юридическими лицами / 7.0	0	0	0	0	0	0
Республика Коми	Государственные, муниципальные (без учета организаций в ведении ФСИН); Очная	   полученных от приносящей доход деятельности / 17.0	13	13	0	7	7	0
Республика Коми	Государственные, муниципальные (без учета организаций в ведении ФСИН); Очная	   стипендии Правительства Российской Федерации / 3.0	19	19	0	22	22	0
Республика Коми	Государственные, муниципальные (без учета организаций в ведении ФСИН); Очная	"   стипендии, назначенные физическими лицами (кроме именных,
   указанных в строке 09) / 12.0"	0	0	0	0	0	0
Республика Коми	Государственные, муниципальные (без учета организаций в ведении ФСИН); Очная	"   стипендии, назначенные юридическими лицами (кроме именных,
   указанных в строке 07) / 10.0"	76	76	0	205	197	8
Республика Коми	Государственные, муниципальные (без учета организаций в ведении ФСИН); Очная	Численность студентов, получающих другие формы материальной поддержки / 14.0	327	324	3	760	707	53
Республика Коми	Государственные, муниципальные (без учета организаций в ведении ФСИН); Очная	Численность студентов, получающих: государственные академические стипендии / 1.0	2618	2567	51	5847	5354	493
Республика Коми	Частные; Очная	      в том числе студентам, направленным ими на обучение / 11.0	0	0	0	0	0	0
Республика Коми	Частные; Очная	      в том числе студентам, направленным ими на обучение / 13.0	0	0	0	0	0	0
Республика Коми	Частные; Очная	      из них организацией, студентами которой они являются / 8.0	0	0	0	0	0	0
Республика Коми	Частные; Очная	   бюджетных ассигнований бюджета субъекта Российской Федерации / 16.0	0	0	0	2	2	0
Республика Коми	Частные; Очная	   государственные социальные стипендии / 2.0	0	0	0	8	8	0
Республика Коми	Частные; Очная	"   из них за счет средств: 
   стипендиального фонда / 15.0"	0	0	0	0	0	0
Республика Коми	Частные; Очная	"   именные стипендии, учрежденные: 
   органами государственной власти субъекта Российской Федерации / 5.0"	0	0	0	0	0	0
Республика Коми	Частные; Очная	   именные стипендии, учрежденные: органами местного самоуправления / 6.0	0	0	0	0	0	0
Республика Коми	Частные; Очная	   именные стипендии, учрежденные: федеральными государственными органами / 4.0	0	0	0	0	0	0
Республика Коми	Частные; Очная	   именные стипендии, учрежденные: физическими лицами / 9.0	0	0	0	0	0	0
Республика Коми	Частные; Очная	   именные стипендии, учрежденные: юридическими лицами / 7.0	0	0	0	0	0	0
Республика Коми	Частные; Очная	   полученных от приносящей доход деятельности / 17.0	0	0	0	0	0	0
Республика Коми	Частные; Очная	   стипендии Правительства Российской Федерации / 3.0	0	0	0	0	0	0
Республика Коми	Частные; Очная	"   стипендии, назначенные физическими лицами (кроме именных,
   указанных в строке 09) / 12.0"	0	0	0	0	0	0
Республика Коми	Частные; Очная	"   стипендии, назначенные юридическими лицами (кроме именных,
   указанных в строке 07) / 10.0"	0	0	0	0	0	0
Республика Коми	Частные; Очная	Численность студентов, получающих другие формы материальной поддержки / 14.0	0	0	0	2	2	0
Республика Коми	Частные; Очная	Численность студентов, получающих: государственные академические стипендии / 1.0	0	0	0	20	20	0
Республика Крым	Государственные, муниципальные (без учета организаций в ведении ФСИН); Очная	      в том числе студентам, направленным ими на обучение / 11.0	0	0	0	0	0	0
Республика Крым	Государственные, муниципальные (без учета организаций в ведении ФСИН); Очная	      в том числе студентам, направленным ими на обучение / 13.0	0	0	0	0	0	0
Республика Крым	Государственные, муниципальные (без учета организаций в ведении ФСИН); Очная	      из них организацией, студентами которой они являются / 8.0	0	0	0	6	6	0
Республика Крым	Государственные, муниципальные (без учета организаций в ведении ФСИН); Очная	   бюджетных ассигнований бюджета субъекта Российской Федерации / 16.0	1738	1710	28	2020	1698	322
Республика Крым	Государственные, муниципальные (без учета организаций в ведении ФСИН); Очная	   государственные социальные стипендии / 2.0	684	588	96	690	555	135
Республика Крым	Государственные, муниципальные (без учета организаций в ведении ФСИН); Очная	"   из них за счет средств: 
   стипендиального фонда / 15.0"	2349	2297	52	3369	2753	616
Республика Крым	Государственные, муниципальные (без учета организаций в ведении ФСИН); Очная	"   именные стипендии, учрежденные: 
   органами государственной власти субъекта Российской Федерации / 5.0"	0	0	0	3	3	0
Республика Крым	Государственные, муниципальные (без учета организаций в ведении ФСИН); Очная	   именные стипендии, учрежденные: органами местного самоуправления / 6.0	1	1	0	10	5	5
Республика Крым	Государственные, муниципальные (без учета организаций в ведении ФСИН); Очная	   именные стипендии, учрежденные: федеральными государственными органами / 4.0	2	2	0	2	2	0
Республика Крым	Государственные, муниципальные (без учета организаций в ведении ФСИН); Очная	   именные стипендии, учрежденные: физическими лицами / 9.0	0	0	0	0	0	0
Республика Крым	Государственные, муниципальные (без учета организаций в ведении ФСИН); Очная	   именные стипендии, учрежденные: юридическими лицами / 7.0	0	0	0	6	6	0
Республика Крым	Государственные, муниципальные (без учета организаций в ведении ФСИН); Очная	   полученных от приносящей доход деятельности / 17.0	1	1	0	48	1	47
Республика Крым	Государственные, муниципальные (без учета организаций в ведении ФСИН); Очная	   стипендии Правительства Российской Федерации / 3.0	23	23	0	251	244	7
Республика Крым	Государственные, муниципальные (без учета организаций в ведении ФСИН); Очная	"   стипендии, назначенные физическими лицами (кроме именных,
   указанных в строке 09) / 12.0"	0	0	0	0	0	0
Республика Крым	Государственные, муниципальные (без учета организаций в ведении ФСИН); Очная	"   стипендии, назначенные юридическими лицами (кроме именных,
   указанных в строке 07) / 10.0"	0	0	0	2	1	1
Республика Крым	Государственные, муниципальные (без учета организаций в ведении ФСИН); Очная	Численность студентов, получающих другие формы материальной поддержки / 14.0	3691	3611	80	4868	3874	994
Республика Крым	Государственные, муниципальные (без учета организаций в ведении ФСИН); Очная	Численность студентов, получающих: государственные академические стипендии / 1.0	5706	5265	441	10179	8136	2043
Республика Крым	Частные; Очная	      в том числе студентам, направленным ими на обучение / 11.0	0	0	0	0	0	0
Республика Крым	Частные; Очная	      в том числе студентам, направленным ими на обучение / 13.0	0	0	0	0	0	0
Республика Крым	Частные; Очная	      из них организацией, студентами которой они являются / 8.0	0	0	0	0	0	0
Республика Крым	Частные; Очная	   бюджетных ассигнований бюджета субъекта Российской Федерации / 16.0	0	0	0	0	0	0
Республика Крым	Частные; Очная	   государственные социальные стипендии / 2.0	0	0	0	0	0	0
Республика Крым	Частные; Очная	"   из них за счет средств: 
   стипендиального фонда / 15.0"	0	0	0	0	0	0
Республика Крым	Частные; Очная	"   именные стипендии, учрежденные: 
   органами государственной власти субъекта Российской Федерации / 5.0"	0	0	0	0	0	0
Республика Крым	Частные; Очная	   именные стипендии, учрежденные: органами местного самоуправления / 6.0	0	0	0	1	1	0
Республика Крым	Частные; Очная	   именные стипендии, учрежденные: федеральными государственными органами / 4.0	0	0	0	0	0	0
Республика Крым	Частные; Очная	   именные стипендии, учрежденные: физическими лицами / 9.0	0	0	0	0	0	0
Республика Крым	Частные; Очная	   именные стипендии, учрежденные: юридическими лицами / 7.0	0	0	0	0	0	0
Республика Крым	Частные; Очная	   полученных от приносящей доход деятельности / 17.0	0	0	0	0	0	0
Республика Крым	Частные; Очная	   стипендии Правительства Российской Федерации / 3.0	0	0	0	1	1	0
Республика Крым	Частные; Очная	"   стипендии, назначенные физическими лицами (кроме именных,
   указанных в строке 09) / 12.0"	0	0	0	0	0	0
Республика Крым	Частные; Очная	"   стипендии, назначенные юридическими лицами (кроме именных,
   указанных в строке 07) / 10.0"	0	0	0	0	0	0
Республика Крым	Частные; Очная	Численность студентов, получающих другие формы материальной поддержки / 14.0	0	0	0	0	0	0
Республика Крым	Частные; Очная	Численность студентов, получающих: государственные академические стипендии / 1.0	0	0	0	0	0	0
Республика Марий Эл	Государственные, муниципальные (без учета организаций в ведении ФСИН); Очная	      в том числе студентам, направленным ими на обучение / 11.0	0	0	0	0	0	0
Республика Марий Эл	Государственные, муниципальные (без учета организаций в ведении ФСИН); Очная	      в том числе студентам, направленным ими на обучение / 13.0	0	0	0	0	0	0
Республика Марий Эл	Государственные, муниципальные (без учета организаций в ведении ФСИН); Очная	      из них организацией, студентами которой они являются / 8.0	0	0	0	0	0	0
Республика Марий Эл	Государственные, муниципальные (без учета организаций в ведении ФСИН); Очная	   бюджетных ассигнований бюджета субъекта Российской Федерации / 16.0	31	31	0	142	137	5
Республика Марий Эл	Государственные, муниципальные (без учета организаций в ведении ФСИН); Очная	   государственные социальные стипендии / 2.0	258	252	6	1305	1235	70
Республика Марий Эл	Государственные, муниципальные (без учета организаций в ведении ФСИН); Очная	"   из них за счет средств: 
   стипендиального фонда / 15.0"	137	135	2	1913	1800	113
Республика Марий Эл	Государственные, муниципальные (без учета организаций в ведении ФСИН); Очная	"   именные стипендии, учрежденные: 
   органами государственной власти субъекта Российской Федерации / 5.0"	0	0	0	20	19	1
Республика Марий Эл	Государственные, муниципальные (без учета организаций в ведении ФСИН); Очная	   именные стипендии, учрежденные: органами местного самоуправления / 6.0	0	0	0	8	8	0
Республика Марий Эл	Государственные, муниципальные (без учета организаций в ведении ФСИН); Очная	   именные стипендии, учрежденные: федеральными государственными органами / 4.0	0	0	0	1	1	0
Республика Марий Эл	Государственные, муниципальные (без учета организаций в ведении ФСИН); Очная	   именные стипендии, учрежденные: физическими лицами / 9.0	0	0	0	0	0	0
Республика Марий Эл	Государственные, муниципальные (без учета организаций в ведении ФСИН); Очная	   именные стипендии, учрежденные: юридическими лицами / 7.0	0	0	0	1	1	0
Республика Марий Эл	Государственные, муниципальные (без учета организаций в ведении ФСИН); Очная	   полученных от приносящей доход деятельности / 17.0	0	0	0	26	26	0
Республика Марий Эл	Государственные, муниципальные (без учета организаций в ведении ФСИН); Очная	   стипендии Правительства Российской Федерации / 3.0	4	4	0	31	30	1
Республика Марий Эл	Государственные, муниципальные (без учета организаций в ведении ФСИН); Очная	"   стипендии, назначенные физическими лицами (кроме именных,
   указанных в строке 09) / 12.0"	0	0	0	0	0	0
Республика Марий Эл	Государственные, муниципальные (без учета организаций в ведении ФСИН); Очная	"   стипендии, назначенные юридическими лицами (кроме именных,
   указанных в строке 07) / 10.0"	0	0	0	0	0	0
Республика Марий Эл	Государственные, муниципальные (без учета организаций в ведении ФСИН); Очная	Численность студентов, получающих другие формы материальной поддержки / 14.0	163	161	2	2101	1987	114
Республика Марий Эл	Государственные, муниципальные (без учета организаций в ведении ФСИН); Очная	Численность студентов, получающих: государственные академические стипендии / 1.0	1026	972	54	6718	6247	471
Республика Марий Эл	Частные; Очная	      в том числе студентам, направленным ими на обучение / 11.0	0	0	0	0	0	0
Республика Марий Эл	Частные; Очная	      в том числе студентам, направленным ими на обучение / 13.0	0	0	0	0	0	0
Республика Марий Эл	Частные; Очная	      из них организацией, студентами которой они являются / 8.0	0	0	0	0	0	0
Республика Марий Эл	Частные; Очная	   бюджетных ассигнований бюджета субъекта Российской Федерации / 16.0	0	0	0	0	0	0
Республика Марий Эл	Частные; Очная	   государственные социальные стипендии / 2.0	0	0	0	0	0	0
Республика Марий Эл	Частные; Очная	"   из них за счет средств: 
   стипендиального фонда / 15.0"	0	0	0	0	0	0
Республика Марий Эл	Частные; Очная	"   именные стипендии, учрежденные: 
   органами государственной власти субъекта Российской Федерации / 5.0"	0	0	0	0	0	0
Республика Марий Эл	Частные; Очная	   именные стипендии, учрежденные: органами местного самоуправления / 6.0	0	0	0	0	0	0
Республика Марий Эл	Частные; Очная	   именные стипендии, учрежденные: федеральными государственными органами / 4.0	0	0	0	0	0	0
Республика Марий Эл	Частные; Очная	   именные стипендии, учрежденные: физическими лицами / 9.0	0	0	0	0	0	0
Республика Марий Эл	Частные; Очная	   именные стипендии, учрежденные: юридическими лицами / 7.0	0	0	0	0	0	0
Республика Марий Эл	Частные; Очная	   полученных от приносящей доход деятельности / 17.0	0	0	0	0	0	0
Республика Марий Эл	Частные; Очная	   стипендии Правительства Российской Федерации / 3.0	0	0	0	0	0	0
Республика Марий Эл	Частные; Очная	"   стипендии, назначенные физическими лицами (кроме именных,
   указанных в строке 09) / 12.0"	0	0	0	0	0	0
Республика Марий Эл	Частные; Очная	"   стипендии, назначенные юридическими лицами (кроме именных,
   указанных в строке 07) / 10.0"	0	0	0	0	0	0
Республика Марий Эл	Частные; Очная	Численность студентов, получающих другие формы материальной поддержки / 14.0	0	0	0	0	0	0
Республика Марий Эл	Частные; Очная	Численность студентов, получающих: государственные академические стипендии / 1.0	0	0	0	0	0	0
Республика Мордовия	Государственные, муниципальные (без учета организаций в ведении ФСИН); Очная	      в том числе студентам, направленным ими на обучение / 11.0	0	0	0	24	24	0
Республика Мордовия	Государственные, муниципальные (без учета организаций в ведении ФСИН); Очная	      в том числе студентам, направленным ими на обучение / 13.0	0	0	0	0	0	0
Республика Мордовия	Государственные, муниципальные (без учета организаций в ведении ФСИН); Очная	      из них организацией, студентами которой они являются / 8.0	0	0	0	15	15	0
Республика Мордовия	Государственные, муниципальные (без учета организаций в ведении ФСИН); Очная	   бюджетных ассигнований бюджета субъекта Российской Федерации / 16.0	28	28	0	618	616	2
Республика Мордовия	Государственные, муниципальные (без учета организаций в ведении ФСИН); Очная	   государственные социальные стипендии / 2.0	273	270	3	1181	1155	26
Республика Мордовия	Государственные, муниципальные (без учета организаций в ведении ФСИН); Очная	"   из них за счет средств: 
   стипендиального фонда / 15.0"	8	8	0	303	301	2
Республика Мордовия	Государственные, муниципальные (без учета организаций в ведении ФСИН); Очная	"   именные стипендии, учрежденные: 
   органами государственной власти субъекта Российской Федерации / 5.0"	0	0	0	0	0	0
Республика Мордовия	Государственные, муниципальные (без учета организаций в ведении ФСИН); Очная	   именные стипендии, учрежденные: органами местного самоуправления / 6.0	0	0	0	0	0	0
Республика Мордовия	Государственные, муниципальные (без учета организаций в ведении ФСИН); Очная	   именные стипендии, учрежденные: федеральными государственными органами / 4.0	0	0	0	0	0	0
Республика Мордовия	Государственные, муниципальные (без учета организаций в ведении ФСИН); Очная	   именные стипендии, учрежденные: физическими лицами / 9.0	0	0	0	0	0	0
Республика Мордовия	Государственные, муниципальные (без учета организаций в ведении ФСИН); Очная	   именные стипендии, учрежденные: юридическими лицами / 7.0	0	0	0	17	17	0
Республика Мордовия	Государственные, муниципальные (без учета организаций в ведении ФСИН); Очная	   полученных от приносящей доход деятельности / 17.0	12	12	0	274	274	0
Республика Мордовия	Государственные, муниципальные (без учета организаций в ведении ФСИН); Очная	   стипендии Правительства Российской Федерации / 3.0	12	12	0	70	70	0
Республика Мордовия	Государственные, муниципальные (без учета организаций в ведении ФСИН); Очная	"   стипендии, назначенные физическими лицами (кроме именных,
   указанных в строке 09) / 12.0"	0	0	0	0	0	0
Республика Мордовия	Государственные, муниципальные (без учета организаций в ведении ФСИН); Очная	"   стипендии, назначенные юридическими лицами (кроме именных,
   указанных в строке 07) / 10.0"	0	0	0	36	36	0
Республика Мордовия	Государственные, муниципальные (без учета организаций в ведении ФСИН); Очная	Численность студентов, получающих другие формы материальной поддержки / 14.0	41	41	0	1171	1167	4
Республика Мордовия	Государственные, муниципальные (без учета организаций в ведении ФСИН); Очная	Численность студентов, получающих: государственные академические стипендии / 1.0	797	777	20	5905	5732	173
Республика Мордовия	Частные; Очная	      в том числе студентам, направленным ими на обучение / 11.0	0	0	0	0	0	0
Республика Мордовия	Частные; Очная	      в том числе студентам, направленным ими на обучение / 13.0	0	0	0	0	0	0
Республика Мордовия	Частные; Очная	      из них организацией, студентами которой они являются / 8.0	0	0	0	0	0	0
Республика Мордовия	Частные; Очная	   бюджетных ассигнований бюджета субъекта Российской Федерации / 16.0	0	0	0	0	0	0
Республика Мордовия	Частные; Очная	   государственные социальные стипендии / 2.0	0	0	0	5	5	0
Республика Мордовия	Частные; Очная	"   из них за счет средств: 
   стипендиального фонда / 15.0"	0	0	0	14	14	0
Республика Мордовия	Частные; Очная	"   именные стипендии, учрежденные: 
   органами государственной власти субъекта Российской Федерации / 5.0"	0	0	0	0	0	0
Республика Мордовия	Частные; Очная	   именные стипендии, учрежденные: органами местного самоуправления / 6.0	0	0	0	0	0	0
Республика Мордовия	Частные; Очная	   именные стипендии, учрежденные: федеральными государственными органами / 4.0	0	0	0	0	0	0
Республика Мордовия	Частные; Очная	   именные стипендии, учрежденные: физическими лицами / 9.0	0	0	0	0	0	0
Республика Мордовия	Частные; Очная	   именные стипендии, учрежденные: юридическими лицами / 7.0	0	0	0	0	0	0
Республика Мордовия	Частные; Очная	   полученных от приносящей доход деятельности / 17.0	0	0	0	0	0	0
Республика Мордовия	Частные; Очная	   стипендии Правительства Российской Федерации / 3.0	0	0	0	0	0	0
Республика Мордовия	Частные; Очная	"   стипендии, назначенные физическими лицами (кроме именных,
   указанных в строке 09) / 12.0"	0	0	0	0	0	0
Республика Мордовия	Частные; Очная	"   стипендии, назначенные юридическими лицами (кроме именных,
   указанных в строке 07) / 10.0"	0	0	0	0	0	0
Республика Мордовия	Частные; Очная	Численность студентов, получающих другие формы материальной поддержки / 14.0	0	0	0	14	14	0
Республика Мордовия	Частные; Очная	Численность студентов, получающих: государственные академические стипендии / 1.0	0	0	0	25	25	0
Республика Саха (Якутия)	Государственные, муниципальные (без учета организаций в ведении ФСИН); Очная	      в том числе студентам, направленным ими на обучение / 11.0	0	0	0	0	0	0
Республика Саха (Якутия)	Государственные, муниципальные (без учета организаций в ведении ФСИН); Очная	      в том числе студентам, направленным ими на обучение / 13.0	0	0	0	0	0	0
Республика Саха (Якутия)	Государственные, муниципальные (без учета организаций в ведении ФСИН); Очная	      из них организацией, студентами которой они являются / 8.0	1	1	0	9	3	6
Республика Саха (Якутия)	Государственные, муниципальные (без учета организаций в ведении ФСИН); Очная	   бюджетных ассигнований бюджета субъекта Российской Федерации / 16.0	115	110	5	310	108	202
Республика Саха (Якутия)	Государственные, муниципальные (без учета организаций в ведении ФСИН); Очная	   государственные социальные стипендии / 2.0	859	758	101	3133	1466	1667
Республика Саха (Якутия)	Государственные, муниципальные (без учета организаций в ведении ФСИН); Очная	"   из них за счет средств: 
   стипендиального фонда / 15.0"	259	239	20	2406	1351	1055
Республика Саха (Якутия)	Государственные, муниципальные (без учета организаций в ведении ФСИН); Очная	"   именные стипендии, учрежденные: 
   органами государственной власти субъекта Российской Федерации / 5.0"	73	34	39	160	88	72
Республика Саха (Якутия)	Государственные, муниципальные (без учета организаций в ведении ФСИН); Очная	   именные стипендии, учрежденные: органами местного самоуправления / 6.0	4	3	1	0	0	0
Республика Саха (Якутия)	Государственные, муниципальные (без учета организаций в ведении ФСИН); Очная	   именные стипендии, учрежденные: федеральными государственными органами / 4.0	10	1	9	0	0	0
Республика Саха (Якутия)	Государственные, муниципальные (без учета организаций в ведении ФСИН); Очная	   именные стипендии, учрежденные: физическими лицами / 9.0	0	0	0	8	0	8
Республика Саха (Якутия)	Государственные, муниципальные (без учета организаций в ведении ФСИН); Очная	   именные стипендии, учрежденные: юридическими лицами / 7.0	1	1	0	12	6	6
Республика Саха (Якутия)	Государственные, муниципальные (без учета организаций в ведении ФСИН); Очная	   полученных от приносящей доход деятельности / 17.0	1	1	0	104	68	36
Республика Саха (Якутия)	Государственные, муниципальные (без учета организаций в ведении ФСИН); Очная	   стипендии Правительства Российской Федерации / 3.0	14	10	4	30	15	15
Республика Саха (Якутия)	Государственные, муниципальные (без учета организаций в ведении ФСИН); Очная	"   стипендии, назначенные физическими лицами (кроме именных,
   указанных в строке 09) / 12.0"	0	0	0	0	0	0
Республика Саха (Якутия)	Государственные, муниципальные (без учета организаций в ведении ФСИН); Очная	"   стипендии, назначенные юридическими лицами (кроме именных,
   указанных в строке 07) / 10.0"	0	0	0	892	10	882
Республика Саха (Якутия)	Государственные, муниципальные (без учета организаций в ведении ФСИН); Очная	Численность студентов, получающих другие формы материальной поддержки / 14.0	481	430	51	2834	1552	1282
Республика Саха (Якутия)	Государственные, муниципальные (без учета организаций в ведении ФСИН); Очная	Численность студентов, получающих: государственные академические стипендии / 1.0	3047	2341	706	8967	3806	5161
Республика Саха (Якутия)	Частные; Очная	      в том числе студентам, направленным ими на обучение / 11.0	0	0	0	0	0	0
Республика Саха (Якутия)	Частные; Очная	      в том числе студентам, направленным ими на обучение / 13.0	0	0	0	0	0	0
Республика Саха (Якутия)	Частные; Очная	      из них организацией, студентами которой они являются / 8.0	0	0	0	0	0	0
Республика Саха (Якутия)	Частные; Очная	   бюджетных ассигнований бюджета субъекта Российской Федерации / 16.0	0	0	0	12	5	7
Республика Саха (Якутия)	Частные; Очная	   государственные социальные стипендии / 2.0	0	0	0	18	7	11
Республика Саха (Якутия)	Частные; Очная	"   из них за счет средств: 
   стипендиального фонда / 15.0"	0	0	0	0	0	0
Республика Саха (Якутия)	Частные; Очная	"   именные стипендии, учрежденные: 
   органами государственной власти субъекта Российской Федерации / 5.0"	0	0	0	0	0	0
Республика Саха (Якутия)	Частные; Очная	   именные стипендии, учрежденные: органами местного самоуправления / 6.0	0	0	0	0	0	0
Республика Саха (Якутия)	Частные; Очная	   именные стипендии, учрежденные: федеральными государственными органами / 4.0	0	0	0	0	0	0
Республика Саха (Якутия)	Частные; Очная	   именные стипендии, учрежденные: физическими лицами / 9.0	0	0	0	0	0	0
Республика Саха (Якутия)	Частные; Очная	   именные стипендии, учрежденные: юридическими лицами / 7.0	0	0	0	0	0	0
Республика Саха (Якутия)	Частные; Очная	   полученных от приносящей доход деятельности / 17.0	0	0	0	0	0	0
Республика Саха (Якутия)	Частные; Очная	   стипендии Правительства Российской Федерации / 3.0	0	0	0	1	0	1
Республика Саха (Якутия)	Частные; Очная	"   стипендии, назначенные физическими лицами (кроме именных,
   указанных в строке 09) / 12.0"	0	0	0	0	0	0
Республика Саха (Якутия)	Частные; Очная	"   стипендии, назначенные юридическими лицами (кроме именных,
   указанных в строке 07) / 10.0"	0	0	0	0	0	0
Республика Саха (Якутия)	Частные; Очная	Численность студентов, получающих другие формы материальной поддержки / 14.0	0	0	0	12	5	7
Республика Саха (Якутия)	Частные; Очная	Численность студентов, получающих: государственные академические стипендии / 1.0	0	0	0	92	26	66
Республика Северная Осетия - Алания	Государственные, муниципальные (без учета организаций в ведении ФСИН); Очная	      в том числе студентам, направленным ими на обучение / 11.0	0	0	0	14	14	0
Республика Северная Осетия - Алания	Государственные, муниципальные (без учета организаций в ведении ФСИН); Очная	      в том числе студентам, направленным ими на обучение / 13.0	0	0	0	0	0	0
Республика Северная Осетия - Алания	Государственные, муниципальные (без учета организаций в ведении ФСИН); Очная	      из них организацией, студентами которой они являются / 8.0	0	0	0	0	0	0
Республика Северная Осетия - Алания	Государственные, муниципальные (без учета организаций в ведении ФСИН); Очная	   бюджетных ассигнований бюджета субъекта Российской Федерации / 16.0	0	0	0	20	18	2
Республика Северная Осетия - Алания	Государственные, муниципальные (без учета организаций в ведении ФСИН); Очная	   государственные социальные стипендии / 2.0	346	343	3	762	717	45
Республика Северная Осетия - Алания	Государственные, муниципальные (без учета организаций в ведении ФСИН); Очная	"   из них за счет средств: 
   стипендиального фонда / 15.0"	0	0	0	263	260	3
Республика Северная Осетия - Алания	Государственные, муниципальные (без учета организаций в ведении ФСИН); Очная	"   именные стипендии, учрежденные: 
   органами государственной власти субъекта Российской Федерации / 5.0"	0	0	0	0	0	0
Республика Северная Осетия - Алания	Государственные, муниципальные (без учета организаций в ведении ФСИН); Очная	   именные стипендии, учрежденные: органами местного самоуправления / 6.0	0	0	0	2	2	0
Республика Северная Осетия - Алания	Государственные, муниципальные (без учета организаций в ведении ФСИН); Очная	   именные стипендии, учрежденные: федеральными государственными органами / 4.0	0	0	0	3	3	0
Республика Северная Осетия - Алания	Государственные, муниципальные (без учета организаций в ведении ФСИН); Очная	   именные стипендии, учрежденные: физическими лицами / 9.0	2	2	0	2	2	0
Республика Северная Осетия - Алания	Государственные, муниципальные (без учета организаций в ведении ФСИН); Очная	   именные стипендии, учрежденные: юридическими лицами / 7.0	0	0	0	0	0	0
Республика Северная Осетия - Алания	Государственные, муниципальные (без учета организаций в ведении ФСИН); Очная	   полученных от приносящей доход деятельности / 17.0	8	8	0	13	13	0
Республика Северная Осетия - Алания	Государственные, муниципальные (без учета организаций в ведении ФСИН); Очная	   стипендии Правительства Российской Федерации / 3.0	10	10	0	15	15	0
Республика Северная Осетия - Алания	Государственные, муниципальные (без учета организаций в ведении ФСИН); Очная	"   стипендии, назначенные физическими лицами (кроме именных,
   указанных в строке 09) / 12.0"	0	0	0	2	2	0
Республика Северная Осетия - Алания	Государственные, муниципальные (без учета организаций в ведении ФСИН); Очная	"   стипендии, назначенные юридическими лицами (кроме именных,
   указанных в строке 07) / 10.0"	0	0	0	50	50	0
Республика Северная Осетия - Алания	Государственные, муниципальные (без учета организаций в ведении ФСИН); Очная	Численность студентов, получающих другие формы материальной поддержки / 14.0	13	13	0	364	346	18
Республика Северная Осетия - Алания	Государственные, муниципальные (без учета организаций в ведении ФСИН); Очная	Численность студентов, получающих: государственные академические стипендии / 1.0	1980	1938	42	5210	4867	343
Республика Татарстан	Государственные, муниципальные (без учета организаций в ведении ФСИН); Очная	      в том числе студентам, направленным ими на обучение / 11.0	0	0	0	32	31	1
Республика Татарстан	Государственные, муниципальные (без учета организаций в ведении ФСИН); Очная	      в том числе студентам, направленным ими на обучение / 13.0	0	0	0	0	0	0
Республика Татарстан	Государственные, муниципальные (без учета организаций в ведении ФСИН); Очная	      из них организацией, студентами которой они являются / 8.0	0	0	0	6	6	0
Республика Татарстан	Государственные, муниципальные (без учета организаций в ведении ФСИН); Очная	   бюджетных ассигнований бюджета субъекта Российской Федерации / 16.0	68	54	14	2956	2699	257
Республика Татарстан	Государственные, муниципальные (без учета организаций в ведении ФСИН); Очная	   государственные социальные стипендии / 2.0	775	773	2	1931	1855	76
Республика Татарстан	Государственные, муниципальные (без учета организаций в ведении ФСИН); Очная	"   из них за счет средств: 
   стипендиального фонда / 15.0"	182	175	7	1642	1541	101
Республика Татарстан	Государственные, муниципальные (без учета организаций в ведении ФСИН); Очная	"   именные стипендии, учрежденные: 
   органами государственной власти субъекта Российской Федерации / 5.0"	140	140	0	198	198	0
Республика Татарстан	Государственные, муниципальные (без учета организаций в ведении ФСИН); Очная	   именные стипендии, учрежденные: органами местного самоуправления / 6.0	0	0	0	1	1	0
Республика Татарстан	Государственные, муниципальные (без учета организаций в ведении ФСИН); Очная	   именные стипендии, учрежденные: федеральными государственными органами / 4.0	0	0	0	19	18	1
Республика Татарстан	Государственные, муниципальные (без учета организаций в ведении ФСИН); Очная	   именные стипендии, учрежденные: физическими лицами / 9.0	0	0	0	0	0	0
Республика Татарстан	Государственные, муниципальные (без учета организаций в ведении ФСИН); Очная	   именные стипендии, учрежденные: юридическими лицами / 7.0	0	0	0	78	78	0
Республика Татарстан	Государственные, муниципальные (без учета организаций в ведении ФСИН); Очная	   полученных от приносящей доход деятельности / 17.0	7	7	0	180	179	1
Республика Татарстан	Государственные, муниципальные (без учета организаций в ведении ФСИН); Очная	   стипендии Правительства Российской Федерации / 3.0	24	24	0	137	132	5
Республика Татарстан	Государственные, муниципальные (без учета организаций в ведении ФСИН); Очная	"   стипендии, назначенные физическими лицами (кроме именных,
   указанных в строке 09) / 12.0"	0	0	0	0	0	0
Республика Татарстан	Государственные, муниципальные (без учета организаций в ведении ФСИН); Очная	"   стипендии, назначенные юридическими лицами (кроме именных,
   указанных в строке 07) / 10.0"	28	28	0	94	93	1
Республика Татарстан	Государственные, муниципальные (без учета организаций в ведении ФСИН); Очная	Численность студентов, получающих другие формы материальной поддержки / 14.0	257	236	21	4623	4274	349
Республика Татарстан	Государственные, муниципальные (без учета организаций в ведении ФСИН); Очная	Численность студентов, получающих: государственные академические стипендии / 1.0	5855	5678	177	31184	29139	2045
Республика Татарстан	Частные; Очная	      в том числе студентам, направленным ими на обучение / 11.0	0	0	0	0	0	0
Республика Татарстан	Частные; Очная	      в том числе студентам, направленным ими на обучение / 13.0	0	0	0	0	0	0
Республика Татарстан	Частные; Очная	      из них организацией, студентами которой они являются / 8.0	0	0	0	47	45	2
Республика Татарстан	Частные; Очная	   бюджетных ассигнований бюджета субъекта Российской Федерации / 16.0	0	0	0	0	0	0
Республика Татарстан	Частные; Очная	   государственные социальные стипендии / 2.0	0	0	0	13	13	0
Республика Татарстан	Частные; Очная	"   из них за счет средств: 
   стипендиального фонда / 15.0"	0	0	0	34	34	0
Республика Татарстан	Частные; Очная	"   именные стипендии, учрежденные: 
   органами государственной власти субъекта Российской Федерации / 5.0"	0	0	0	0	0	0
Республика Татарстан	Частные; Очная	   именные стипендии, учрежденные: органами местного самоуправления / 6.0	0	0	0	0	0	0
Республика Татарстан	Частные; Очная	   именные стипендии, учрежденные: федеральными государственными органами / 4.0	0	0	0	0	0	0
Республика Татарстан	Частные; Очная	   именные стипендии, учрежденные: физическими лицами / 9.0	0	0	0	0	0	0
Республика Татарстан	Частные; Очная	   именные стипендии, учрежденные: юридическими лицами / 7.0	0	0	0	47	45	2
Республика Татарстан	Частные; Очная	   полученных от приносящей доход деятельности / 17.0	0	0	0	0	0	0
Республика Татарстан	Частные; Очная	   стипендии Правительства Российской Федерации / 3.0	0	0	0	3	3	0
Республика Татарстан	Частные; Очная	"   стипендии, назначенные физическими лицами (кроме именных,
   указанных в строке 09) / 12.0"	0	0	0	0	0	0
Республика Татарстан	Частные; Очная	"   стипендии, назначенные юридическими лицами (кроме именных,
   указанных в строке 07) / 10.0"	0	0	0	246	108	138
Республика Татарстан	Частные; Очная	Численность студентов, получающих другие формы материальной поддержки / 14.0	0	0	0	34	34	0
Республика Татарстан	Частные; Очная	Численность студентов, получающих: государственные академические стипендии / 1.0	0	0	0	103	103	0
Республика Тыва	Государственные, муниципальные (без учета организаций в ведении ФСИН); Очная	      в том числе студентам, направленным ими на обучение / 11.0	0	0	0	0	0	0
Республика Тыва	Государственные, муниципальные (без учета организаций в ведении ФСИН); Очная	      в том числе студентам, направленным ими на обучение / 13.0	0	0	0	0	0	0
Республика Тыва	Государственные, муниципальные (без учета организаций в ведении ФСИН); Очная	      из них организацией, студентами которой они являются / 8.0	0	0	0	0	0	0
Республика Тыва	Государственные, муниципальные (без учета организаций в ведении ФСИН); Очная	   бюджетных ассигнований бюджета субъекта Российской Федерации / 16.0	0	0	0	0	0	0
Республика Тыва	Государственные, муниципальные (без учета организаций в ведении ФСИН); Очная	   государственные социальные стипендии / 2.0	442	409	33	1173	833	340
Республика Тыва	Государственные, муниципальные (без учета организаций в ведении ФСИН); Очная	"   из них за счет средств: 
   стипендиального фонда / 15.0"	45	40	5	80	20	60
Республика Тыва	Государственные, муниципальные (без учета организаций в ведении ФСИН); Очная	"   именные стипендии, учрежденные: 
   органами государственной власти субъекта Российской Федерации / 5.0"	0	0	0	0	0	0
Республика Тыва	Государственные, муниципальные (без учета организаций в ведении ФСИН); Очная	   именные стипендии, учрежденные: органами местного самоуправления / 6.0	0	0	0	0	0	0
Республика Тыва	Государственные, муниципальные (без учета организаций в ведении ФСИН); Очная	   именные стипендии, учрежденные: федеральными государственными органами / 4.0	0	0	0	0	0	0
Республика Тыва	Государственные, муниципальные (без учета организаций в ведении ФСИН); Очная	   именные стипендии, учрежденные: физическими лицами / 9.0	0	0	0	0	0	0
Республика Тыва	Государственные, муниципальные (без учета организаций в ведении ФСИН); Очная	   именные стипендии, учрежденные: юридическими лицами / 7.0	0	0	0	0	0	0
Республика Тыва	Государственные, муниципальные (без учета организаций в ведении ФСИН); Очная	   полученных от приносящей доход деятельности / 17.0	0	0	0	0	0	0
Республика Тыва	Государственные, муниципальные (без учета организаций в ведении ФСИН); Очная	   стипендии Правительства Российской Федерации / 3.0	4	4	0	3	1	2
Республика Тыва	Государственные, муниципальные (без учета организаций в ведении ФСИН); Очная	"   стипендии, назначенные физическими лицами (кроме именных,
   указанных в строке 09) / 12.0"	0	0	0	0	0	0
Республика Тыва	Государственные, муниципальные (без учета организаций в ведении ФСИН); Очная	"   стипендии, назначенные юридическими лицами (кроме именных,
   указанных в строке 07) / 10.0"	0	0	0	0	0	0
Республика Тыва	Государственные, муниципальные (без учета организаций в ведении ФСИН); Очная	Численность студентов, получающих другие формы материальной поддержки / 14.0	89	81	8	324	63	261
Республика Тыва	Государственные, муниципальные (без учета организаций в ведении ФСИН); Очная	Численность студентов, получающих: государственные академические стипендии / 1.0	1708	1261	447	2885	1745	1140
Республика Тыва	Частные; Очная	      в том числе студентам, направленным ими на обучение / 11.0	0	0	0	0	0	0
Республика Тыва	Частные; Очная	      в том числе студентам, направленным ими на обучение / 13.0	0	0	0	0	0	0
Республика Тыва	Частные; Очная	      из них организацией, студентами которой они являются / 8.0	0	0	0	0	0	0
Республика Тыва	Частные; Очная	   бюджетных ассигнований бюджета субъекта Российской Федерации / 16.0	0	0	0	0	0	0
Республика Тыва	Частные; Очная	   государственные социальные стипендии / 2.0	0	0	0	0	0	0
Республика Тыва	Частные; Очная	"   из них за счет средств: 
   стипендиального фонда / 15.0"	0	0	0	0	0	0
Республика Тыва	Частные; Очная	"   именные стипендии, учрежденные: 
   органами государственной власти субъекта Российской Федерации / 5.0"	0	0	0	0	0	0
Республика Тыва	Частные; Очная	   именные стипендии, учрежденные: органами местного самоуправления / 6.0	0	0	0	0	0	0
Республика Тыва	Частные; Очная	   именные стипендии, учрежденные: федеральными государственными органами / 4.0	0	0	0	0	0	0
Республика Тыва	Частные; Очная	   именные стипендии, учрежденные: физическими лицами / 9.0	0	0	0	0	0	0
Республика Тыва	Частные; Очная	   именные стипендии, учрежденные: юридическими лицами / 7.0	0	0	0	0	0	0
Республика Тыва	Частные; Очная	   полученных от приносящей доход деятельности / 17.0	0	0	0	0	0	0
Республика Тыва	Частные; Очная	   стипендии Правительства Российской Федерации / 3.0	0	0	0	1	1	0
Республика Тыва	Частные; Очная	"   стипендии, назначенные физическими лицами (кроме именных,
   указанных в строке 09) / 12.0"	0	0	0	0	0	0
Республика Тыва	Частные; Очная	"   стипендии, назначенные юридическими лицами (кроме именных,
   указанных в строке 07) / 10.0"	0	0	0	0	0	0
Республика Тыва	Частные; Очная	Численность студентов, получающих другие формы материальной поддержки / 14.0	0	0	0	0	0	0
Республика Тыва	Частные; Очная	Численность студентов, получающих: государственные академические стипендии / 1.0	0	0	0	0	0	0
Республика Хакасия	Государственные, муниципальные (без учета организаций в ведении ФСИН); Очная	      в том числе студентам, направленным ими на обучение / 11.0	0	0	0	0	0	0
Республика Хакасия	Государственные, муниципальные (без учета организаций в ведении ФСИН); Очная	      в том числе студентам, направленным ими на обучение / 13.0	0	0	0	0	0	0
Республика Хакасия	Государственные, муниципальные (без учета организаций в ведении ФСИН); Очная	      из них организацией, студентами которой они являются / 8.0	0	0	0	0	0	0
Республика Хакасия	Государственные, муниципальные (без учета организаций в ведении ФСИН); Очная	   бюджетных ассигнований бюджета субъекта Российской Федерации / 16.0	81	81	0	80	59	21
Республика Хакасия	Государственные, муниципальные (без учета организаций в ведении ФСИН); Очная	   государственные социальные стипендии / 2.0	481	479	2	871	713	158
Республика Хакасия	Государственные, муниципальные (без учета организаций в ведении ФСИН); Очная	"   из них за счет средств: 
   стипендиального фонда / 15.0"	17	17	0	292	253	39
Республика Хакасия	Государственные, муниципальные (без учета организаций в ведении ФСИН); Очная	"   именные стипендии, учрежденные: 
   органами государственной власти субъекта Российской Федерации / 5.0"	9	9	0	25	23	2
Республика Хакасия	Государственные, муниципальные (без учета организаций в ведении ФСИН); Очная	   именные стипендии, учрежденные: органами местного самоуправления / 6.0	3	3	0	9	9	0
Республика Хакасия	Государственные, муниципальные (без учета организаций в ведении ФСИН); Очная	   именные стипендии, учрежденные: федеральными государственными органами / 4.0	0	0	0	0	0	0
Республика Хакасия	Государственные, муниципальные (без учета организаций в ведении ФСИН); Очная	   именные стипендии, учрежденные: физическими лицами / 9.0	0	0	0	0	0	0
Республика Хакасия	Государственные, муниципальные (без учета организаций в ведении ФСИН); Очная	   именные стипендии, учрежденные: юридическими лицами / 7.0	0	0	0	1	0	1
Республика Хакасия	Государственные, муниципальные (без учета организаций в ведении ФСИН); Очная	   полученных от приносящей доход деятельности / 17.0	4	4	0	92	76	16
Республика Хакасия	Государственные, муниципальные (без учета организаций в ведении ФСИН); Очная	   стипендии Правительства Российской Федерации / 3.0	5	5	0	15	13	2
Республика Хакасия	Государственные, муниципальные (без учета организаций в ведении ФСИН); Очная	"   стипендии, назначенные физическими лицами (кроме именных,
   указанных в строке 09) / 12.0"	0	0	0	0	0	0
Республика Хакасия	Государственные, муниципальные (без учета организаций в ведении ФСИН); Очная	"   стипендии, назначенные юридическими лицами (кроме именных,
   указанных в строке 07) / 10.0"	0	0	0	12	12	0
Республика Хакасия	Государственные, муниципальные (без учета организаций в ведении ФСИН); Очная	Численность студентов, получающих другие формы материальной поддержки / 14.0	109	109	0	488	410	78
Республика Хакасия	Государственные, муниципальные (без учета организаций в ведении ФСИН); Очная	Численность студентов, получающих: государственные академические стипендии / 1.0	1558	1547	11	3723	3205	518
Республика Хакасия	Частные; Очная	      в том числе студентам, направленным ими на обучение / 11.0	0	0	0	0	0	0
Республика Хакасия	Частные; Очная	      в том числе студентам, направленным ими на обучение / 13.0	0	0	0	0	0	0
Республика Хакасия	Частные; Очная	      из них организацией, студентами которой они являются / 8.0	0	0	0	0	0	0
Республика Хакасия	Частные; Очная	   бюджетных ассигнований бюджета субъекта Российской Федерации / 16.0	0	0	0	0	0	0
Республика Хакасия	Частные; Очная	   государственные социальные стипендии / 2.0	0	0	0	0	0	0
Республика Хакасия	Частные; Очная	"   из них за счет средств: 
   стипендиального фонда / 15.0"	0	0	0	0	0	0
Республика Хакасия	Частные; Очная	"   именные стипендии, учрежденные: 
   органами государственной власти субъекта Российской Федерации / 5.0"	0	0	0	0	0	0
Республика Хакасия	Частные; Очная	   именные стипендии, учрежденные: органами местного самоуправления / 6.0	0	0	0	0	0	0
Республика Хакасия	Частные; Очная	   именные стипендии, учрежденные: федеральными государственными органами / 4.0	0	0	0	0	0	0
Республика Хакасия	Частные; Очная	   именные стипендии, учрежденные: физическими лицами / 9.0	0	0	0	0	0	0
Республика Хакасия	Частные; Очная	   именные стипендии, учрежденные: юридическими лицами / 7.0	0	0	0	0	0	0
Республика Хакасия	Частные; Очная	   полученных от приносящей доход деятельности / 17.0	0	0	0	0	0	0
Республика Хакасия	Частные; Очная	   стипендии Правительства Российской Федерации / 3.0	0	0	0	0	0	0
Республика Хакасия	Частные; Очная	"   стипендии, назначенные физическими лицами (кроме именных,
   указанных в строке 09) / 12.0"	0	0	0	0	0	0
Республика Хакасия	Частные; Очная	"   стипендии, назначенные юридическими лицами (кроме именных,
   указанных в строке 07) / 10.0"	0	0	0	0	0	0
Республика Хакасия	Частные; Очная	Численность студентов, получающих другие формы материальной поддержки / 14.0	0	0	0	0	0	0
Республика Хакасия	Частные; Очная	Численность студентов, получающих: государственные академические стипендии / 1.0	0	0	0	88	88	0
Российская Федерация	Государственные, муниципальные (без учета организаций в ведении ФСИН)	      в том числе студентам, направленным ими на обучение / 11.0	92	70	22	3532	3048	484
Российская Федерация	Государственные, муниципальные (без учета организаций в ведении ФСИН)	      в том числе студентам, направленным ими на обучение / 13.0	80	80	0	154	154	0
Российская Федерация	Государственные, муниципальные (без учета организаций в ведении ФСИН)	      из них организацией, студентами которой они являются / 8.0	326	326	0	1029	869	160
Российская Федерация	Государственные, муниципальные (без учета организаций в ведении ФСИН)	   бюджетных ассигнований бюджета субъекта Российской Федерации / 16.0	24086	23472	614	53675	48826	4849
Российская Федерация	Государственные, муниципальные (без учета организаций в ведении ФСИН)	   государственные социальные стипендии / 2.0	92001	88869	3132	242108	213654	28454
Российская Федерация	Государственные, муниципальные (без учета организаций в ведении ФСИН)	"   из них за счет средств: 
   стипендиального фонда / 15.0"	35348	33480	1868	123232	107474	15758
Российская Федерация	Государственные, муниципальные (без учета организаций в ведении ФСИН)	"   именные стипендии, учрежденные: 
   органами государственной власти субъекта Российской Федерации / 5.0"	1701	1616	85	4093	3492	601
Российская Федерация	Государственные, муниципальные (без учета организаций в ведении ФСИН)	   именные стипендии, учрежденные: органами местного самоуправления / 6.0	55	54	1	673	568	105
Российская Федерация	Государственные, муниципальные (без учета организаций в ведении ФСИН)	   именные стипендии, учрежденные: федеральными государственными органами / 4.0	117	95	22	359	323	36
Российская Федерация	Государственные, муниципальные (без учета организаций в ведении ФСИН)	   именные стипендии, учрежденные: физическими лицами / 9.0	3	3	0	68	55	13
Российская Федерация	Государственные, муниципальные (без учета организаций в ведении ФСИН)	   именные стипендии, учрежденные: юридическими лицами / 7.0	977	973	4	2723	2426	297
Российская Федерация	Государственные, муниципальные (без учета организаций в ведении ФСИН)	   полученных от приносящей доход деятельности / 17.0	1576	1505	71	11855	10186	1669
Российская Федерация	Государственные, муниципальные (без учета организаций в ведении ФСИН)	   стипендии Правительства Российской Федерации / 3.0	1535	1486	49	4396	3928	468
Российская Федерация	Государственные, муниципальные (без учета организаций в ведении ФСИН)	"   стипендии, назначенные физическими лицами (кроме именных,
   указанных в строке 09) / 12.0"	117	117	0	381	289	92
Российская Федерация	Государственные, муниципальные (без учета организаций в ведении ФСИН)	"   стипендии, назначенные юридическими лицами (кроме именных,
   указанных в строке 07) / 10.0"	1405	1378	27	7559	6064	1495
Российская Федерация	Государственные, муниципальные (без учета организаций в ведении ФСИН)	Численность студентов, получающих другие формы материальной поддержки / 14.0	61354	58702	2652	188481	165929	22552
Российская Федерация	Государственные, муниципальные (без учета организаций в ведении ФСИН)	Численность студентов, получающих: государственные академические стипендии / 1.0	324418	305587	18831	1118356	976513	141843
Российская Федерация	Государственные, муниципальные (без учета организаций в ведении ФСИН); Очная	      в том числе студентам, направленным ими на обучение / 11.0	92	70	22	3532	3048	484
Российская Федерация	Государственные, муниципальные (без учета организаций в ведении ФСИН); Очная	      в том числе студентам, направленным ими на обучение / 13.0	80	80	0	154	154	0
Российская Федерация	Государственные, муниципальные (без учета организаций в ведении ФСИН); Очная	      из них организацией, студентами которой они являются / 8.0	326	326	0	1029	869	160
Российская Федерация	Государственные, муниципальные (без учета организаций в ведении ФСИН); Очная	   бюджетных ассигнований бюджета субъекта Российской Федерации / 16.0	24086	23472	614	53675	48826	4849
Российская Федерация	Государственные, муниципальные (без учета организаций в ведении ФСИН); Очная	   государственные социальные стипендии / 2.0	92001	88869	3132	242108	213654	28454
Российская Федерация	Государственные, муниципальные (без учета организаций в ведении ФСИН); Очная	"   из них за счет средств: 
   стипендиального фонда / 15.0"	35348	33480	1868	123232	107474	15758
Российская Федерация	Государственные, муниципальные (без учета организаций в ведении ФСИН); Очная	"   именные стипендии, учрежденные: 
   органами государственной власти субъекта Российской Федерации / 5.0"	1701	1616	85	4093	3492	601
Российская Федерация	Государственные, муниципальные (без учета организаций в ведении ФСИН); Очная	   именные стипендии, учрежденные: органами местного самоуправления / 6.0	55	54	1	673	568	105
Российская Федерация	Государственные, муниципальные (без учета организаций в ведении ФСИН); Очная	   именные стипендии, учрежденные: федеральными государственными органами / 4.0	117	95	22	359	323	36
Российская Федерация	Государственные, муниципальные (без учета организаций в ведении ФСИН); Очная	   именные стипендии, учрежденные: физическими лицами / 9.0	3	3	0	68	55	13
Российская Федерация	Государственные, муниципальные (без учета организаций в ведении ФСИН); Очная	   именные стипендии, учрежденные: юридическими лицами / 7.0	977	973	4	2723	2426	297
Российская Федерация	Государственные, муниципальные (без учета организаций в ведении ФСИН); Очная	   полученных от приносящей доход деятельности / 17.0	1576	1505	71	11855	10186	1669
Российская Федерация	Государственные, муниципальные (без учета организаций в ведении ФСИН); Очная	   стипендии Правительства Российской Федерации / 3.0	1535	1486	49	4396	3928	468
Российская Федерация	Государственные, муниципальные (без учета организаций в ведении ФСИН); Очная	"   стипендии, назначенные физическими лицами (кроме именных,
   указанных в строке 09) / 12.0"	117	117	0	381	289	92
Российская Федерация	Государственные, муниципальные (без учета организаций в ведении ФСИН); Очная	"   стипендии, назначенные юридическими лицами (кроме именных,
   указанных в строке 07) / 10.0"	1405	1378	27	7559	6064	1495
Российская Федерация	Государственные, муниципальные (без учета организаций в ведении ФСИН); Очная	Численность студентов, получающих другие формы материальной поддержки / 14.0	61354	58702	2652	188481	165929	22552
Российская Федерация	Государственные, муниципальные (без учета организаций в ведении ФСИН); Очная	Численность студентов, получающих: государственные академические стипендии / 1.0	324418	305587	18831	1118356	976513	141843
Российская Федерация	Очная	      в том числе студентам, направленным ими на обучение / 11.0	92	70	22	3532	3048	484
Российская Федерация	Очная	      в том числе студентам, направленным ими на обучение / 13.0	80	80	0	154	154	0
Российская Федерация	Очная	      из них организацией, студентами которой они являются / 8.0	326	326	0	1213	1018	195
Российская Федерация	Очная	   бюджетных ассигнований бюджета субъекта Российской Федерации / 16.0	24171	23557	614	54240	49374	4866
Российская Федерация	Очная	   государственные социальные стипендии / 2.0	92038	88906	3132	242692	214196	28496
Российская Федерация	Очная	"   из них за счет средств: 
   стипендиального фонда / 15.0"	35348	33480	1868	123966	108134	15832
Российская Федерация	Очная	"   именные стипендии, учрежденные: 
   органами государственной власти субъекта Российской Федерации / 5.0"	1701	1616	85	4185	3580	605
Российская Федерация	Очная	   именные стипендии, учрежденные: органами местного самоуправления / 6.0	55	54	1	692	584	108
Российская Федерация	Очная	   именные стипендии, учрежденные: федеральными государственными органами / 4.0	117	95	22	367	331	36
Российская Федерация	Очная	   именные стипендии, учрежденные: физическими лицами / 9.0	3	3	0	68	55	13
Российская Федерация	Очная	   именные стипендии, учрежденные: юридическими лицами / 7.0	988	973	15	2968	2596	372
Российская Федерация	Очная	   полученных от приносящей доход деятельности / 17.0	1588	1517	71	12942	11150	1792
Российская Федерация	Очная	   стипендии Правительства Российской Федерации / 3.0	1542	1493	49	4483	4009	474
Российская Федерация	Очная	"   стипендии, назначенные физическими лицами (кроме именных,
   указанных в строке 09) / 12.0"	117	117	0	381	289	92
Российская Федерация	Очная	"   стипендии, назначенные юридическими лицами (кроме именных,
   указанных в строке 07) / 10.0"	1416	1378	38	8130	6403	1727
Российская Федерация	Очная	Численность студентов, получающих другие формы материальной поддержки / 14.0	61451	58799	2652	190943	168177	22766
Российская Федерация	Очная	Численность студентов, получающих: государственные академические стипендии / 1.0	324751	305845	18906	1124218	981819	142399
Российская Федерация	Частные	      в том числе студентам, направленным ими на обучение / 11.0	0	0	0	0	0	0
Российская Федерация	Частные	      в том числе студентам, направленным ими на обучение / 13.0	0	0	0	0	0	0
Российская Федерация	Частные	      из них организацией, студентами которой они являются / 8.0	0	0	0	184	149	35
Российская Федерация	Частные	   бюджетных ассигнований бюджета субъекта Российской Федерации / 16.0	85	85	0	565	548	17
Российская Федерация	Частные	   государственные социальные стипендии / 2.0	37	37	0	584	542	42
Российская Федерация	Частные	"   из них за счет средств: 
   стипендиального фонда / 15.0"	0	0	0	734	660	74
Российская Федерация	Частные	"   именные стипендии, учрежденные: 
   органами государственной власти субъекта Российской Федерации / 5.0"	0	0	0	92	88	4
Российская Федерация	Частные	   именные стипендии, учрежденные: органами местного самоуправления / 6.0	0	0	0	19	16	3
Российская Федерация	Частные	   именные стипендии, учрежденные: федеральными государственными органами / 4.0	0	0	0	8	8	0
Российская Федерация	Частные	   именные стипендии, учрежденные: физическими лицами / 9.0	0	0	0	0	0	0
Российская Федерация	Частные	   именные стипендии, учрежденные: юридическими лицами / 7.0	11	0	11	245	170	75
Российская Федерация	Частные	   полученных от приносящей доход деятельности / 17.0	12	12	0	1087	964	123
Российская Федерация	Частные	   стипендии Правительства Российской Федерации / 3.0	7	7	0	87	81	6
Российская Федерация	Частные	"   стипендии, назначенные физическими лицами (кроме именных,
   указанных в строке 09) / 12.0"	0	0	0	0	0	0
Российская Федерация	Частные	"   стипендии, назначенные юридическими лицами (кроме именных,
   указанных в строке 07) / 10.0"	11	0	11	571	339	232
Российская Федерация	Частные	Численность студентов, получающих другие формы материальной поддержки / 14.0	97	97	0	2462	2248	214
Российская Федерация	Частные	Численность студентов, получающих: государственные академические стипендии / 1.0	333	258	75	5862	5306	556
Российская Федерация	Частные; Очная	      в том числе студентам, направленным ими на обучение / 11.0	0	0	0	0	0	0
Российская Федерация	Частные; Очная	      в том числе студентам, направленным ими на обучение / 13.0	0	0	0	0	0	0
Российская Федерация	Частные; Очная	      из них организацией, студентами которой они являются / 8.0	0	0	0	184	149	35
Российская Федерация	Частные; Очная	   бюджетных ассигнований бюджета субъекта Российской Федерации / 16.0	85	85	0	565	548	17
Российская Федерация	Частные; Очная	   государственные социальные стипендии / 2.0	37	37	0	584	542	42
Российская Федерация	Частные; Очная	"   из них за счет средств: 
   стипендиального фонда / 15.0"	0	0	0	734	660	74
Российская Федерация	Частные; Очная	"   именные стипендии, учрежденные: 
   органами государственной власти субъекта Российской Федерации / 5.0"	0	0	0	92	88	4
Российская Федерация	Частные; Очная	   именные стипендии, учрежденные: органами местного самоуправления / 6.0	0	0	0	19	16	3
Российская Федерация	Частные; Очная	   именные стипендии, учрежденные: федеральными государственными органами / 4.0	0	0	0	8	8	0
Российская Федерация	Частные; Очная	   именные стипендии, учрежденные: физическими лицами / 9.0	0	0	0	0	0	0
Российская Федерация	Частные; Очная	   именные стипендии, учрежденные: юридическими лицами / 7.0	11	0	11	245	170	75
Российская Федерация	Частные; Очная	   полученных от приносящей доход деятельности / 17.0	12	12	0	1087	964	123
Российская Федерация	Частные; Очная	   стипендии Правительства Российской Федерации / 3.0	7	7	0	87	81	6
Российская Федерация	Частные; Очная	"   стипендии, назначенные физическими лицами (кроме именных,
   указанных в строке 09) / 12.0"	0	0	0	0	0	0
Российская Федерация	Частные; Очная	"   стипендии, назначенные юридическими лицами (кроме именных,
   указанных в строке 07) / 10.0"	11	0	11	571	339	232
Российская Федерация	Частные; Очная	Численность студентов, получающих другие формы материальной поддержки / 14.0	97	97	0	2462	2248	214
Российская Федерация	Частные; Очная	Численность студентов, получающих: государственные академические стипендии / 1.0	333	258	75	5862	5306	556
Ростовская область	Государственные, муниципальные (без учета организаций в ведении ФСИН); Очная	      в том числе студентам, направленным ими на обучение / 11.0	0	0	0	57	0	57
Ростовская область	Государственные, муниципальные (без учета организаций в ведении ФСИН); Очная	      в том числе студентам, направленным ими на обучение / 13.0	0	0	0	0	0	0
Ростовская область	Государственные, муниципальные (без учета организаций в ведении ФСИН); Очная	      из них организацией, студентами которой они являются / 8.0	298	298	0	168	167	1
Ростовская область	Государственные, муниципальные (без учета организаций в ведении ФСИН); Очная	   бюджетных ассигнований бюджета субъекта Российской Федерации / 16.0	1543	1517	26	492	420	72
Ростовская область	Государственные, муниципальные (без учета организаций в ведении ФСИН); Очная	   государственные социальные стипендии / 2.0	2703	2610	93	5583	4865	718
Ростовская область	Государственные, муниципальные (без учета организаций в ведении ФСИН); Очная	"   из них за счет средств: 
   стипендиального фонда / 15.0"	253	248	5	640	584	56
Ростовская область	Государственные, муниципальные (без учета организаций в ведении ФСИН); Очная	"   именные стипендии, учрежденные: 
   органами государственной власти субъекта Российской Федерации / 5.0"	0	0	0	18	14	4
Ростовская область	Государственные, муниципальные (без учета организаций в ведении ФСИН); Очная	   именные стипендии, учрежденные: органами местного самоуправления / 6.0	5	5	0	11	10	1
Ростовская область	Государственные, муниципальные (без учета организаций в ведении ФСИН); Очная	   именные стипендии, учрежденные: федеральными государственными органами / 4.0	1	1	0	16	16	0
Ростовская область	Государственные, муниципальные (без учета организаций в ведении ФСИН); Очная	   именные стипендии, учрежденные: физическими лицами / 9.0	0	0	0	23	23	0
Ростовская область	Государственные, муниципальные (без учета организаций в ведении ФСИН); Очная	   именные стипендии, учрежденные: юридическими лицами / 7.0	328	324	4	282	267	15
Ростовская область	Государственные, муниципальные (без учета организаций в ведении ФСИН); Очная	   полученных от приносящей доход деятельности / 17.0	48	46	2	961	893	68
Ростовская область	Государственные, муниципальные (без учета организаций в ведении ФСИН); Очная	   стипендии Правительства Российской Федерации / 3.0	20	20	0	84	74	10
Ростовская область	Государственные, муниципальные (без учета организаций в ведении ФСИН); Очная	"   стипендии, назначенные физическими лицами (кроме именных,
   указанных в строке 09) / 12.0"	1	1	0	10	10	0
Ростовская область	Государственные, муниципальные (без учета организаций в ведении ФСИН); Очная	"   стипендии, назначенные юридическими лицами (кроме именных,
   указанных в строке 07) / 10.0"	9	9	0	127	65	62
Ростовская область	Государственные, муниципальные (без учета организаций в ведении ФСИН); Очная	Численность студентов, получающих другие формы материальной поддержки / 14.0	1789	1760	29	2679	2488	191
Ростовская область	Государственные, муниципальные (без учета организаций в ведении ФСИН); Очная	Численность студентов, получающих: государственные академические стипендии / 1.0	12451	11598	853	34404	29501	4903
Ростовская область	Частные; Очная	      в том числе студентам, направленным ими на обучение / 11.0	0	0	0	0	0	0
Ростовская область	Частные; Очная	      в том числе студентам, направленным ими на обучение / 13.0	0	0	0	0	0	0
Ростовская область	Частные; Очная	      из них организацией, студентами которой они являются / 8.0	0	0	0	0	0	0
Ростовская область	Частные; Очная	   бюджетных ассигнований бюджета субъекта Российской Федерации / 16.0	0	0	0	0	0	0
Ростовская область	Частные; Очная	   государственные социальные стипендии / 2.0	0	0	0	4	4	0
Ростовская область	Частные; Очная	"   из них за счет средств: 
   стипендиального фонда / 15.0"	0	0	0	0	0	0
Ростовская область	Частные; Очная	"   именные стипендии, учрежденные: 
   органами государственной власти субъекта Российской Федерации / 5.0"	0	0	0	0	0	0
Ростовская область	Частные; Очная	   именные стипендии, учрежденные: органами местного самоуправления / 6.0	0	0	0	0	0	0
Ростовская область	Частные; Очная	   именные стипендии, учрежденные: федеральными государственными органами / 4.0	0	0	0	0	0	0
Ростовская область	Частные; Очная	   именные стипендии, учрежденные: физическими лицами / 9.0	0	0	0	0	0	0
Ростовская область	Частные; Очная	   именные стипендии, учрежденные: юридическими лицами / 7.0	0	0	0	0	0	0
Ростовская область	Частные; Очная	   полученных от приносящей доход деятельности / 17.0	0	0	0	26	26	0
Ростовская область	Частные; Очная	   стипендии Правительства Российской Федерации / 3.0	0	0	0	0	0	0
Ростовская область	Частные; Очная	"   стипендии, назначенные физическими лицами (кроме именных,
   указанных в строке 09) / 12.0"	0	0	0	0	0	0
Ростовская область	Частные; Очная	"   стипендии, назначенные юридическими лицами (кроме именных,
   указанных в строке 07) / 10.0"	0	0	0	0	0	0
Ростовская область	Частные; Очная	Численность студентов, получающих другие формы материальной поддержки / 14.0	0	0	0	26	26	0
Ростовская область	Частные; Очная	Численность студентов, получающих: государственные академические стипендии / 1.0	0	0	0	52	52	0
Рязанская область	Государственные, муниципальные (без учета организаций в ведении ФСИН); Очная	      в том числе студентам, направленным ими на обучение / 11.0	0	0	0	42	42	0
Рязанская область	Государственные, муниципальные (без учета организаций в ведении ФСИН); Очная	      в том числе студентам, направленным ими на обучение / 13.0	0	0	0	0	0	0
Рязанская область	Государственные, муниципальные (без учета организаций в ведении ФСИН); Очная	      из них организацией, студентами которой они являются / 8.0	0	0	0	0	0	0
Рязанская область	Государственные, муниципальные (без учета организаций в ведении ФСИН); Очная	   бюджетных ассигнований бюджета субъекта Российской Федерации / 16.0	501	498	3	2001	1812	189
Рязанская область	Государственные, муниципальные (без учета организаций в ведении ФСИН); Очная	   государственные социальные стипендии / 2.0	325	311	14	3017	2904	113
Рязанская область	Государственные, муниципальные (без учета организаций в ведении ФСИН); Очная	"   из них за счет средств: 
   стипендиального фонда / 15.0"	19	19	0	327	327	0
Рязанская область	Государственные, муниципальные (без учета организаций в ведении ФСИН); Очная	"   именные стипендии, учрежденные: 
   органами государственной власти субъекта Российской Федерации / 5.0"	5	5	0	17	17	0
Рязанская область	Государственные, муниципальные (без учета организаций в ведении ФСИН); Очная	   именные стипендии, учрежденные: органами местного самоуправления / 6.0	0	0	0	6	6	0
Рязанская область	Государственные, муниципальные (без учета организаций в ведении ФСИН); Очная	   именные стипендии, учрежденные: федеральными государственными органами / 4.0	0	0	0	0	0	0
Рязанская область	Государственные, муниципальные (без учета организаций в ведении ФСИН); Очная	   именные стипендии, учрежденные: физическими лицами / 9.0	0	0	0	0	0	0
Рязанская область	Государственные, муниципальные (без учета организаций в ведении ФСИН); Очная	   именные стипендии, учрежденные: юридическими лицами / 7.0	0	0	0	5	5	0
Рязанская область	Государственные, муниципальные (без учета организаций в ведении ФСИН); Очная	   полученных от приносящей доход деятельности / 17.0	42	42	0	1262	1252	10
Рязанская область	Государственные, муниципальные (без учета организаций в ведении ФСИН); Очная	   стипендии Правительства Российской Федерации / 3.0	51	51	0	43	37	6
Рязанская область	Государственные, муниципальные (без учета организаций в ведении ФСИН); Очная	"   стипендии, назначенные физическими лицами (кроме именных,
   указанных в строке 09) / 12.0"	0	0	0	0	0	0
Рязанская область	Государственные, муниципальные (без учета организаций в ведении ФСИН); Очная	"   стипендии, назначенные юридическими лицами (кроме именных,
   указанных в строке 07) / 10.0"	0	0	0	42	42	0
Рязанская область	Государственные, муниципальные (без учета организаций в ведении ФСИН); Очная	Численность студентов, получающих другие формы материальной поддержки / 14.0	546	543	3	3777	3513	264
Рязанская область	Государственные, муниципальные (без учета организаций в ведении ФСИН); Очная	Численность студентов, получающих: государственные академические стипендии / 1.0	1026	974	52	8448	7760	688
Самарская область	Государственные, муниципальные (без учета организаций в ведении ФСИН); Очная	      в том числе студентам, направленным ими на обучение / 11.0	0	0	0	150	118	32
Самарская область	Государственные, муниципальные (без учета организаций в ведении ФСИН); Очная	      в том числе студентам, направленным ими на обучение / 13.0	0	0	0	0	0	0
Самарская область	Государственные, муниципальные (без учета организаций в ведении ФСИН); Очная	      из них организацией, студентами которой они являются / 8.0	0	0	0	9	8	1
Самарская область	Государственные, муниципальные (без учета организаций в ведении ФСИН); Очная	   бюджетных ассигнований бюджета субъекта Российской Федерации / 16.0	1867	1842	25	5951	5678	273
Самарская область	Государственные, муниципальные (без учета организаций в ведении ФСИН); Очная	   государственные социальные стипендии / 2.0	2902	2891	11	7412	7064	348
Самарская область	Государственные, муниципальные (без учета организаций в ведении ФСИН); Очная	"   из них за счет средств: 
   стипендиального фонда / 15.0"	3284	3283	1	13261	12991	270
Самарская область	Государственные, муниципальные (без учета организаций в ведении ФСИН); Очная	"   именные стипендии, учрежденные: 
   органами государственной власти субъекта Российской Федерации / 5.0"	377	377	0	368	368	0
Самарская область	Государственные, муниципальные (без учета организаций в ведении ФСИН); Очная	   именные стипендии, учрежденные: органами местного самоуправления / 6.0	0	0	0	6	6	0
Самарская область	Государственные, муниципальные (без учета организаций в ведении ФСИН); Очная	   именные стипендии, учрежденные: федеральными государственными органами / 4.0	0	0	0	0	0	0
Самарская область	Государственные, муниципальные (без учета организаций в ведении ФСИН); Очная	   именные стипендии, учрежденные: физическими лицами / 9.0	0	0	0	0	0	0
Самарская область	Государственные, муниципальные (без учета организаций в ведении ФСИН); Очная	   именные стипендии, учрежденные: юридическими лицами / 7.0	0	0	0	12	11	1
Самарская область	Государственные, муниципальные (без учета организаций в ведении ФСИН); Очная	   полученных от приносящей доход деятельности / 17.0	87	86	1	119	111	8
Самарская область	Государственные, муниципальные (без учета организаций в ведении ФСИН); Очная	   стипендии Правительства Российской Федерации / 3.0	7	7	0	67	64	3
Самарская область	Государственные, муниципальные (без учета организаций в ведении ФСИН); Очная	"   стипендии, назначенные физическими лицами (кроме именных,
   указанных в строке 09) / 12.0"	0	0	0	0	0	0
Самарская область	Государственные, муниципальные (без учета организаций в ведении ФСИН); Очная	"   стипендии, назначенные юридическими лицами (кроме именных,
   указанных в строке 07) / 10.0"	0	0	0	150	118	32
Самарская область	Государственные, муниципальные (без учета организаций в ведении ФСИН); Очная	Численность студентов, получающих другие формы материальной поддержки / 14.0	5337	5306	31	19426	18874	552
Самарская область	Государственные, муниципальные (без учета организаций в ведении ФСИН); Очная	Численность студентов, получающих: государственные академические стипендии / 1.0	9601	9310	291	30617	29105	1512
Самарская область	Частные; Очная	      в том числе студентам, направленным ими на обучение / 11.0	0	0	0	0	0	0
Самарская область	Частные; Очная	      в том числе студентам, направленным ими на обучение / 13.0	0	0	0	0	0	0
Самарская область	Частные; Очная	      из них организацией, студентами которой они являются / 8.0	0	0	0	0	0	0
Самарская область	Частные; Очная	   бюджетных ассигнований бюджета субъекта Российской Федерации / 16.0	0	0	0	3	1	2
Самарская область	Частные; Очная	   государственные социальные стипендии / 2.0	0	0	0	28	22	6
Самарская область	Частные; Очная	"   из них за счет средств: 
   стипендиального фонда / 15.0"	0	0	0	0	0	0
Самарская область	Частные; Очная	"   именные стипендии, учрежденные: 
   органами государственной власти субъекта Российской Федерации / 5.0"	0	0	0	0	0	0
Самарская область	Частные; Очная	   именные стипендии, учрежденные: органами местного самоуправления / 6.0	0	0	0	0	0	0
Самарская область	Частные; Очная	   именные стипендии, учрежденные: федеральными государственными органами / 4.0	0	0	0	0	0	0
Самарская область	Частные; Очная	   именные стипендии, учрежденные: физическими лицами / 9.0	0	0	0	0	0	0
Самарская область	Частные; Очная	   именные стипендии, учрежденные: юридическими лицами / 7.0	0	0	0	0	0	0
Самарская область	Частные; Очная	   полученных от приносящей доход деятельности / 17.0	0	0	0	0	0	0
Самарская область	Частные; Очная	   стипендии Правительства Российской Федерации / 3.0	0	0	0	0	0	0
Самарская область	Частные; Очная	"   стипендии, назначенные физическими лицами (кроме именных,
   указанных в строке 09) / 12.0"	0	0	0	0	0	0
Самарская область	Частные; Очная	"   стипендии, назначенные юридическими лицами (кроме именных,
   указанных в строке 07) / 10.0"	0	0	0	0	0	0
Самарская область	Частные; Очная	Численность студентов, получающих другие формы материальной поддержки / 14.0	0	0	0	3	1	2
Самарская область	Частные; Очная	Численность студентов, получающих: государственные академические стипендии / 1.0	0	0	0	172	140	32
Саратовская область	Государственные, муниципальные (без учета организаций в ведении ФСИН); Очная	      в том числе студентам, направленным ими на обучение / 11.0	0	0	0	296	296	0
Саратовская область	Государственные, муниципальные (без учета организаций в ведении ФСИН); Очная	      в том числе студентам, направленным ими на обучение / 13.0	0	0	0	0	0	0
Саратовская область	Государственные, муниципальные (без учета организаций в ведении ФСИН); Очная	      из них организацией, студентами которой они являются / 8.0	0	0	0	3	3	0
Саратовская область	Государственные, муниципальные (без учета организаций в ведении ФСИН); Очная	   бюджетных ассигнований бюджета субъекта Российской Федерации / 16.0	705	659	46	2058	2030	28
Саратовская область	Государственные, муниципальные (без учета организаций в ведении ФСИН); Очная	   государственные социальные стипендии / 2.0	12018	11905	113	40040	37711	2329
Саратовская область	Государственные, муниципальные (без учета организаций в ведении ФСИН); Очная	"   из них за счет средств: 
   стипендиального фонда / 15.0"	667	658	9	4261	3813	448
Саратовская область	Государственные, муниципальные (без учета организаций в ведении ФСИН); Очная	"   именные стипендии, учрежденные: 
   органами государственной власти субъекта Российской Федерации / 5.0"	0	0	0	5	5	0
Саратовская область	Государственные, муниципальные (без учета организаций в ведении ФСИН); Очная	   именные стипендии, учрежденные: органами местного самоуправления / 6.0	0	0	0	131	109	22
Саратовская область	Государственные, муниципальные (без учета организаций в ведении ФСИН); Очная	   именные стипендии, учрежденные: федеральными государственными органами / 4.0	0	0	0	0	0	0
Саратовская область	Государственные, муниципальные (без учета организаций в ведении ФСИН); Очная	   именные стипендии, учрежденные: физическими лицами / 9.0	0	0	0	0	0	0
Саратовская область	Государственные, муниципальные (без учета организаций в ведении ФСИН); Очная	   именные стипендии, учрежденные: юридическими лицами / 7.0	9	9	0	45	45	0
Саратовская область	Государственные, муниципальные (без учета организаций в ведении ФСИН); Очная	   полученных от приносящей доход деятельности / 17.0	3	3	0	231	223	8
Саратовская область	Государственные, муниципальные (без учета организаций в ведении ФСИН); Очная	   стипендии Правительства Российской Федерации / 3.0	35	33	2	90	78	12
Саратовская область	Государственные, муниципальные (без учета организаций в ведении ФСИН); Очная	"   стипендии, назначенные физическими лицами (кроме именных,
   указанных в строке 09) / 12.0"	0	0	0	0	0	0
Саратовская область	Государственные, муниципальные (без учета организаций в ведении ФСИН); Очная	"   стипендии, назначенные юридическими лицами (кроме именных,
   указанных в строке 07) / 10.0"	0	0	0	296	296	0
Саратовская область	Государственные, муниципальные (без учета организаций в ведении ФСИН); Очная	Численность студентов, получающих другие формы материальной поддержки / 14.0	1583	1485	98	6201	5595	606
Саратовская область	Государственные, муниципальные (без учета организаций в ведении ФСИН); Очная	Численность студентов, получающих: государственные академические стипендии / 1.0	24901	24551	350	94129	88140	5989
Сахалинская область	Государственные, муниципальные (без учета организаций в ведении ФСИН); Очная	      в том числе студентам, направленным ими на обучение / 11.0	0	0	0	0	0	0
Сахалинская область	Государственные, муниципальные (без учета организаций в ведении ФСИН); Очная	      в том числе студентам, направленным ими на обучение / 13.0	0	0	0	0	0	0
Сахалинская область	Государственные, муниципальные (без учета организаций в ведении ФСИН); Очная	      из них организацией, студентами которой они являются / 8.0	0	0	0	0	0	0
Сахалинская область	Государственные, муниципальные (без учета организаций в ведении ФСИН); Очная	   бюджетных ассигнований бюджета субъекта Российской Федерации / 16.0	116	115	1	92	80	12
Сахалинская область	Государственные, муниципальные (без учета организаций в ведении ФСИН); Очная	   государственные социальные стипендии / 2.0	1065	1064	1	924	740	184
Сахалинская область	Государственные, муниципальные (без учета организаций в ведении ФСИН); Очная	"   из них за счет средств: 
   стипендиального фонда / 15.0"	114	114	0	196	190	6
Сахалинская область	Государственные, муниципальные (без учета организаций в ведении ФСИН); Очная	"   именные стипендии, учрежденные: 
   органами государственной власти субъекта Российской Федерации / 5.0"	5	5	0	8	7	1
Сахалинская область	Государственные, муниципальные (без учета организаций в ведении ФСИН); Очная	   именные стипендии, учрежденные: органами местного самоуправления / 6.0	0	0	0	0	0	0
Сахалинская область	Государственные, муниципальные (без учета организаций в ведении ФСИН); Очная	   именные стипендии, учрежденные: федеральными государственными органами / 4.0	0	0	0	0	0	0
Сахалинская область	Государственные, муниципальные (без учета организаций в ведении ФСИН); Очная	   именные стипендии, учрежденные: физическими лицами / 9.0	0	0	0	0	0	0
Сахалинская область	Государственные, муниципальные (без учета организаций в ведении ФСИН); Очная	   именные стипендии, учрежденные: юридическими лицами / 7.0	0	0	0	0	0	0
Сахалинская область	Государственные, муниципальные (без учета организаций в ведении ФСИН); Очная	   полученных от приносящей доход деятельности / 17.0	0	0	0	0	0	0
Сахалинская область	Государственные, муниципальные (без учета организаций в ведении ФСИН); Очная	   стипендии Правительства Российской Федерации / 3.0	5	5	0	23	12	11
Сахалинская область	Государственные, муниципальные (без учета организаций в ведении ФСИН); Очная	"   стипендии, назначенные физическими лицами (кроме именных,
   указанных в строке 09) / 12.0"	0	0	0	0	0	0
Сахалинская область	Государственные, муниципальные (без учета организаций в ведении ФСИН); Очная	"   стипендии, назначенные юридическими лицами (кроме именных,
   указанных в строке 07) / 10.0"	0	0	0	0	0	0
Сахалинская область	Государственные, муниципальные (без учета организаций в ведении ФСИН); Очная	Численность студентов, получающих другие формы материальной поддержки / 14.0	246	245	1	304	286	18
Сахалинская область	Государственные, муниципальные (без учета организаций в ведении ФСИН); Очная	Численность студентов, получающих: государственные академические стипендии / 1.0	2160	2137	23	3367	2668	699
Свердловская область	Государственные, муниципальные (без учета организаций в ведении ФСИН); Очная	      в том числе студентам, направленным ими на обучение / 11.0	0	0	0	0	0	0
Свердловская область	Государственные, муниципальные (без учета организаций в ведении ФСИН); Очная	      в том числе студентам, направленным ими на обучение / 13.0	0	0	0	4	4	0
Свердловская область	Государственные, муниципальные (без учета организаций в ведении ФСИН); Очная	      из них организацией, студентами которой они являются / 8.0	0	0	0	30	20	10
Свердловская область	Государственные, муниципальные (без учета организаций в ведении ФСИН); Очная	   бюджетных ассигнований бюджета субъекта Российской Федерации / 16.0	519	506	13	1983	1722	261
Свердловская область	Государственные, муниципальные (без учета организаций в ведении ФСИН); Очная	   государственные социальные стипендии / 2.0	2258	2227	31	6332	5604	728
Свердловская область	Государственные, муниципальные (без учета организаций в ведении ФСИН); Очная	"   из них за счет средств: 
   стипендиального фонда / 15.0"	650	639	11	2541	2144	397
Свердловская область	Государственные, муниципальные (без учета организаций в ведении ФСИН); Очная	"   именные стипендии, учрежденные: 
   органами государственной власти субъекта Российской Федерации / 5.0"	10	10	0	21	21	0
Свердловская область	Государственные, муниципальные (без учета организаций в ведении ФСИН); Очная	   именные стипендии, учрежденные: органами местного самоуправления / 6.0	0	0	0	1	1	0
Свердловская область	Государственные, муниципальные (без учета организаций в ведении ФСИН); Очная	   именные стипендии, учрежденные: федеральными государственными органами / 4.0	0	0	0	1	1	0
Свердловская область	Государственные, муниципальные (без учета организаций в ведении ФСИН); Очная	   именные стипендии, учрежденные: физическими лицами / 9.0	0	0	0	0	0	0
Свердловская область	Государственные, муниципальные (без учета организаций в ведении ФСИН); Очная	   именные стипендии, учрежденные: юридическими лицами / 7.0	8	8	0	38	28	10
Свердловская область	Государственные, муниципальные (без учета организаций в ведении ФСИН); Очная	   полученных от приносящей доход деятельности / 17.0	28	28	0	212	190	22
Свердловская область	Государственные, муниципальные (без учета организаций в ведении ФСИН); Очная	   стипендии Правительства Российской Федерации / 3.0	30	30	0	128	101	27
Свердловская область	Государственные, муниципальные (без учета организаций в ведении ФСИН); Очная	"   стипендии, назначенные физическими лицами (кроме именных,
   указанных в строке 09) / 12.0"	0	0	0	5	5	0
Свердловская область	Государственные, муниципальные (без учета организаций в ведении ФСИН); Очная	"   стипендии, назначенные юридическими лицами (кроме именных,
   указанных в строке 07) / 10.0"	9	9	0	29	28	1
Свердловская область	Государственные, муниципальные (без учета организаций в ведении ФСИН); Очная	Численность студентов, получающих другие формы материальной поддержки / 14.0	1254	1234	20	4881	4209	672
Свердловская область	Государственные, муниципальные (без учета организаций в ведении ФСИН); Очная	Численность студентов, получающих: государственные академические стипендии / 1.0	7930	7774	156	37652	33419	4233
Смоленская область	Государственные, муниципальные (без учета организаций в ведении ФСИН); Очная	      в том числе студентам, направленным ими на обучение / 11.0	7	7	0	10	10	0
Смоленская область	Государственные, муниципальные (без учета организаций в ведении ФСИН); Очная	      в том числе студентам, направленным ими на обучение / 13.0	0	0	0	0	0	0
Смоленская область	Государственные, муниципальные (без учета организаций в ведении ФСИН); Очная	      из них организацией, студентами которой они являются / 8.0	0	0	0	0	0	0
Смоленская область	Государственные, муниципальные (без учета организаций в ведении ФСИН); Очная	   бюджетных ассигнований бюджета субъекта Российской Федерации / 16.0	142	141	1	658	471	187
Смоленская область	Государственные, муниципальные (без учета организаций в ведении ФСИН); Очная	   государственные социальные стипендии / 2.0	433	429	4	1008	870	138
Смоленская область	Государственные, муниципальные (без учета организаций в ведении ФСИН); Очная	"   из них за счет средств: 
   стипендиального фонда / 15.0"	199	198	1	453	408	45
Смоленская область	Государственные, муниципальные (без учета организаций в ведении ФСИН); Очная	"   именные стипендии, учрежденные: 
   органами государственной власти субъекта Российской Федерации / 5.0"	0	0	0	4	3	1
Смоленская область	Государственные, муниципальные (без учета организаций в ведении ФСИН); Очная	   именные стипендии, учрежденные: органами местного самоуправления / 6.0	0	0	0	0	0	0
Смоленская область	Государственные, муниципальные (без учета организаций в ведении ФСИН); Очная	   именные стипендии, учрежденные: федеральными государственными органами / 4.0	0	0	0	0	0	0
Смоленская область	Государственные, муниципальные (без учета организаций в ведении ФСИН); Очная	   именные стипендии, учрежденные: физическими лицами / 9.0	0	0	0	0	0	0
Смоленская область	Государственные, муниципальные (без учета организаций в ведении ФСИН); Очная	   именные стипендии, учрежденные: юридическими лицами / 7.0	0	0	0	12	12	0
Смоленская область	Государственные, муниципальные (без учета организаций в ведении ФСИН); Очная	   полученных от приносящей доход деятельности / 17.0	0	0	0	132	124	8
Смоленская область	Государственные, муниципальные (без учета организаций в ведении ФСИН); Очная	   стипендии Правительства Российской Федерации / 3.0	5	5	0	14	12	2
Смоленская область	Государственные, муниципальные (без учета организаций в ведении ФСИН); Очная	"   стипендии, назначенные физическими лицами (кроме именных,
   указанных в строке 09) / 12.0"	0	0	0	0	0	0
Смоленская область	Государственные, муниципальные (без учета организаций в ведении ФСИН); Очная	"   стипендии, назначенные юридическими лицами (кроме именных,
   указанных в строке 07) / 10.0"	7	7	0	10	10	0
Смоленская область	Государственные, муниципальные (без учета организаций в ведении ФСИН); Очная	Численность студентов, получающих другие формы материальной поддержки / 14.0	291	290	1	1101	867	234
Смоленская область	Государственные, муниципальные (без учета организаций в ведении ФСИН); Очная	Численность студентов, получающих: государственные академические стипендии / 1.0	1730	1654	76	5582	4770	812
Смоленская область	Частные; Очная	      в том числе студентам, направленным ими на обучение / 11.0	0	0	0	0	0	0
Смоленская область	Частные; Очная	      в том числе студентам, направленным ими на обучение / 13.0	0	0	0	0	0	0
Смоленская область	Частные; Очная	      из них организацией, студентами которой они являются / 8.0	0	0	0	0	0	0
Смоленская область	Частные; Очная	   бюджетных ассигнований бюджета субъекта Российской Федерации / 16.0	0	0	0	11	11	0
Смоленская область	Частные; Очная	   государственные социальные стипендии / 2.0	0	0	0	0	0	0
Смоленская область	Частные; Очная	"   из них за счет средств: 
   стипендиального фонда / 15.0"	0	0	0	0	0	0
Смоленская область	Частные; Очная	"   именные стипендии, учрежденные: 
   органами государственной власти субъекта Российской Федерации / 5.0"	0	0	0	0	0	0
Смоленская область	Частные; Очная	   именные стипендии, учрежденные: органами местного самоуправления / 6.0	0	0	0	0	0	0
Смоленская область	Частные; Очная	   именные стипендии, учрежденные: федеральными государственными органами / 4.0	0	0	0	0	0	0
Смоленская область	Частные; Очная	   именные стипендии, учрежденные: физическими лицами / 9.0	0	0	0	0	0	0
Смоленская область	Частные; Очная	   именные стипендии, учрежденные: юридическими лицами / 7.0	0	0	0	0	0	0
Смоленская область	Частные; Очная	   полученных от приносящей доход деятельности / 17.0	0	0	0	0	0	0
Смоленская область	Частные; Очная	   стипендии Правительства Российской Федерации / 3.0	0	0	0	0	0	0
Смоленская область	Частные; Очная	"   стипендии, назначенные физическими лицами (кроме именных,
   указанных в строке 09) / 12.0"	0	0	0	0	0	0
Смоленская область	Частные; Очная	"   стипендии, назначенные юридическими лицами (кроме именных,
   указанных в строке 07) / 10.0"	0	0	0	0	0	0
Смоленская область	Частные; Очная	Численность студентов, получающих другие формы материальной поддержки / 14.0	0	0	0	11	11	0
Смоленская область	Частные; Очная	Численность студентов, получающих: государственные академические стипендии / 1.0	0	0	0	0	0	0
Ставропольский край	Государственные, муниципальные (без учета организаций в ведении ФСИН); Очная	      в том числе студентам, направленным ими на обучение / 11.0	0	0	0	280	269	11
Ставропольский край	Государственные, муниципальные (без учета организаций в ведении ФСИН); Очная	      в том числе студентам, направленным ими на обучение / 13.0	0	0	0	0	0	0
Ставропольский край	Государственные, муниципальные (без учета организаций в ведении ФСИН); Очная	      из них организацией, студентами которой они являются / 8.0	2	2	0	27	27	0
Ставропольский край	Государственные, муниципальные (без учета организаций в ведении ФСИН); Очная	   бюджетных ассигнований бюджета субъекта Российской Федерации / 16.0	62	62	0	254	253	1
Ставропольский край	Государственные, муниципальные (без учета организаций в ведении ФСИН); Очная	   государственные социальные стипендии / 2.0	706	686	20	2519	2185	334
Ставропольский край	Государственные, муниципальные (без учета организаций в ведении ФСИН); Очная	"   из них за счет средств: 
   стипендиального фонда / 15.0"	0	0	0	65	63	2
Ставропольский край	Государственные, муниципальные (без учета организаций в ведении ФСИН); Очная	"   именные стипендии, учрежденные: 
   органами государственной власти субъекта Российской Федерации / 5.0"	0	0	0	15	14	1
Ставропольский край	Государственные, муниципальные (без учета организаций в ведении ФСИН); Очная	   именные стипендии, учрежденные: органами местного самоуправления / 6.0	1	1	0	13	12	1
Ставропольский край	Государственные, муниципальные (без учета организаций в ведении ФСИН); Очная	   именные стипендии, учрежденные: федеральными государственными органами / 4.0	0	0	0	1	1	0
Ставропольский край	Государственные, муниципальные (без учета организаций в ведении ФСИН); Очная	   именные стипендии, учрежденные: физическими лицами / 9.0	0	0	0	0	0	0
Ставропольский край	Государственные, муниципальные (без учета организаций в ведении ФСИН); Очная	   именные стипендии, учрежденные: юридическими лицами / 7.0	2	2	0	40	40	0
Ставропольский край	Государственные, муниципальные (без учета организаций в ведении ФСИН); Очная	   полученных от приносящей доход деятельности / 17.0	0	0	0	24	24	0
Ставропольский край	Государственные, муниципальные (без учета организаций в ведении ФСИН); Очная	   стипендии Правительства Российской Федерации / 3.0	20	19	1	65	60	5
Ставропольский край	Государственные, муниципальные (без учета организаций в ведении ФСИН); Очная	"   стипендии, назначенные физическими лицами (кроме именных,
   указанных в строке 09) / 12.0"	0	0	0	0	0	0
Ставропольский край	Государственные, муниципальные (без учета организаций в ведении ФСИН); Очная	"   стипендии, назначенные юридическими лицами (кроме именных,
   указанных в строке 07) / 10.0"	0	0	0	331	289	42
Ставропольский край	Государственные, муниципальные (без учета организаций в ведении ФСИН); Очная	Численность студентов, получающих другие формы материальной поддержки / 14.0	72	72	0	362	359	3
Ставропольский край	Государственные, муниципальные (без учета организаций в ведении ФСИН); Очная	Численность студентов, получающих: государственные академические стипендии / 1.0	3790	3613	177	20670	18967	1703
Ставропольский край	Частные; Очная	      в том числе студентам, направленным ими на обучение / 11.0	0	0	0	0	0	0
Ставропольский край	Частные; Очная	      в том числе студентам, направленным ими на обучение / 13.0	0	0	0	0	0	0
Ставропольский край	Частные; Очная	      из них организацией, студентами которой они являются / 8.0	0	0	0	0	0	0
Ставропольский край	Частные; Очная	   бюджетных ассигнований бюджета субъекта Российской Федерации / 16.0	0	0	0	1	1	0
Ставропольский край	Частные; Очная	   государственные социальные стипендии / 2.0	0	0	0	8	8	0
Ставропольский край	Частные; Очная	"   из них за счет средств: 
   стипендиального фонда / 15.0"	0	0	0	0	0	0
Ставропольский край	Частные; Очная	"   именные стипендии, учрежденные: 
   органами государственной власти субъекта Российской Федерации / 5.0"	0	0	0	2	1	1
Ставропольский край	Частные; Очная	   именные стипендии, учрежденные: органами местного самоуправления / 6.0	0	0	0	1	1	0
Ставропольский край	Частные; Очная	   именные стипендии, учрежденные: федеральными государственными органами / 4.0	0	0	0	4	4	0
Ставропольский край	Частные; Очная	   именные стипендии, учрежденные: физическими лицами / 9.0	0	0	0	0	0	0
Ставропольский край	Частные; Очная	   именные стипендии, учрежденные: юридическими лицами / 7.0	0	0	0	0	0	0
Ставропольский край	Частные; Очная	   полученных от приносящей доход деятельности / 17.0	0	0	0	2	1	1
Ставропольский край	Частные; Очная	   стипендии Правительства Российской Федерации / 3.0	0	0	0	0	0	0
Ставропольский край	Частные; Очная	"   стипендии, назначенные физическими лицами (кроме именных,
   указанных в строке 09) / 12.0"	0	0	0	0	0	0
Ставропольский край	Частные; Очная	"   стипендии, назначенные юридическими лицами (кроме именных,
   указанных в строке 07) / 10.0"	0	0	0	0	0	0
Ставропольский край	Частные; Очная	Численность студентов, получающих другие формы материальной поддержки / 14.0	0	0	0	3	2	1
Ставропольский край	Частные; Очная	Численность студентов, получающих: государственные академические стипендии / 1.0	0	0	0	112	112	0
Тамбовская область	Государственные, муниципальные (без учета организаций в ведении ФСИН); Очная	      в том числе студентам, направленным ими на обучение / 11.0	0	0	0	36	36	0
Тамбовская область	Государственные, муниципальные (без учета организаций в ведении ФСИН); Очная	      в том числе студентам, направленным ими на обучение / 13.0	0	0	0	0	0	0
Тамбовская область	Государственные, муниципальные (без учета организаций в ведении ФСИН); Очная	      из них организацией, студентами которой они являются / 8.0	0	0	0	7	7	0
Тамбовская область	Государственные, муниципальные (без учета организаций в ведении ФСИН); Очная	   бюджетных ассигнований бюджета субъекта Российской Федерации / 16.0	0	0	0	22	22	0
Тамбовская область	Государственные, муниципальные (без учета организаций в ведении ФСИН); Очная	   государственные социальные стипендии / 2.0	688	686	2	2215	2152	63
Тамбовская область	Государственные, муниципальные (без учета организаций в ведении ФСИН); Очная	"   из них за счет средств: 
   стипендиального фонда / 15.0"	417	417	0	2611	2390	221
Тамбовская область	Государственные, муниципальные (без учета организаций в ведении ФСИН); Очная	"   именные стипендии, учрежденные: 
   органами государственной власти субъекта Российской Федерации / 5.0"	0	0	0	2	2	0
Тамбовская область	Государственные, муниципальные (без учета организаций в ведении ФСИН); Очная	   именные стипендии, учрежденные: органами местного самоуправления / 6.0	0	0	0	43	3	40
Тамбовская область	Государственные, муниципальные (без учета организаций в ведении ФСИН); Очная	   именные стипендии, учрежденные: федеральными государственными органами / 4.0	0	0	0	0	0	0
Тамбовская область	Государственные, муниципальные (без учета организаций в ведении ФСИН); Очная	   именные стипендии, учрежденные: физическими лицами / 9.0	0	0	0	0	0	0
Тамбовская область	Государственные, муниципальные (без учета организаций в ведении ФСИН); Очная	   именные стипендии, учрежденные: юридическими лицами / 7.0	0	0	0	12	10	2
Тамбовская область	Государственные, муниципальные (без учета организаций в ведении ФСИН); Очная	   полученных от приносящей доход деятельности / 17.0	0	0	0	39	39	0
Тамбовская область	Государственные, муниципальные (без учета организаций в ведении ФСИН); Очная	   стипендии Правительства Российской Федерации / 3.0	8	8	0	36	34	2
Тамбовская область	Государственные, муниципальные (без учета организаций в ведении ФСИН); Очная	"   стипендии, назначенные физическими лицами (кроме именных,
   указанных в строке 09) / 12.0"	0	0	0	0	0	0
Тамбовская область	Государственные, муниципальные (без учета организаций в ведении ФСИН); Очная	"   стипендии, назначенные юридическими лицами (кроме именных,
   указанных в строке 07) / 10.0"	0	0	0	36	36	0
Тамбовская область	Государственные, муниципальные (без учета организаций в ведении ФСИН); Очная	Численность студентов, получающих другие формы материальной поддержки / 14.0	425	425	0	2728	2507	221
Тамбовская область	Государственные, муниципальные (без учета организаций в ведении ФСИН); Очная	Численность студентов, получающих: государственные академические стипендии / 1.0	2245	2209	36	8291	7886	405
Тверская область	Государственные, муниципальные (без учета организаций в ведении ФСИН); Очная	      в том числе студентам, направленным ими на обучение / 11.0	0	0	0	55	33	22
Тверская область	Государственные, муниципальные (без учета организаций в ведении ФСИН); Очная	      в том числе студентам, направленным ими на обучение / 13.0	0	0	0	0	0	0
Тверская область	Государственные, муниципальные (без учета организаций в ведении ФСИН); Очная	      из них организацией, студентами которой они являются / 8.0	0	0	0	0	0	0
Тверская область	Государственные, муниципальные (без учета организаций в ведении ФСИН); Очная	   бюджетных ассигнований бюджета субъекта Российской Федерации / 16.0	92	75	17	239	197	42
Тверская область	Государственные, муниципальные (без учета организаций в ведении ФСИН); Очная	   государственные социальные стипендии / 2.0	427	398	29	921	809	112
Тверская область	Государственные, муниципальные (без учета организаций в ведении ФСИН); Очная	"   из них за счет средств: 
   стипендиального фонда / 15.0"	81	78	3	172	157	15
Тверская область	Государственные, муниципальные (без учета организаций в ведении ФСИН); Очная	"   именные стипендии, учрежденные: 
   органами государственной власти субъекта Российской Федерации / 5.0"	0	0	0	0	0	0
Тверская область	Государственные, муниципальные (без учета организаций в ведении ФСИН); Очная	   именные стипендии, учрежденные: органами местного самоуправления / 6.0	0	0	0	2	2	0
Тверская область	Государственные, муниципальные (без учета организаций в ведении ФСИН); Очная	   именные стипендии, учрежденные: федеральными государственными органами / 4.0	0	0	0	10	10	0
Тверская область	Государственные, муниципальные (без учета организаций в ведении ФСИН); Очная	   именные стипендии, учрежденные: физическими лицами / 9.0	0	0	0	0	0	0
Тверская область	Государственные, муниципальные (без учета организаций в ведении ФСИН); Очная	   именные стипендии, учрежденные: юридическими лицами / 7.0	0	0	0	0	0	0
Тверская область	Государственные, муниципальные (без учета организаций в ведении ФСИН); Очная	   полученных от приносящей доход деятельности / 17.0	0	0	0	0	0	0
Тверская область	Государственные, муниципальные (без учета организаций в ведении ФСИН); Очная	   стипендии Правительства Российской Федерации / 3.0	6	6	0	24	24	0
Тверская область	Государственные, муниципальные (без учета организаций в ведении ФСИН); Очная	"   стипендии, назначенные физическими лицами (кроме именных,
   указанных в строке 09) / 12.0"	0	0	0	0	0	0
Тверская область	Государственные, муниципальные (без учета организаций в ведении ФСИН); Очная	"   стипендии, назначенные юридическими лицами (кроме именных,
   указанных в строке 07) / 10.0"	0	0	0	55	33	22
Тверская область	Государственные, муниципальные (без учета организаций в ведении ФСИН); Очная	Численность студентов, получающих другие формы материальной поддержки / 14.0	173	153	20	420	363	57
Тверская область	Государственные, муниципальные (без учета организаций в ведении ФСИН); Очная	Численность студентов, получающих: государственные академические стипендии / 1.0	2178	2126	52	7957	6982	975
Томская область	Государственные, муниципальные (без учета организаций в ведении ФСИН); Очная	      в том числе студентам, направленным ими на обучение / 11.0	0	0	0	55	55	0
Томская область	Государственные, муниципальные (без учета организаций в ведении ФСИН); Очная	      в том числе студентам, направленным ими на обучение / 13.0	0	0	0	0	0	0
Томская область	Государственные, муниципальные (без учета организаций в ведении ФСИН); Очная	      из них организацией, студентами которой они являются / 8.0	1	1	0	6	6	0
Томская область	Государственные, муниципальные (без учета организаций в ведении ФСИН); Очная	   бюджетных ассигнований бюджета субъекта Российской Федерации / 16.0	183	179	4	361	271	90
Томская область	Государственные, муниципальные (без учета организаций в ведении ФСИН); Очная	   государственные социальные стипендии / 2.0	740	736	4	2044	1576	468
Томская область	Государственные, муниципальные (без учета организаций в ведении ФСИН); Очная	"   из них за счет средств: 
   стипендиального фонда / 15.0"	43	43	0	774	587	187
Томская область	Государственные, муниципальные (без учета организаций в ведении ФСИН); Очная	"   именные стипендии, учрежденные: 
   органами государственной власти субъекта Российской Федерации / 5.0"	0	0	0	0	0	0
Томская область	Государственные, муниципальные (без учета организаций в ведении ФСИН); Очная	   именные стипендии, учрежденные: органами местного самоуправления / 6.0	0	0	0	20	15	5
Томская область	Государственные, муниципальные (без учета организаций в ведении ФСИН); Очная	   именные стипендии, учрежденные: федеральными государственными органами / 4.0	0	0	0	0	0	0
Томская область	Государственные, муниципальные (без учета организаций в ведении ФСИН); Очная	   именные стипендии, учрежденные: физическими лицами / 9.0	0	0	0	0	0	0
Томская область	Государственные, муниципальные (без учета организаций в ведении ФСИН); Очная	   именные стипендии, учрежденные: юридическими лицами / 7.0	1	1	0	20	11	9
Томская область	Государственные, муниципальные (без учета организаций в ведении ФСИН); Очная	   полученных от приносящей доход деятельности / 17.0	0	0	0	69	58	11
Томская область	Государственные, муниципальные (без учета организаций в ведении ФСИН); Очная	   стипендии Правительства Российской Федерации / 3.0	15	15	0	34	29	5
Томская область	Государственные, муниципальные (без учета организаций в ведении ФСИН); Очная	"   стипендии, назначенные физическими лицами (кроме именных,
   указанных в строке 09) / 12.0"	0	0	0	0	0	0
Томская область	Государственные, муниципальные (без учета организаций в ведении ФСИН); Очная	"   стипендии, назначенные юридическими лицами (кроме именных,
   указанных в строке 07) / 10.0"	0	0	0	55	55	0
Томская область	Государственные, муниципальные (без учета организаций в ведении ФСИН); Очная	Численность студентов, получающих другие формы материальной поддержки / 14.0	257	253	4	967	742	225
Томская область	Государственные, муниципальные (без учета организаций в ведении ФСИН); Очная	Численность студентов, получающих: государственные академические стипендии / 1.0	2099	1981	118	9263	6899	2364
Томская область	Частные; Очная	      в том числе студентам, направленным ими на обучение / 11.0	0	0	0	0	0	0
Томская область	Частные; Очная	      в том числе студентам, направленным ими на обучение / 13.0	0	0	0	0	0	0
Томская область	Частные; Очная	      из них организацией, студентами которой они являются / 8.0	0	0	0	0	0	0
Томская область	Частные; Очная	   бюджетных ассигнований бюджета субъекта Российской Федерации / 16.0	0	0	0	0	0	0
Томская область	Частные; Очная	   государственные социальные стипендии / 2.0	0	0	0	0	0	0
Томская область	Частные; Очная	"   из них за счет средств: 
   стипендиального фонда / 15.0"	0	0	0	0	0	0
Томская область	Частные; Очная	"   именные стипендии, учрежденные: 
   органами государственной власти субъекта Российской Федерации / 5.0"	0	0	0	0	0	0
Томская область	Частные; Очная	   именные стипендии, учрежденные: органами местного самоуправления / 6.0	0	0	0	0	0	0
Томская область	Частные; Очная	   именные стипендии, учрежденные: федеральными государственными органами / 4.0	0	0	0	0	0	0
Томская область	Частные; Очная	   именные стипендии, учрежденные: физическими лицами / 9.0	0	0	0	0	0	0
Томская область	Частные; Очная	   именные стипендии, учрежденные: юридическими лицами / 7.0	0	0	0	0	0	0
Томская область	Частные; Очная	   полученных от приносящей доход деятельности / 17.0	0	0	0	0	0	0
Томская область	Частные; Очная	   стипендии Правительства Российской Федерации / 3.0	0	0	0	0	0	0
Томская область	Частные; Очная	"   стипендии, назначенные физическими лицами (кроме именных,
   указанных в строке 09) / 12.0"	0	0	0	0	0	0
Томская область	Частные; Очная	"   стипендии, назначенные юридическими лицами (кроме именных,
   указанных в строке 07) / 10.0"	0	0	0	0	0	0
Томская область	Частные; Очная	Численность студентов, получающих другие формы материальной поддержки / 14.0	0	0	0	0	0	0
Томская область	Частные; Очная	Численность студентов, получающих: государственные академические стипендии / 1.0	0	0	0	0	0	0
Тульская область	Государственные, муниципальные (без учета организаций в ведении ФСИН); Очная	      в том числе студентам, направленным ими на обучение / 11.0	0	0	0	0	0	0
Тульская область	Государственные, муниципальные (без учета организаций в ведении ФСИН); Очная	      в том числе студентам, направленным ими на обучение / 13.0	0	0	0	0	0	0
Тульская область	Государственные, муниципальные (без учета организаций в ведении ФСИН); Очная	      из них организацией, студентами которой они являются / 8.0	0	0	0	2	2	0
Тульская область	Государственные, муниципальные (без учета организаций в ведении ФСИН); Очная	   бюджетных ассигнований бюджета субъекта Российской Федерации / 16.0	86	86	0	344	339	5
Тульская область	Государственные, муниципальные (без учета организаций в ведении ФСИН); Очная	   государственные социальные стипендии / 2.0	2524	2507	17	7179	6730	449
Тульская область	Государственные, муниципальные (без учета организаций в ведении ФСИН); Очная	"   из них за счет средств: 
   стипендиального фонда / 15.0"	0	0	0	153	153	0
Тульская область	Государственные, муниципальные (без учета организаций в ведении ФСИН); Очная	"   именные стипендии, учрежденные: 
   органами государственной власти субъекта Российской Федерации / 5.0"	1	1	0	5	5	0
Тульская область	Государственные, муниципальные (без учета организаций в ведении ФСИН); Очная	   именные стипендии, учрежденные: органами местного самоуправления / 6.0	0	0	0	1	1	0
Тульская область	Государственные, муниципальные (без учета организаций в ведении ФСИН); Очная	   именные стипендии, учрежденные: федеральными государственными органами / 4.0	0	0	0	7	7	0
Тульская область	Государственные, муниципальные (без учета организаций в ведении ФСИН); Очная	   именные стипендии, учрежденные: физическими лицами / 9.0	0	0	0	1	1	0
Тульская область	Государственные, муниципальные (без учета организаций в ведении ФСИН); Очная	   именные стипендии, учрежденные: юридическими лицами / 7.0	0	0	0	19	19	0
Тульская область	Государственные, муниципальные (без учета организаций в ведении ФСИН); Очная	   полученных от приносящей доход деятельности / 17.0	1	1	0	21	21	0
Тульская область	Государственные, муниципальные (без учета организаций в ведении ФСИН); Очная	   стипендии Правительства Российской Федерации / 3.0	15	15	0	38	34	4
Тульская область	Государственные, муниципальные (без учета организаций в ведении ФСИН); Очная	"   стипендии, назначенные физическими лицами (кроме именных,
   указанных в строке 09) / 12.0"	0	0	0	0	0	0
Тульская область	Государственные, муниципальные (без учета организаций в ведении ФСИН); Очная	"   стипендии, назначенные юридическими лицами (кроме именных,
   указанных в строке 07) / 10.0"	0	0	0	14	14	0
Тульская область	Государственные, муниципальные (без учета организаций в ведении ФСИН); Очная	Численность студентов, получающих другие формы материальной поддержки / 14.0	110	110	0	580	568	12
Тульская область	Государственные, муниципальные (без учета организаций в ведении ФСИН); Очная	Численность студентов, получающих: государственные академические стипендии / 1.0	4064	4023	41	11340	10423	917
Тюменская область	Государственные, муниципальные (без учета организаций в ведении ФСИН); Очная	      в том числе студентам, направленным ими на обучение / 11.0	0	0	0	0	0	0
Тюменская область	Государственные, муниципальные (без учета организаций в ведении ФСИН); Очная	      в том числе студентам, направленным ими на обучение / 13.0	0	0	0	0	0	0
Тюменская область	Государственные, муниципальные (без учета организаций в ведении ФСИН); Очная	      из них организацией, студентами которой они являются / 8.0	0	0	0	23	18	5
Тюменская область	Государственные, муниципальные (без учета организаций в ведении ФСИН); Очная	   бюджетных ассигнований бюджета субъекта Российской Федерации / 16.0	75	54	21	738	568	170
Тюменская область	Государственные, муниципальные (без учета организаций в ведении ФСИН); Очная	   государственные социальные стипендии / 2.0	747	624	123	1706	912	794
Тюменская область	Государственные, муниципальные (без учета организаций в ведении ФСИН); Очная	"   из них за счет средств: 
   стипендиального фонда / 15.0"	1778	1325	453	3762	1315	2447
Тюменская область	Государственные, муниципальные (без учета организаций в ведении ФСИН); Очная	"   именные стипендии, учрежденные: 
   органами государственной власти субъекта Российской Федерации / 5.0"	8	7	1	19	9	10
Тюменская область	Государственные, муниципальные (без учета организаций в ведении ФСИН); Очная	   именные стипендии, учрежденные: органами местного самоуправления / 6.0	0	0	0	1	1	0
Тюменская область	Государственные, муниципальные (без учета организаций в ведении ФСИН); Очная	   именные стипендии, учрежденные: федеральными государственными органами / 4.0	1	1	0	2	2	0
Тюменская область	Государственные, муниципальные (без учета организаций в ведении ФСИН); Очная	   именные стипендии, учрежденные: физическими лицами / 9.0	0	0	0	0	0	0
Тюменская область	Государственные, муниципальные (без учета организаций в ведении ФСИН); Очная	   именные стипендии, учрежденные: юридическими лицами / 7.0	2	2	0	26	20	6
Тюменская область	Государственные, муниципальные (без учета организаций в ведении ФСИН); Очная	   полученных от приносящей доход деятельности / 17.0	20	20	0	177	41	136
Тюменская область	Государственные, муниципальные (без учета организаций в ведении ФСИН); Очная	   стипендии Правительства Российской Федерации / 3.0	19	19	0	87	61	26
Тюменская область	Государственные, муниципальные (без учета организаций в ведении ФСИН); Очная	"   стипендии, назначенные физическими лицами (кроме именных,
   указанных в строке 09) / 12.0"	0	0	0	0	0	0
Тюменская область	Государственные, муниципальные (без учета организаций в ведении ФСИН); Очная	"   стипендии, назначенные юридическими лицами (кроме именных,
   указанных в строке 07) / 10.0"	0	0	0	0	0	0
Тюменская область	Государственные, муниципальные (без учета организаций в ведении ФСИН); Очная	Численность студентов, получающих другие формы материальной поддержки / 14.0	1862	1407	455	4473	1851	2622
Тюменская область	Государственные, муниципальные (без учета организаций в ведении ФСИН); Очная	Численность студентов, получающих: государственные академические стипендии / 1.0	5306	3963	1343	14440	6912	7528
Тюменская область	Частные; Очная	      в том числе студентам, направленным ими на обучение / 11.0	0	0	0	0	0	0
Тюменская область	Частные; Очная	      в том числе студентам, направленным ими на обучение / 13.0	0	0	0	0	0	0
Тюменская область	Частные; Очная	      из них организацией, студентами которой они являются / 8.0	0	0	0	0	0	0
Тюменская область	Частные; Очная	   бюджетных ассигнований бюджета субъекта Российской Федерации / 16.0	0	0	0	14	8	6
Тюменская область	Частные; Очная	   государственные социальные стипендии / 2.0	0	0	0	10	6	4
Тюменская область	Частные; Очная	"   из них за счет средств: 
   стипендиального фонда / 15.0"	0	0	0	0	0	0
Тюменская область	Частные; Очная	"   именные стипендии, учрежденные: 
   органами государственной власти субъекта Российской Федерации / 5.0"	0	0	0	2	2	0
Тюменская область	Частные; Очная	   именные стипендии, учрежденные: органами местного самоуправления / 6.0	0	0	0	0	0	0
Тюменская область	Частные; Очная	   именные стипендии, учрежденные: федеральными государственными органами / 4.0	0	0	0	0	0	0
Тюменская область	Частные; Очная	   именные стипендии, учрежденные: физическими лицами / 9.0	0	0	0	0	0	0
Тюменская область	Частные; Очная	   именные стипендии, учрежденные: юридическими лицами / 7.0	0	0	0	4	1	3
Тюменская область	Частные; Очная	   полученных от приносящей доход деятельности / 17.0	0	0	0	0	0	0
Тюменская область	Частные; Очная	   стипендии Правительства Российской Федерации / 3.0	0	0	0	1	1	0
Тюменская область	Частные; Очная	"   стипендии, назначенные физическими лицами (кроме именных,
   указанных в строке 09) / 12.0"	0	0	0	0	0	0
Тюменская область	Частные; Очная	"   стипендии, назначенные юридическими лицами (кроме именных,
   указанных в строке 07) / 10.0"	0	0	0	0	0	0
Тюменская область	Частные; Очная	Численность студентов, получающих другие формы материальной поддержки / 14.0	0	0	0	14	8	6
Тюменская область	Частные; Очная	Численность студентов, получающих: государственные академические стипендии / 1.0	75	0	75	315	149	166
Удмуртская Республика	Государственные, муниципальные (без учета организаций в ведении ФСИН); Очная	      в том числе студентам, направленным ими на обучение / 11.0	0	0	0	22	22	0
Удмуртская Республика	Государственные, муниципальные (без учета организаций в ведении ФСИН); Очная	      в том числе студентам, направленным ими на обучение / 13.0	0	0	0	6	6	0
Удмуртская Республика	Государственные, муниципальные (без учета организаций в ведении ФСИН); Очная	      из них организацией, студентами которой они являются / 8.0	0	0	0	3	3	0
Удмуртская Республика	Государственные, муниципальные (без учета организаций в ведении ФСИН); Очная	   бюджетных ассигнований бюджета субъекта Российской Федерации / 16.0	446	446	0	426	363	63
Удмуртская Республика	Государственные, муниципальные (без учета организаций в ведении ФСИН); Очная	   государственные социальные стипендии / 2.0	1195	1194	1	2502	2382	120
Удмуртская Республика	Государственные, муниципальные (без учета организаций в ведении ФСИН); Очная	"   из них за счет средств: 
   стипендиального фонда / 15.0"	313	313	0	718	686	32
Удмуртская Республика	Государственные, муниципальные (без учета организаций в ведении ФСИН); Очная	"   именные стипендии, учрежденные: 
   органами государственной власти субъекта Российской Федерации / 5.0"	11	11	0	42	42	0
Удмуртская Республика	Государственные, муниципальные (без учета организаций в ведении ФСИН); Очная	   именные стипендии, учрежденные: органами местного самоуправления / 6.0	0	0	0	5	4	1
Удмуртская Республика	Государственные, муниципальные (без учета организаций в ведении ФСИН); Очная	   именные стипендии, учрежденные: федеральными государственными органами / 4.0	0	0	0	1	1	0
Удмуртская Республика	Государственные, муниципальные (без учета организаций в ведении ФСИН); Очная	   именные стипендии, учрежденные: физическими лицами / 9.0	1	1	0	1	1	0
Удмуртская Республика	Государственные, муниципальные (без учета организаций в ведении ФСИН); Очная	   именные стипендии, учрежденные: юридическими лицами / 7.0	9	9	0	10	10	0
Удмуртская Республика	Государственные, муниципальные (без учета организаций в ведении ФСИН); Очная	   полученных от приносящей доход деятельности / 17.0	155	155	0	516	470	46
Удмуртская Республика	Государственные, муниципальные (без учета организаций в ведении ФСИН); Очная	   стипендии Правительства Российской Федерации / 3.0	4	4	0	16	16	0
Удмуртская Республика	Государственные, муниципальные (без учета организаций в ведении ФСИН); Очная	"   стипендии, назначенные физическими лицами (кроме именных,
   указанных в строке 09) / 12.0"	0	0	0	6	6	0
Удмуртская Республика	Государственные, муниципальные (без учета организаций в ведении ФСИН); Очная	"   стипендии, назначенные юридическими лицами (кроме именных,
   указанных в строке 07) / 10.0"	119	119	0	67	67	0
Удмуртская Республика	Государственные, муниципальные (без учета организаций в ведении ФСИН); Очная	Численность студентов, получающих другие формы материальной поддержки / 14.0	665	665	0	1668	1517	151
Удмуртская Республика	Государственные, муниципальные (без учета организаций в ведении ФСИН); Очная	Численность студентов, получающих: государственные академические стипендии / 1.0	5457	5429	28	10790	9699	1091
Удмуртская Республика	Частные; Очная	      в том числе студентам, направленным ими на обучение / 11.0	0	0	0	0	0	0
Удмуртская Республика	Частные; Очная	      в том числе студентам, направленным ими на обучение / 13.0	0	0	0	0	0	0
Удмуртская Республика	Частные; Очная	      из них организацией, студентами которой они являются / 8.0	0	0	0	5	5	0
Удмуртская Республика	Частные; Очная	   бюджетных ассигнований бюджета субъекта Российской Федерации / 16.0	0	0	0	1	1	0
Удмуртская Республика	Частные; Очная	   государственные социальные стипендии / 2.0	0	0	0	11	11	0
Удмуртская Республика	Частные; Очная	"   из них за счет средств: 
   стипендиального фонда / 15.0"	0	0	0	0	0	0
Удмуртская Республика	Частные; Очная	"   именные стипендии, учрежденные: 
   органами государственной власти субъекта Российской Федерации / 5.0"	0	0	0	0	0	0
Удмуртская Республика	Частные; Очная	   именные стипендии, учрежденные: органами местного самоуправления / 6.0	0	0	0	0	0	0
Удмуртская Республика	Частные; Очная	   именные стипендии, учрежденные: федеральными государственными органами / 4.0	0	0	0	0	0	0
Удмуртская Республика	Частные; Очная	   именные стипендии, учрежденные: физическими лицами / 9.0	0	0	0	0	0	0
Удмуртская Республика	Частные; Очная	   именные стипендии, учрежденные: юридическими лицами / 7.0	0	0	0	5	5	0
Удмуртская Республика	Частные; Очная	   полученных от приносящей доход деятельности / 17.0	0	0	0	0	0	0
Удмуртская Республика	Частные; Очная	   стипендии Правительства Российской Федерации / 3.0	0	0	0	0	0	0
Удмуртская Республика	Частные; Очная	"   стипендии, назначенные физическими лицами (кроме именных,
   указанных в строке 09) / 12.0"	0	0	0	0	0	0
Удмуртская Республика	Частные; Очная	"   стипендии, назначенные юридическими лицами (кроме именных,
   указанных в строке 07) / 10.0"	0	0	0	0	0	0
Удмуртская Республика	Частные; Очная	Численность студентов, получающих другие формы материальной поддержки / 14.0	0	0	0	1	1	0
Удмуртская Республика	Частные; Очная	Численность студентов, получающих: государственные академические стипендии / 1.0	25	25	0	123	123	0
Ульяновская область	Государственные, муниципальные (без учета организаций в ведении ФСИН); Очная	      в том числе студентам, направленным ими на обучение / 11.0	0	0	0	0	0	0
Ульяновская область	Государственные, муниципальные (без учета организаций в ведении ФСИН); Очная	      в том числе студентам, направленным ими на обучение / 13.0	0	0	0	0	0	0
Ульяновская область	Государственные, муниципальные (без учета организаций в ведении ФСИН); Очная	      из них организацией, студентами которой они являются / 8.0	0	0	0	4	4	0
Ульяновская область	Государственные, муниципальные (без учета организаций в ведении ФСИН); Очная	   бюджетных ассигнований бюджета субъекта Российской Федерации / 16.0	3	3	0	38	38	0
Ульяновская область	Государственные, муниципальные (без учета организаций в ведении ФСИН); Очная	   государственные социальные стипендии / 2.0	654	605	49	1800	1515	285
Ульяновская область	Государственные, муниципальные (без учета организаций в ведении ФСИН); Очная	"   из них за счет средств: 
   стипендиального фонда / 15.0"	16	16	0	559	450	109
Ульяновская область	Государственные, муниципальные (без учета организаций в ведении ФСИН); Очная	"   именные стипендии, учрежденные: 
   органами государственной власти субъекта Российской Федерации / 5.0"	0	0	0	4	4	0
Ульяновская область	Государственные, муниципальные (без учета организаций в ведении ФСИН); Очная	   именные стипендии, учрежденные: органами местного самоуправления / 6.0	0	0	0	0	0	0
Ульяновская область	Государственные, муниципальные (без учета организаций в ведении ФСИН); Очная	   именные стипендии, учрежденные: федеральными государственными органами / 4.0	0	0	0	0	0	0
Ульяновская область	Государственные, муниципальные (без учета организаций в ведении ФСИН); Очная	   именные стипендии, учрежденные: физическими лицами / 9.0	0	0	0	0	0	0
Ульяновская область	Государственные, муниципальные (без учета организаций в ведении ФСИН); Очная	   именные стипендии, учрежденные: юридическими лицами / 7.0	0	0	0	5	5	0
Ульяновская область	Государственные, муниципальные (без учета организаций в ведении ФСИН); Очная	   полученных от приносящей доход деятельности / 17.0	15	15	0	72	60	12
Ульяновская область	Государственные, муниципальные (без учета организаций в ведении ФСИН); Очная	   стипендии Правительства Российской Федерации / 3.0	4	4	0	28	28	0
Ульяновская область	Государственные, муниципальные (без учета организаций в ведении ФСИН); Очная	"   стипендии, назначенные физическими лицами (кроме именных,
   указанных в строке 09) / 12.0"	0	0	0	0	0	0
Ульяновская область	Государственные, муниципальные (без учета организаций в ведении ФСИН); Очная	"   стипендии, назначенные юридическими лицами (кроме именных,
   указанных в строке 07) / 10.0"	0	0	0	0	0	0
Ульяновская область	Государственные, муниципальные (без учета организаций в ведении ФСИН); Очная	Численность студентов, получающих другие формы материальной поддержки / 14.0	27	27	0	651	538	113
Ульяновская область	Государственные, муниципальные (без учета организаций в ведении ФСИН); Очная	Численность студентов, получающих: государственные академические стипендии / 1.0	1913	1809	104	8882	7981	901
Ульяновская область	Частные; Очная	      в том числе студентам, направленным ими на обучение / 11.0	0	0	0	0	0	0
Ульяновская область	Частные; Очная	      в том числе студентам, направленным ими на обучение / 13.0	0	0	0	0	0	0
Ульяновская область	Частные; Очная	      из них организацией, студентами которой они являются / 8.0	0	0	0	0	0	0
Ульяновская область	Частные; Очная	   бюджетных ассигнований бюджета субъекта Российской Федерации / 16.0	0	0	0	0	0	0
Ульяновская область	Частные; Очная	   государственные социальные стипендии / 2.0	0	0	0	22	22	0
Ульяновская область	Частные; Очная	"   из них за счет средств: 
   стипендиального фонда / 15.0"	0	0	0	0	0	0
Ульяновская область	Частные; Очная	"   именные стипендии, учрежденные: 
   органами государственной власти субъекта Российской Федерации / 5.0"	0	0	0	0	0	0
Ульяновская область	Частные; Очная	   именные стипендии, учрежденные: органами местного самоуправления / 6.0	0	0	0	0	0	0
Ульяновская область	Частные; Очная	   именные стипендии, учрежденные: федеральными государственными органами / 4.0	0	0	0	0	0	0
Ульяновская область	Частные; Очная	   именные стипендии, учрежденные: физическими лицами / 9.0	0	0	0	0	0	0
Ульяновская область	Частные; Очная	   именные стипендии, учрежденные: юридическими лицами / 7.0	0	0	0	0	0	0
Ульяновская область	Частные; Очная	   полученных от приносящей доход деятельности / 17.0	0	0	0	0	0	0
Ульяновская область	Частные; Очная	   стипендии Правительства Российской Федерации / 3.0	0	0	0	0	0	0
Ульяновская область	Частные; Очная	"   стипендии, назначенные физическими лицами (кроме именных,
   указанных в строке 09) / 12.0"	0	0	0	0	0	0
Ульяновская область	Частные; Очная	"   стипендии, назначенные юридическими лицами (кроме именных,
   указанных в строке 07) / 10.0"	0	0	0	0	0	0
Ульяновская область	Частные; Очная	Численность студентов, получающих другие формы материальной поддержки / 14.0	0	0	0	0	0	0
Ульяновская область	Частные; Очная	Численность студентов, получающих: государственные академические стипендии / 1.0	0	0	0	166	166	0
Хабаровский край	Государственные, муниципальные (без учета организаций в ведении ФСИН); Очная	      в том числе студентам, направленным ими на обучение / 11.0	0	0	0	28	21	7
Хабаровский край	Государственные, муниципальные (без учета организаций в ведении ФСИН); Очная	      в том числе студентам, направленным ими на обучение / 13.0	0	0	0	0	0	0
Хабаровский край	Государственные, муниципальные (без учета организаций в ведении ФСИН); Очная	      из них организацией, студентами которой они являются / 8.0	0	0	0	20	16	4
Хабаровский край	Государственные, муниципальные (без учета организаций в ведении ФСИН); Очная	   бюджетных ассигнований бюджета субъекта Российской Федерации / 16.0	3703	3702	1	1080	994	86
Хабаровский край	Государственные, муниципальные (без учета организаций в ведении ФСИН); Очная	   государственные социальные стипендии / 2.0	834	832	2	1661	1438	223
Хабаровский край	Государственные, муниципальные (без учета организаций в ведении ФСИН); Очная	"   из них за счет средств: 
   стипендиального фонда / 15.0"	89	89	0	414	285	129
Хабаровский край	Государственные, муниципальные (без учета организаций в ведении ФСИН); Очная	"   именные стипендии, учрежденные: 
   органами государственной власти субъекта Российской Федерации / 5.0"	1	1	0	28	25	3
Хабаровский край	Государственные, муниципальные (без учета организаций в ведении ФСИН); Очная	   именные стипендии, учрежденные: органами местного самоуправления / 6.0	1	1	0	10	10	0
Хабаровский край	Государственные, муниципальные (без учета организаций в ведении ФСИН); Очная	   именные стипендии, учрежденные: федеральными государственными органами / 4.0	0	0	0	0	0	0
Хабаровский край	Государственные, муниципальные (без учета организаций в ведении ФСИН); Очная	   именные стипендии, учрежденные: физическими лицами / 9.0	0	0	0	0	0	0
Хабаровский край	Государственные, муниципальные (без учета организаций в ведении ФСИН); Очная	   именные стипендии, учрежденные: юридическими лицами / 7.0	4	4	0	68	61	7
Хабаровский край	Государственные, муниципальные (без учета организаций в ведении ФСИН); Очная	   полученных от приносящей доход деятельности / 17.0	19	19	0	47	45	2
Хабаровский край	Государственные, муниципальные (без учета организаций в ведении ФСИН); Очная	   стипендии Правительства Российской Федерации / 3.0	30	30	0	64	64	0
Хабаровский край	Государственные, муниципальные (без учета организаций в ведении ФСИН); Очная	"   стипендии, назначенные физическими лицами (кроме именных,
   указанных в строке 09) / 12.0"	0	0	0	0	0	0
Хабаровский край	Государственные, муниципальные (без учета организаций в ведении ФСИН); Очная	"   стипендии, назначенные юридическими лицами (кроме именных,
   указанных в строке 07) / 10.0"	6	6	0	28	21	7
Хабаровский край	Государственные, муниципальные (без учета организаций в ведении ФСИН); Очная	Численность студентов, получающих другие формы материальной поддержки / 14.0	3939	3938	1	1573	1336	237
Хабаровский край	Государственные, муниципальные (без учета организаций в ведении ФСИН); Очная	Численность студентов, получающих: государственные академические стипендии / 1.0	3774	3699	75	10868	8431	2437
Ханты-Мансийский автономный округ	Государственные, муниципальные (без учета организаций в ведении ФСИН); Очная	      в том числе студентам, направленным ими на обучение / 11.0	0	0	0	0	0	0
Ханты-Мансийский автономный округ	Государственные, муниципальные (без учета организаций в ведении ФСИН); Очная	      в том числе студентам, направленным ими на обучение / 13.0	0	0	0	0	0	0
Ханты-Мансийский автономный округ	Государственные, муниципальные (без учета организаций в ведении ФСИН); Очная	      из них организацией, студентами которой они являются / 8.0	0	0	0	0	0	0
Ханты-Мансийский автономный округ	Государственные, муниципальные (без учета организаций в ведении ФСИН); Очная	   бюджетных ассигнований бюджета субъекта Российской Федерации / 16.0	207	189	18	533	501	32
Ханты-Мансийский автономный округ	Государственные, муниципальные (без учета организаций в ведении ФСИН); Очная	   государственные социальные стипендии / 2.0	655	642	13	1096	1016	80
Ханты-Мансийский автономный округ	Государственные, муниципальные (без учета организаций в ведении ФСИН); Очная	"   из них за счет средств: 
   стипендиального фонда / 15.0"	1035	996	39	2135	1784	351
Ханты-Мансийский автономный округ	Государственные, муниципальные (без учета организаций в ведении ФСИН); Очная	"   именные стипендии, учрежденные: 
   органами государственной власти субъекта Российской Федерации / 5.0"	7	7	0	50	47	3
Ханты-Мансийский автономный округ	Государственные, муниципальные (без учета организаций в ведении ФСИН); Очная	   именные стипендии, учрежденные: органами местного самоуправления / 6.0	0	0	0	1	1	0
Ханты-Мансийский автономный округ	Государственные, муниципальные (без учета организаций в ведении ФСИН); Очная	   именные стипендии, учрежденные: федеральными государственными органами / 4.0	7	7	0	22	21	1
Ханты-Мансийский автономный округ	Государственные, муниципальные (без учета организаций в ведении ФСИН); Очная	   именные стипендии, учрежденные: физическими лицами / 9.0	0	0	0	0	0	0
Ханты-Мансийский автономный округ	Государственные, муниципальные (без учета организаций в ведении ФСИН); Очная	   именные стипендии, учрежденные: юридическими лицами / 7.0	1	1	0	9	9	0
Ханты-Мансийский автономный округ	Государственные, муниципальные (без учета организаций в ведении ФСИН); Очная	   полученных от приносящей доход деятельности / 17.0	2	2	0	9	9	0
Ханты-Мансийский автономный округ	Государственные, муниципальные (без учета организаций в ведении ФСИН); Очная	   стипендии Правительства Российской Федерации / 3.0	11	11	0	25	24	1
Ханты-Мансийский автономный округ	Государственные, муниципальные (без учета организаций в ведении ФСИН); Очная	"   стипендии, назначенные физическими лицами (кроме именных,
   указанных в строке 09) / 12.0"	0	0	0	1	1	0
Ханты-Мансийский автономный округ	Государственные, муниципальные (без учета организаций в ведении ФСИН); Очная	"   стипендии, назначенные юридическими лицами (кроме именных,
   указанных в строке 07) / 10.0"	1	1	0	7	7	0
Ханты-Мансийский автономный округ	Государственные, муниципальные (без учета организаций в ведении ФСИН); Очная	Численность студентов, получающих другие формы материальной поддержки / 14.0	1230	1173	57	2734	2351	383
Ханты-Мансийский автономный округ	Государственные, муниципальные (без учета организаций в ведении ФСИН); Очная	Численность студентов, получающих: государственные академические стипендии / 1.0	2944	2820	124	11139	9849	1290
Ханты-Мансийский автономный округ	Частные; Очная	      в том числе студентам, направленным ими на обучение / 11.0	0	0	0	0	0	0
Ханты-Мансийский автономный округ	Частные; Очная	      в том числе студентам, направленным ими на обучение / 13.0	0	0	0	0	0	0
Ханты-Мансийский автономный округ	Частные; Очная	      из них организацией, студентами которой они являются / 8.0	0	0	0	0	0	0
Ханты-Мансийский автономный округ	Частные; Очная	   бюджетных ассигнований бюджета субъекта Российской Федерации / 16.0	0	0	0	0	0	0
Ханты-Мансийский автономный округ	Частные; Очная	   государственные социальные стипендии / 2.0	2	2	0	23	23	0
Ханты-Мансийский автономный округ	Частные; Очная	"   из них за счет средств: 
   стипендиального фонда / 15.0"	0	0	0	0	0	0
Ханты-Мансийский автономный округ	Частные; Очная	"   именные стипендии, учрежденные: 
   органами государственной власти субъекта Российской Федерации / 5.0"	0	0	0	0	0	0
Ханты-Мансийский автономный округ	Частные; Очная	   именные стипендии, учрежденные: органами местного самоуправления / 6.0	0	0	0	0	0	0
Ханты-Мансийский автономный округ	Частные; Очная	   именные стипендии, учрежденные: федеральными государственными органами / 4.0	0	0	0	0	0	0
Ханты-Мансийский автономный округ	Частные; Очная	   именные стипендии, учрежденные: физическими лицами / 9.0	0	0	0	0	0	0
Ханты-Мансийский автономный округ	Частные; Очная	   именные стипендии, учрежденные: юридическими лицами / 7.0	0	0	0	0	0	0
Ханты-Мансийский автономный округ	Частные; Очная	   полученных от приносящей доход деятельности / 17.0	0	0	0	0	0	0
Ханты-Мансийский автономный округ	Частные; Очная	   стипендии Правительства Российской Федерации / 3.0	0	0	0	0	0	0
Ханты-Мансийский автономный округ	Частные; Очная	"   стипендии, назначенные физическими лицами (кроме именных,
   указанных в строке 09) / 12.0"	0	0	0	0	0	0
Ханты-Мансийский автономный округ	Частные; Очная	"   стипендии, назначенные юридическими лицами (кроме именных,
   указанных в строке 07) / 10.0"	0	0	0	0	0	0
Ханты-Мансийский автономный округ	Частные; Очная	Численность студентов, получающих другие формы материальной поддержки / 14.0	0	0	0	0	0	0
Ханты-Мансийский автономный округ	Частные; Очная	Численность студентов, получающих: государственные академические стипендии / 1.0	54	54	0	629	629	0
Челябинская область	Государственные, муниципальные (без учета организаций в ведении ФСИН); Очная	      в том числе студентам, направленным ими на обучение / 11.0	0	0	0	0	0	0
Челябинская область	Государственные, муниципальные (без учета организаций в ведении ФСИН); Очная	      в том числе студентам, направленным ими на обучение / 13.0	0	0	0	0	0	0
Челябинская область	Государственные, муниципальные (без учета организаций в ведении ФСИН); Очная	      из них организацией, студентами которой они являются / 8.0	8	8	0	18	18	0
Челябинская область	Государственные, муниципальные (без учета организаций в ведении ФСИН); Очная	   бюджетных ассигнований бюджета субъекта Российской Федерации / 16.0	485	483	2	956	902	54
Челябинская область	Государственные, муниципальные (без учета организаций в ведении ФСИН); Очная	   государственные социальные стипендии / 2.0	1485	1471	14	3861	3562	299
Челябинская область	Государственные, муниципальные (без учета организаций в ведении ФСИН); Очная	"   из них за счет средств: 
   стипендиального фонда / 15.0"	59	59	0	297	237	60
Челябинская область	Государственные, муниципальные (без учета организаций в ведении ФСИН); Очная	"   именные стипендии, учрежденные: 
   органами государственной власти субъекта Российской Федерации / 5.0"	4	4	0	14	14	0
Челябинская область	Государственные, муниципальные (без учета организаций в ведении ФСИН); Очная	   именные стипендии, учрежденные: органами местного самоуправления / 6.0	0	0	0	6	6	0
Челябинская область	Государственные, муниципальные (без учета организаций в ведении ФСИН); Очная	   именные стипендии, учрежденные: федеральными государственными органами / 4.0	0	0	0	0	0	0
Челябинская область	Государственные, муниципальные (без учета организаций в ведении ФСИН); Очная	   именные стипендии, учрежденные: физическими лицами / 9.0	0	0	0	0	0	0
Челябинская область	Государственные, муниципальные (без учета организаций в ведении ФСИН); Очная	   именные стипендии, учрежденные: юридическими лицами / 7.0	9	9	0	78	78	0
Челябинская область	Государственные, муниципальные (без учета организаций в ведении ФСИН); Очная	   полученных от приносящей доход деятельности / 17.0	80	80	0	202	199	3
Челябинская область	Государственные, муниципальные (без учета организаций в ведении ФСИН); Очная	   стипендии Правительства Российской Федерации / 3.0	60	58	2	106	95	11
Челябинская область	Государственные, муниципальные (без учета организаций в ведении ФСИН); Очная	"   стипендии, назначенные физическими лицами (кроме именных,
   указанных в строке 09) / 12.0"	0	0	0	0	0	0
Челябинская область	Государственные, муниципальные (без учета организаций в ведении ФСИН); Очная	"   стипендии, назначенные юридическими лицами (кроме именных,
   указанных в строке 07) / 10.0"	7	7	0	52	52	0
Челябинская область	Государственные, муниципальные (без учета организаций в ведении ФСИН); Очная	Численность студентов, получающих другие формы материальной поддержки / 14.0	627	625	2	1868	1748	120
Челябинская область	Государственные, муниципальные (без учета организаций в ведении ФСИН); Очная	Численность студентов, получающих: государственные академические стипендии / 1.0	6485	6393	92	26801	24605	2196
Челябинская область	Частные; Очная	      в том числе студентам, направленным ими на обучение / 11.0	0	0	0	0	0	0
Челябинская область	Частные; Очная	      в том числе студентам, направленным ими на обучение / 13.0	0	0	0	0	0	0
Челябинская область	Частные; Очная	      из них организацией, студентами которой они являются / 8.0	0	0	0	22	21	1
Челябинская область	Частные; Очная	   бюджетных ассигнований бюджета субъекта Российской Федерации / 16.0	0	0	0	0	0	0
Челябинская область	Частные; Очная	   государственные социальные стипендии / 2.0	0	0	0	0	0	0
Челябинская область	Частные; Очная	"   из них за счет средств: 
   стипендиального фонда / 15.0"	0	0	0	61	11	50
Челябинская область	Частные; Очная	"   именные стипендии, учрежденные: 
   органами государственной власти субъекта Российской Федерации / 5.0"	0	0	0	1	1	0
Челябинская область	Частные; Очная	   именные стипендии, учрежденные: органами местного самоуправления / 6.0	0	0	0	0	0	0
Челябинская область	Частные; Очная	   именные стипендии, учрежденные: федеральными государственными органами / 4.0	0	0	0	4	4	0
Челябинская область	Частные; Очная	   именные стипендии, учрежденные: физическими лицами / 9.0	0	0	0	0	0	0
Челябинская область	Частные; Очная	   именные стипендии, учрежденные: юридическими лицами / 7.0	0	0	0	22	21	1
Челябинская область	Частные; Очная	   полученных от приносящей доход деятельности / 17.0	10	10	0	597	559	38
Челябинская область	Частные; Очная	   стипендии Правительства Российской Федерации / 3.0	0	0	0	3	3	0
Челябинская область	Частные; Очная	"   стипендии, назначенные физическими лицами (кроме именных,
   указанных в строке 09) / 12.0"	0	0	0	0	0	0
Челябинская область	Частные; Очная	"   стипендии, назначенные юридическими лицами (кроме именных,
   указанных в строке 07) / 10.0"	0	0	0	1	1	0
Челябинская область	Частные; Очная	Численность студентов, получающих другие формы материальной поддержки / 14.0	10	10	0	658	570	88
Челябинская область	Частные; Очная	Численность студентов, получающих: государственные академические стипендии / 1.0	0	0	0	0	0	0
Чеченская Республика	Государственные, муниципальные (без учета организаций в ведении ФСИН); Очная	      в том числе студентам, направленным ими на обучение / 11.0	0	0	0	0	0	0
Чеченская Республика	Государственные, муниципальные (без учета организаций в ведении ФСИН); Очная	      в том числе студентам, направленным ими на обучение / 13.0	0	0	0	0	0	0
Чеченская Республика	Государственные, муниципальные (без учета организаций в ведении ФСИН); Очная	      из них организацией, студентами которой они являются / 8.0	0	0	0	0	0	0
Чеченская Республика	Государственные, муниципальные (без учета организаций в ведении ФСИН); Очная	   бюджетных ассигнований бюджета субъекта Российской Федерации / 16.0	167	92	75	329	304	25
Чеченская Республика	Государственные, муниципальные (без учета организаций в ведении ФСИН); Очная	   государственные социальные стипендии / 2.0	107	102	5	990	920	70
Чеченская Республика	Государственные, муниципальные (без учета организаций в ведении ФСИН); Очная	"   из них за счет средств: 
   стипендиального фонда / 15.0"	0	0	0	87	87	0
Чеченская Республика	Государственные, муниципальные (без учета организаций в ведении ФСИН); Очная	"   именные стипендии, учрежденные: 
   органами государственной власти субъекта Российской Федерации / 5.0"	0	0	0	0	0	0
Чеченская Республика	Государственные, муниципальные (без учета организаций в ведении ФСИН); Очная	   именные стипендии, учрежденные: органами местного самоуправления / 6.0	0	0	0	0	0	0
Чеченская Республика	Государственные, муниципальные (без учета организаций в ведении ФСИН); Очная	   именные стипендии, учрежденные: федеральными государственными органами / 4.0	0	0	0	0	0	0
Чеченская Республика	Государственные, муниципальные (без учета организаций в ведении ФСИН); Очная	   именные стипендии, учрежденные: физическими лицами / 9.0	0	0	0	0	0	0
Чеченская Республика	Государственные, муниципальные (без учета организаций в ведении ФСИН); Очная	   именные стипендии, учрежденные: юридическими лицами / 7.0	0	0	0	0	0	0
Чеченская Республика	Государственные, муниципальные (без учета организаций в ведении ФСИН); Очная	   полученных от приносящей доход деятельности / 17.0	0	0	0	0	0	0
Чеченская Республика	Государственные, муниципальные (без учета организаций в ведении ФСИН); Очная	   стипендии Правительства Российской Федерации / 3.0	11	11	0	17	17	0
Чеченская Республика	Государственные, муниципальные (без учета организаций в ведении ФСИН); Очная	"   стипендии, назначенные физическими лицами (кроме именных,
   указанных в строке 09) / 12.0"	0	0	0	0	0	0
Чеченская Республика	Государственные, муниципальные (без учета организаций в ведении ФСИН); Очная	"   стипендии, назначенные юридическими лицами (кроме именных,
   указанных в строке 07) / 10.0"	25	20	5	0	0	0
Чеченская Республика	Государственные, муниципальные (без учета организаций в ведении ФСИН); Очная	Численность студентов, получающих другие формы материальной поддержки / 14.0	167	92	75	416	391	25
Чеченская Республика	Государственные, муниципальные (без учета организаций в ведении ФСИН); Очная	Численность студентов, получающих: государственные академические стипендии / 1.0	2964	2495	469	7700	7301	399
Чеченская Республика	Частные; Очная	      в том числе студентам, направленным ими на обучение / 11.0	0	0	0	0	0	0
Чеченская Республика	Частные; Очная	      в том числе студентам, направленным ими на обучение / 13.0	0	0	0	0	0	0
Чеченская Республика	Частные; Очная	      из них организацией, студентами которой они являются / 8.0	0	0	0	0	0	0
Чеченская Республика	Частные; Очная	   бюджетных ассигнований бюджета субъекта Российской Федерации / 16.0	0	0	0	0	0	0
Чеченская Республика	Частные; Очная	   государственные социальные стипендии / 2.0	0	0	0	0	0	0
Чеченская Республика	Частные; Очная	"   из них за счет средств: 
   стипендиального фонда / 15.0"	0	0	0	0	0	0
Чеченская Республика	Частные; Очная	"   именные стипендии, учрежденные: 
   органами государственной власти субъекта Российской Федерации / 5.0"	0	0	0	0	0	0
Чеченская Республика	Частные; Очная	   именные стипендии, учрежденные: органами местного самоуправления / 6.0	0	0	0	0	0	0
Чеченская Республика	Частные; Очная	   именные стипендии, учрежденные: федеральными государственными органами / 4.0	0	0	0	0	0	0
Чеченская Республика	Частные; Очная	   именные стипендии, учрежденные: физическими лицами / 9.0	0	0	0	0	0	0
Чеченская Республика	Частные; Очная	   именные стипендии, учрежденные: юридическими лицами / 7.0	0	0	0	0	0	0
Чеченская Республика	Частные; Очная	   полученных от приносящей доход деятельности / 17.0	0	0	0	0	0	0
Чеченская Республика	Частные; Очная	   стипендии Правительства Российской Федерации / 3.0	0	0	0	0	0	0
Чеченская Республика	Частные; Очная	"   стипендии, назначенные физическими лицами (кроме именных,
   указанных в строке 09) / 12.0"	0	0	0	0	0	0
Чеченская Республика	Частные; Очная	"   стипендии, назначенные юридическими лицами (кроме именных,
   указанных в строке 07) / 10.0"	0	0	0	0	0	0
Чеченская Республика	Частные; Очная	Численность студентов, получающих другие формы материальной поддержки / 14.0	0	0	0	0	0	0
Чеченская Республика	Частные; Очная	Численность студентов, получающих: государственные академические стипендии / 1.0	0	0	0	0	0	0
Чувашская Республика	Государственные, муниципальные (без учета организаций в ведении ФСИН); Очная	      в том числе студентам, направленным ими на обучение / 11.0	0	0	0	38	38	0
Чувашская Республика	Государственные, муниципальные (без учета организаций в ведении ФСИН); Очная	      в том числе студентам, направленным ими на обучение / 13.0	5	5	0	6	6	0
Чувашская Республика	Государственные, муниципальные (без учета организаций в ведении ФСИН); Очная	      из них организацией, студентами которой они являются / 8.0	0	0	0	10	10	0
Чувашская Республика	Государственные, муниципальные (без учета организаций в ведении ФСИН); Очная	   бюджетных ассигнований бюджета субъекта Российской Федерации / 16.0	118	104	14	232	229	3
Чувашская Республика	Государственные, муниципальные (без учета организаций в ведении ФСИН); Очная	   государственные социальные стипендии / 2.0	453	401	52	1280	1194	86
Чувашская Республика	Государственные, муниципальные (без учета организаций в ведении ФСИН); Очная	"   из них за счет средств: 
   стипендиального фонда / 15.0"	57	57	0	168	156	12
Чувашская Республика	Государственные, муниципальные (без учета организаций в ведении ФСИН); Очная	"   именные стипендии, учрежденные: 
   органами государственной власти субъекта Российской Федерации / 5.0"	1	1	0	19	19	0
Чувашская Республика	Государственные, муниципальные (без учета организаций в ведении ФСИН); Очная	   именные стипендии, учрежденные: органами местного самоуправления / 6.0	0	0	0	0	0	0
Чувашская Республика	Государственные, муниципальные (без учета организаций в ведении ФСИН); Очная	   именные стипендии, учрежденные: федеральными государственными органами / 4.0	0	0	0	0	0	0
Чувашская Республика	Государственные, муниципальные (без учета организаций в ведении ФСИН); Очная	   именные стипендии, учрежденные: физическими лицами / 9.0	0	0	0	0	0	0
Чувашская Республика	Государственные, муниципальные (без учета организаций в ведении ФСИН); Очная	   именные стипендии, учрежденные: юридическими лицами / 7.0	0	0	0	12	12	0
Чувашская Республика	Государственные, муниципальные (без учета организаций в ведении ФСИН); Очная	   полученных от приносящей доход деятельности / 17.0	13	13	0	488	457	31
Чувашская Республика	Государственные, муниципальные (без учета организаций в ведении ФСИН); Очная	   стипендии Правительства Российской Федерации / 3.0	3	3	0	38	38	0
Чувашская Республика	Государственные, муниципальные (без учета организаций в ведении ФСИН); Очная	"   стипендии, назначенные физическими лицами (кроме именных,
   указанных в строке 09) / 12.0"	33	33	0	30	30	0
Чувашская Республика	Государственные, муниципальные (без учета организаций в ведении ФСИН); Очная	"   стипендии, назначенные юридическими лицами (кроме именных,
   указанных в строке 07) / 10.0"	38	38	0	74	74	0
Чувашская Республика	Государственные, муниципальные (без учета организаций в ведении ФСИН); Очная	Численность студентов, получающих другие формы материальной поддержки / 14.0	131	117	14	893	836	57
Чувашская Республика	Государственные, муниципальные (без учета организаций в ведении ФСИН); Очная	Численность студентов, получающих: государственные академические стипендии / 1.0	3092	2265	827	11056	10534	522
Чувашская Республика	Частные; Очная	      в том числе студентам, направленным ими на обучение / 11.0	0	0	0	0	0	0
Чувашская Республика	Частные; Очная	      в том числе студентам, направленным ими на обучение / 13.0	0	0	0	0	0	0
Чувашская Республика	Частные; Очная	      из них организацией, студентами которой они являются / 8.0	0	0	0	0	0	0
Чувашская Республика	Частные; Очная	   бюджетных ассигнований бюджета субъекта Российской Федерации / 16.0	0	0	0	2	2	0
Чувашская Республика	Частные; Очная	   государственные социальные стипендии / 2.0	0	0	0	25	25	0
Чувашская Республика	Частные; Очная	"   из них за счет средств: 
   стипендиального фонда / 15.0"	0	0	0	0	0	0
Чувашская Республика	Частные; Очная	"   именные стипендии, учрежденные: 
   органами государственной власти субъекта Российской Федерации / 5.0"	0	0	0	0	0	0
Чувашская Республика	Частные; Очная	   именные стипендии, учрежденные: органами местного самоуправления / 6.0	0	0	0	0	0	0
Чувашская Республика	Частные; Очная	   именные стипендии, учрежденные: федеральными государственными органами / 4.0	0	0	0	0	0	0
Чувашская Республика	Частные; Очная	   именные стипендии, учрежденные: физическими лицами / 9.0	0	0	0	0	0	0
Чувашская Республика	Частные; Очная	   именные стипендии, учрежденные: юридическими лицами / 7.0	0	0	0	3	3	0
Чувашская Республика	Частные; Очная	   полученных от приносящей доход деятельности / 17.0	0	0	0	0	0	0
Чувашская Республика	Частные; Очная	   стипендии Правительства Российской Федерации / 3.0	0	0	0	0	0	0
Чувашская Республика	Частные; Очная	"   стипендии, назначенные физическими лицами (кроме именных,
   указанных в строке 09) / 12.0"	0	0	0	0	0	0
Чувашская Республика	Частные; Очная	"   стипендии, назначенные юридическими лицами (кроме именных,
   указанных в строке 07) / 10.0"	0	0	0	0	0	0
Чувашская Республика	Частные; Очная	Численность студентов, получающих другие формы материальной поддержки / 14.0	0	0	0	2	2	0
Чувашская Республика	Частные; Очная	Численность студентов, получающих: государственные академические стипендии / 1.0	46	46	0	346	346	0
Чукотский автономный округ	Государственные, муниципальные (без учета организаций в ведении ФСИН); Очная	      в том числе студентам, направленным ими на обучение / 11.0	0	0	0	0	0	0
Чукотский автономный округ	Государственные, муниципальные (без учета организаций в ведении ФСИН); Очная	      в том числе студентам, направленным ими на обучение / 13.0	0	0	0	0	0	0
Чукотский автономный округ	Государственные, муниципальные (без учета организаций в ведении ФСИН); Очная	      из них организацией, студентами которой они являются / 8.0	0	0	0	0	0	0
Чукотский автономный округ	Государственные, муниципальные (без учета организаций в ведении ФСИН); Очная	   бюджетных ассигнований бюджета субъекта Российской Федерации / 16.0	9	9	0	50	35	15
Чукотский автономный округ	Государственные, муниципальные (без учета организаций в ведении ФСИН); Очная	   государственные социальные стипендии / 2.0	15	15	0	68	53	15
Чукотский автономный округ	Государственные, муниципальные (без учета организаций в ведении ФСИН); Очная	"   из них за счет средств: 
   стипендиального фонда / 15.0"	0	0	0	0	0	0
Чукотский автономный округ	Государственные, муниципальные (без учета организаций в ведении ФСИН); Очная	"   именные стипендии, учрежденные: 
   органами государственной власти субъекта Российской Федерации / 5.0"	0	0	0	0	0	0
Чукотский автономный округ	Государственные, муниципальные (без учета организаций в ведении ФСИН); Очная	   именные стипендии, учрежденные: органами местного самоуправления / 6.0	0	0	0	0	0	0
Чукотский автономный округ	Государственные, муниципальные (без учета организаций в ведении ФСИН); Очная	   именные стипендии, учрежденные: федеральными государственными органами / 4.0	1	1	0	0	0	0
Чукотский автономный округ	Государственные, муниципальные (без учета организаций в ведении ФСИН); Очная	   именные стипендии, учрежденные: физическими лицами / 9.0	0	0	0	0	0	0
Чукотский автономный округ	Государственные, муниципальные (без учета организаций в ведении ФСИН); Очная	   именные стипендии, учрежденные: юридическими лицами / 7.0	0	0	0	0	0	0
Чукотский автономный округ	Государственные, муниципальные (без учета организаций в ведении ФСИН); Очная	   полученных от приносящей доход деятельности / 17.0	0	0	0	0	0	0
Чукотский автономный округ	Государственные, муниципальные (без учета организаций в ведении ФСИН); Очная	   стипендии Правительства Российской Федерации / 3.0	1	1	0	1	1	0
Чукотский автономный округ	Государственные, муниципальные (без учета организаций в ведении ФСИН); Очная	"   стипендии, назначенные физическими лицами (кроме именных,
   указанных в строке 09) / 12.0"	0	0	0	0	0	0
Чукотский автономный округ	Государственные, муниципальные (без учета организаций в ведении ФСИН); Очная	"   стипендии, назначенные юридическими лицами (кроме именных,
   указанных в строке 07) / 10.0"	0	0	0	0	0	0
Чукотский автономный округ	Государственные, муниципальные (без учета организаций в ведении ФСИН); Очная	Численность студентов, получающих другие формы материальной поддержки / 14.0	9	9	0	50	35	15
Чукотский автономный округ	Государственные, муниципальные (без учета организаций в ведении ФСИН); Очная	Численность студентов, получающих: государственные академические стипендии / 1.0	79	79	0	204	139	65
Ямало-Ненецкий автономный округ	Государственные, муниципальные (без учета организаций в ведении ФСИН); Очная	      в том числе студентам, направленным ими на обучение / 11.0	0	0	0	0	0	0
Ямало-Ненецкий автономный округ	Государственные, муниципальные (без учета организаций в ведении ФСИН); Очная	      в том числе студентам, направленным ими на обучение / 13.0	0	0	0	0	0	0
Ямало-Ненецкий автономный округ	Государственные, муниципальные (без учета организаций в ведении ФСИН); Очная	      из них организацией, студентами которой они являются / 8.0	0	0	0	0	0	0
Ямало-Ненецкий автономный округ	Государственные, муниципальные (без учета организаций в ведении ФСИН); Очная	   бюджетных ассигнований бюджета субъекта Российской Федерации / 16.0	0	0	0	3	2	1
Ямало-Ненецкий автономный округ	Государственные, муниципальные (без учета организаций в ведении ФСИН); Очная	   государственные социальные стипендии / 2.0	331	330	1	550	520	30
Ямало-Ненецкий автономный округ	Государственные, муниципальные (без учета организаций в ведении ФСИН); Очная	"   из них за счет средств: 
   стипендиального фонда / 15.0"	0	0	0	4	3	1
Ямало-Ненецкий автономный округ	Государственные, муниципальные (без учета организаций в ведении ФСИН); Очная	"   именные стипендии, учрежденные: 
   органами государственной власти субъекта Российской Федерации / 5.0"	17	17	0	22	19	3
Ямало-Ненецкий автономный округ	Государственные, муниципальные (без учета организаций в ведении ФСИН); Очная	   именные стипендии, учрежденные: органами местного самоуправления / 6.0	0	0	0	0	0	0
Ямало-Ненецкий автономный округ	Государственные, муниципальные (без учета организаций в ведении ФСИН); Очная	   именные стипендии, учрежденные: федеральными государственными органами / 4.0	0	0	0	1	1	0
Ямало-Ненецкий автономный округ	Государственные, муниципальные (без учета организаций в ведении ФСИН); Очная	   именные стипендии, учрежденные: физическими лицами / 9.0	0	0	0	0	0	0
Ямало-Ненецкий автономный округ	Государственные, муниципальные (без учета организаций в ведении ФСИН); Очная	   именные стипендии, учрежденные: юридическими лицами / 7.0	0	0	0	0	0	0
Ямало-Ненецкий автономный округ	Государственные, муниципальные (без учета организаций в ведении ФСИН); Очная	   полученных от приносящей доход деятельности / 17.0	0	0	0	2	2	0
Ямало-Ненецкий автономный округ	Государственные, муниципальные (без учета организаций в ведении ФСИН); Очная	   стипендии Правительства Российской Федерации / 3.0	4	4	0	7	6	1
Ямало-Ненецкий автономный округ	Государственные, муниципальные (без учета организаций в ведении ФСИН); Очная	"   стипендии, назначенные физическими лицами (кроме именных,
   указанных в строке 09) / 12.0"	0	0	0	0	0	0
Ямало-Ненецкий автономный округ	Государственные, муниципальные (без учета организаций в ведении ФСИН); Очная	"   стипендии, назначенные юридическими лицами (кроме именных,
   указанных в строке 07) / 10.0"	0	0	0	0	0	0
Ямало-Ненецкий автономный округ	Государственные, муниципальные (без учета организаций в ведении ФСИН); Очная	Численность студентов, получающих другие формы материальной поддержки / 14.0	28	27	1	61	60	1
Ямало-Ненецкий автономный округ	Государственные, муниципальные (без учета организаций в ведении ФСИН); Очная	Численность студентов, получающих: государственные академические стипендии / 1.0	1285	1285	0	2976	2733	243
Ямало-Ненецкий автономный округ	Частные; Очная	      в том числе студентам, направленным ими на обучение / 11.0	0	0	0	0	0	0
Ямало-Ненецкий автономный округ	Частные; Очная	      в том числе студентам, направленным ими на обучение / 13.0	0	0	0	0	0	0
Ямало-Ненецкий автономный округ	Частные; Очная	      из них организацией, студентами которой они являются / 8.0	0	0	0	0	0	0
Ямало-Ненецкий автономный округ	Частные; Очная	   бюджетных ассигнований бюджета субъекта Российской Федерации / 16.0	0	0	0	8	7	1
Ямало-Ненецкий автономный округ	Частные; Очная	   государственные социальные стипендии / 2.0	0	0	0	10	10	0
Ямало-Ненецкий автономный округ	Частные; Очная	"   из них за счет средств: 
   стипендиального фонда / 15.0"	0	0	0	192	192	0
Ямало-Ненецкий автономный округ	Частные; Очная	"   именные стипендии, учрежденные: 
   органами государственной власти субъекта Российской Федерации / 5.0"	0	0	0	3	3	0
Ямало-Ненецкий автономный округ	Частные; Очная	   именные стипендии, учрежденные: органами местного самоуправления / 6.0	0	0	0	0	0	0
Ямало-Ненецкий автономный округ	Частные; Очная	   именные стипендии, учрежденные: федеральными государственными органами / 4.0	0	0	0	0	0	0
Ямало-Ненецкий автономный округ	Частные; Очная	   именные стипендии, учрежденные: физическими лицами / 9.0	0	0	0	0	0	0
Ямало-Ненецкий автономный округ	Частные; Очная	   именные стипендии, учрежденные: юридическими лицами / 7.0	0	0	0	6	6	0
Ямало-Ненецкий автономный округ	Частные; Очная	   полученных от приносящей доход деятельности / 17.0	0	0	0	0	0	0
Ямало-Ненецкий автономный округ	Частные; Очная	   стипендии Правительства Российской Федерации / 3.0	0	0	0	1	1	0
Ямало-Ненецкий автономный округ	Частные; Очная	"   стипендии, назначенные физическими лицами (кроме именных,
   указанных в строке 09) / 12.0"	0	0	0	0	0	0
Ямало-Ненецкий автономный округ	Частные; Очная	"   стипендии, назначенные юридическими лицами (кроме именных,
   указанных в строке 07) / 10.0"	0	0	0	0	0	0
Ямало-Ненецкий автономный округ	Частные; Очная	Численность студентов, получающих другие формы материальной поддержки / 14.0	0	0	0	200	199	1
Ямало-Ненецкий автономный округ	Частные; Очная	Численность студентов, получающих: государственные академические стипендии / 1.0	0	0	0	0	0	0
Ярославская область	Государственные, муниципальные (без учета организаций в ведении ФСИН); Очная	      в том числе студентам, направленным ими на обучение / 11.0	0	0	0	84	81	3
Ярославская область	Государственные, муниципальные (без учета организаций в ведении ФСИН); Очная	      в том числе студентам, направленным ими на обучение / 13.0	0	0	0	0	0	0
Ярославская область	Государственные, муниципальные (без учета организаций в ведении ФСИН); Очная	      из них организацией, студентами которой они являются / 8.0	0	0	0	75	50	25
Ярославская область	Государственные, муниципальные (без учета организаций в ведении ФСИН); Очная	   бюджетных ассигнований бюджета субъекта Российской Федерации / 16.0	177	148	29	360	277	83
Ярославская область	Государственные, муниципальные (без учета организаций в ведении ФСИН); Очная	   государственные социальные стипендии / 2.0	727	715	12	1027	873	154
Ярославская область	Государственные, муниципальные (без учета организаций в ведении ФСИН); Очная	"   из них за счет средств: 
   стипендиального фонда / 15.0"	392	360	32	2083	1679	404
Ярославская область	Государственные, муниципальные (без учета организаций в ведении ФСИН); Очная	"   именные стипендии, учрежденные: 
   органами государственной власти субъекта Российской Федерации / 5.0"	15	15	0	59	47	12
Ярославская область	Государственные, муниципальные (без учета организаций в ведении ФСИН); Очная	   именные стипендии, учрежденные: органами местного самоуправления / 6.0	0	0	0	5	5	0
Ярославская область	Государственные, муниципальные (без учета организаций в ведении ФСИН); Очная	   именные стипендии, учрежденные: федеральными государственными органами / 4.0	1	1	0	5	5	0
Ярославская область	Государственные, муниципальные (без учета организаций в ведении ФСИН); Очная	   именные стипендии, учрежденные: физическими лицами / 9.0	0	0	0	0	0	0
Ярославская область	Государственные, муниципальные (без учета организаций в ведении ФСИН); Очная	   именные стипендии, учрежденные: юридическими лицами / 7.0	0	0	0	75	50	25
Ярославская область	Государственные, муниципальные (без учета организаций в ведении ФСИН); Очная	   полученных от приносящей доход деятельности / 17.0	41	41	0	431	375	56
Ярославская область	Государственные, муниципальные (без учета организаций в ведении ФСИН); Очная	   стипендии Правительства Российской Федерации / 3.0	12	12	0	48	44	4
Ярославская область	Государственные, муниципальные (без учета организаций в ведении ФСИН); Очная	"   стипендии, назначенные физическими лицами (кроме именных,
   указанных в строке 09) / 12.0"	0	0	0	0	0	0
Ярославская область	Государственные, муниципальные (без учета организаций в ведении ФСИН); Очная	"   стипендии, назначенные юридическими лицами (кроме именных,
   указанных в строке 07) / 10.0"	70	70	0	128	125	3
Ярославская область	Государственные, муниципальные (без учета организаций в ведении ФСИН); Очная	Численность студентов, получающих другие формы материальной поддержки / 14.0	545	509	36	2644	2166	478
Ярославская область	Государственные, муниципальные (без учета организаций в ведении ФСИН); Очная	Численность студентов, получающих: государственные академические стипендии / 1.0	3887	3415	472	10651	8911	1740
Ярославская область	Частные; Очная	      в том числе студентам, направленным ими на обучение / 11.0	0	0	0	0	0	0
Ярославская область	Частные; Очная	      в том числе студентам, направленным ими на обучение / 13.0	0	0	0	0	0	0
Ярославская область	Частные; Очная	      из них организацией, студентами которой они являются / 8.0	0	0	0	0	0	0
Ярославская область	Частные; Очная	   бюджетных ассигнований бюджета субъекта Российской Федерации / 16.0	0	0	0	5	4	1
Ярославская область	Частные; Очная	   государственные социальные стипендии / 2.0	0	0	0	8	6	2
Ярославская область	Частные; Очная	"   из них за счет средств: 
   стипендиального фонда / 15.0"	0	0	0	0	0	0
Ярославская область	Частные; Очная	"   именные стипендии, учрежденные: 
   органами государственной власти субъекта Российской Федерации / 5.0"	0	0	0	0	0	0
Ярославская область	Частные; Очная	   именные стипендии, учрежденные: органами местного самоуправления / 6.0	0	0	0	0	0	0
Ярославская область	Частные; Очная	   именные стипендии, учрежденные: федеральными государственными органами / 4.0	0	0	0	0	0	0
Ярославская область	Частные; Очная	   именные стипендии, учрежденные: физическими лицами / 9.0	0	0	0	0	0	0
Ярославская область	Частные; Очная	   именные стипендии, учрежденные: юридическими лицами / 7.0	0	0	0	0	0	0
Ярославская область	Частные; Очная	   полученных от приносящей доход деятельности / 17.0	0	0	0	0	0	0
Ярославская область	Частные; Очная	   стипендии Правительства Российской Федерации / 3.0	0	0	0	0	0	0
Ярославская область	Частные; Очная	"   стипендии, назначенные физическими лицами (кроме именных,
   указанных в строке 09) / 12.0"	0	0	0	0	0	0
Ярославская область	Частные; Очная	"   стипендии, назначенные юридическими лицами (кроме именных,
   указанных в строке 07) / 10.0"	0	0	0	0	0	0
Ярославская область	Частные; Очная	Численность студентов, получающих другие формы материальной поддержки / 14.0	0	0	0	5	4	1
Ярославская область	Частные; Очная	Численность студентов, получающих: государственные академические стипендии / 1.0	0	0	0	116	109	7
г.Москва	Государственные, муниципальные (без учета организаций в ведении ФСИН); Очная	      в том числе студентам, направленным ими на обучение / 11.0	0	0	0	0	0	0
г.Москва	Государственные, муниципальные (без учета организаций в ведении ФСИН); Очная	      в том числе студентам, направленным ими на обучение / 13.0	0	0	0	0	0	0
г.Москва	Государственные, муниципальные (без учета организаций в ведении ФСИН); Очная	      из них организацией, студентами которой они являются / 8.0	0	0	0	38	36	2
г.Москва	Государственные, муниципальные (без учета организаций в ведении ФСИН); Очная	   бюджетных ассигнований бюджета субъекта Российской Федерации / 16.0	533	466	67	2318	1933	385
г.Москва	Государственные, муниципальные (без учета организаций в ведении ФСИН); Очная	   государственные социальные стипендии / 2.0	2303	2070	233	7482	6155	1327
г.Москва	Государственные, муниципальные (без учета организаций в ведении ФСИН); Очная	"   из них за счет средств: 
   стипендиального фонда / 15.0"	839	773	66	4562	3716	846
г.Москва	Государственные, муниципальные (без учета организаций в ведении ФСИН); Очная	"   именные стипендии, учрежденные: 
   органами государственной власти субъекта Российской Федерации / 5.0"	139	114	25	112	98	14
г.Москва	Государственные, муниципальные (без учета организаций в ведении ФСИН); Очная	   именные стипендии, учрежденные: органами местного самоуправления / 6.0	0	0	0	0	0	0
г.Москва	Государственные, муниципальные (без учета организаций в ведении ФСИН); Очная	   именные стипендии, учрежденные: федеральными государственными органами / 4.0	11	11	0	5	5	0
г.Москва	Государственные, муниципальные (без учета организаций в ведении ФСИН); Очная	   именные стипендии, учрежденные: физическими лицами / 9.0	0	0	0	1	1	0
г.Москва	Государственные, муниципальные (без учета организаций в ведении ФСИН); Очная	   именные стипендии, учрежденные: юридическими лицами / 7.0	1	1	0	60	56	4
г.Москва	Государственные, муниципальные (без учета организаций в ведении ФСИН); Очная	   полученных от приносящей доход деятельности / 17.0	64	61	3	316	287	29
г.Москва	Государственные, муниципальные (без учета организаций в ведении ФСИН); Очная	   стипендии Правительства Российской Федерации / 3.0	71	67	4	329	236	93
г.Москва	Государственные, муниципальные (без учета организаций в ведении ФСИН); Очная	"   стипендии, назначенные физическими лицами (кроме именных,
   указанных в строке 09) / 12.0"	0	0	0	0	0	0
г.Москва	Государственные, муниципальные (без учета организаций в ведении ФСИН); Очная	"   стипендии, назначенные юридическими лицами (кроме именных,
   указанных в строке 07) / 10.0"	0	0	0	75	73	2
г.Москва	Государственные, муниципальные (без учета организаций в ведении ФСИН); Очная	Численность студентов, получающих другие формы материальной поддержки / 14.0	1762	1604	158	8155	6693	1462
г.Москва	Государственные, муниципальные (без учета организаций в ведении ФСИН); Очная	Численность студентов, получающих: государственные академические стипендии / 1.0	8323	7198	1125	49222	40896	8326
г.Москва	Частные; Очная	      в том числе студентам, направленным ими на обучение / 11.0	0	0	0	0	0	0
г.Москва	Частные; Очная	      в том числе студентам, направленным ими на обучение / 13.0	0	0	0	0	0	0
г.Москва	Частные; Очная	      из них организацией, студентами которой они являются / 8.0	0	0	0	0	0	0
г.Москва	Частные; Очная	   бюджетных ассигнований бюджета субъекта Российской Федерации / 16.0	0	0	0	0	0	0
г.Москва	Частные; Очная	   государственные социальные стипендии / 2.0	0	0	0	11	11	0
г.Москва	Частные; Очная	"   из них за счет средств: 
   стипендиального фонда / 15.0"	0	0	0	14	9	5
г.Москва	Частные; Очная	"   именные стипендии, учрежденные: 
   органами государственной власти субъекта Российской Федерации / 5.0"	0	0	0	0	0	0
г.Москва	Частные; Очная	   именные стипендии, учрежденные: органами местного самоуправления / 6.0	0	0	0	0	0	0
г.Москва	Частные; Очная	   именные стипендии, учрежденные: федеральными государственными органами / 4.0	0	0	0	0	0	0
г.Москва	Частные; Очная	   именные стипендии, учрежденные: физическими лицами / 9.0	0	0	0	0	0	0
г.Москва	Частные; Очная	   именные стипендии, учрежденные: юридическими лицами / 7.0	0	0	0	0	0	0
г.Москва	Частные; Очная	   полученных от приносящей доход деятельности / 17.0	0	0	0	38	28	10
г.Москва	Частные; Очная	   стипендии Правительства Российской Федерации / 3.0	0	0	0	0	0	0
г.Москва	Частные; Очная	"   стипендии, назначенные физическими лицами (кроме именных,
   указанных в строке 09) / 12.0"	0	0	0	0	0	0
г.Москва	Частные; Очная	"   стипендии, назначенные юридическими лицами (кроме именных,
   указанных в строке 07) / 10.0"	0	0	0	0	0	0
г.Москва	Частные; Очная	Численность студентов, получающих другие формы материальной поддержки / 14.0	0	0	0	83	68	15
г.Москва	Частные; Очная	Численность студентов, получающих: государственные академические стипендии / 1.0	0	0	0	427	389	38
г.Санкт-Петербург	Государственные, муниципальные (без учета организаций в ведении ФСИН); Очная	      в том числе студентам, направленным ими на обучение / 11.0	0	0	0	0	0	0
г.Санкт-Петербург	Государственные, муниципальные (без учета организаций в ведении ФСИН); Очная	      в том числе студентам, направленным ими на обучение / 13.0	0	0	0	0	0	0
г.Санкт-Петербург	Государственные, муниципальные (без учета организаций в ведении ФСИН); Очная	      из них организацией, студентами которой они являются / 8.0	0	0	0	11	10	1
г.Санкт-Петербург	Государственные, муниципальные (без учета организаций в ведении ФСИН); Очная	   бюджетных ассигнований бюджета субъекта Российской Федерации / 16.0	87	32	55	327	259	68
г.Санкт-Петербург	Государственные, муниципальные (без учета организаций в ведении ФСИН); Очная	   государственные социальные стипендии / 2.0	1764	1473	291	3056	2435	621
г.Санкт-Петербург	Государственные, муниципальные (без учета организаций в ведении ФСИН); Очная	"   из них за счет средств: 
   стипендиального фонда / 15.0"	605	502	103	2955	2287	668
г.Санкт-Петербург	Государственные, муниципальные (без учета организаций в ведении ФСИН); Очная	"   именные стипендии, учрежденные: 
   органами государственной власти субъекта Российской Федерации / 5.0"	0	0	0	104	75	29
г.Санкт-Петербург	Государственные, муниципальные (без учета организаций в ведении ФСИН); Очная	   именные стипендии, учрежденные: органами местного самоуправления / 6.0	0	0	0	0	0	0
г.Санкт-Петербург	Государственные, муниципальные (без учета организаций в ведении ФСИН); Очная	   именные стипендии, учрежденные: федеральными государственными органами / 4.0	0	0	0	8	8	0
г.Санкт-Петербург	Государственные, муниципальные (без учета организаций в ведении ФСИН); Очная	   именные стипендии, учрежденные: физическими лицами / 9.0	0	0	0	0	0	0
г.Санкт-Петербург	Государственные, муниципальные (без учета организаций в ведении ФСИН); Очная	   именные стипендии, учрежденные: юридическими лицами / 7.0	15	15	0	26	23	3
г.Санкт-Петербург	Государственные, муниципальные (без учета организаций в ведении ФСИН); Очная	   полученных от приносящей доход деятельности / 17.0	86	68	18	371	270	101
г.Санкт-Петербург	Государственные, муниципальные (без учета организаций в ведении ФСИН); Очная	   стипендии Правительства Российской Федерации / 3.0	74	55	19	198	177	21
г.Санкт-Петербург	Государственные, муниципальные (без учета организаций в ведении ФСИН); Очная	"   стипендии, назначенные физическими лицами (кроме именных,
   указанных в строке 09) / 12.0"	0	0	0	0	0	0
г.Санкт-Петербург	Государственные, муниципальные (без учета организаций в ведении ФСИН); Очная	"   стипендии, назначенные юридическими лицами (кроме именных,
   указанных в строке 07) / 10.0"	0	0	0	10	9	1
г.Санкт-Петербург	Государственные, муниципальные (без учета организаций в ведении ФСИН); Очная	Численность студентов, получающих другие формы материальной поддержки / 14.0	750	602	148	3492	2693	799
г.Санкт-Петербург	Государственные, муниципальные (без учета организаций в ведении ФСИН); Очная	Численность студентов, получающих: государственные академические стипендии / 1.0	11667	9403	2264	38810	31172	7638
г.Санкт-Петербург	Частные; Очная	      в том числе студентам, направленным ими на обучение / 11.0	0	0	0	0	0	0
г.Санкт-Петербург	Частные; Очная	      в том числе студентам, направленным ими на обучение / 13.0	0	0	0	0	0	0
г.Санкт-Петербург	Частные; Очная	      из них организацией, студентами которой они являются / 8.0	0	0	0	0	0	0
г.Санкт-Петербург	Частные; Очная	   бюджетных ассигнований бюджета субъекта Российской Федерации / 16.0	0	0	0	0	0	0
г.Санкт-Петербург	Частные; Очная	   государственные социальные стипендии / 2.0	0	0	0	0	0	0
г.Санкт-Петербург	Частные; Очная	"   из них за счет средств: 
   стипендиального фонда / 15.0"	0	0	0	0	0	0
г.Санкт-Петербург	Частные; Очная	"   именные стипендии, учрежденные: 
   органами государственной власти субъекта Российской Федерации / 5.0"	0	0	0	1	0	1
г.Санкт-Петербург	Частные; Очная	   именные стипендии, учрежденные: органами местного самоуправления / 6.0	0	0	0	0	0	0
г.Санкт-Петербург	Частные; Очная	   именные стипендии, учрежденные: федеральными государственными органами / 4.0	0	0	0	0	0	0
г.Санкт-Петербург	Частные; Очная	   именные стипендии, учрежденные: физическими лицами / 9.0	0	0	0	0	0	0
г.Санкт-Петербург	Частные; Очная	   именные стипендии, учрежденные: юридическими лицами / 7.0	0	0	0	0	0	0
г.Санкт-Петербург	Частные; Очная	   полученных от приносящей доход деятельности / 17.0	0	0	0	23	9	14
г.Санкт-Петербург	Частные; Очная	   стипендии Правительства Российской Федерации / 3.0	0	0	0	0	0	0
г.Санкт-Петербург	Частные; Очная	"   стипендии, назначенные физическими лицами (кроме именных,
   указанных в строке 09) / 12.0"	0	0	0	0	0	0
г.Санкт-Петербург	Частные; Очная	"   стипендии, назначенные юридическими лицами (кроме именных,
   указанных в строке 07) / 10.0"	0	0	0	0	0	0
г.Санкт-Петербург	Частные; Очная	Численность студентов, получающих другие формы материальной поддержки / 14.0	0	0	0	23	9	14
г.Санкт-Петербург	Частные; Очная	Численность студентов, получающих: государственные академические стипендии / 1.0	0	0	0	30	30	0
г.Севастополь	Государственные, муниципальные (без учета организаций в ведении ФСИН); Очная	      в том числе студентам, направленным ими на обучение / 11.0	0	0	0	0	0	0
г.Севастополь	Государственные, муниципальные (без учета организаций в ведении ФСИН); Очная	      в том числе студентам, направленным ими на обучение / 13.0	0	0	0	0	0	0
г.Севастополь	Государственные, муниципальные (без учета организаций в ведении ФСИН); Очная	      из них организацией, студентами которой они являются / 8.0	0	0	0	0	0	0
г.Севастополь	Государственные, муниципальные (без учета организаций в ведении ФСИН); Очная	   бюджетных ассигнований бюджета субъекта Российской Федерации / 16.0	23	20	3	373	289	84
г.Севастополь	Государственные, муниципальные (без учета организаций в ведении ФСИН); Очная	   государственные социальные стипендии / 2.0	149	145	4	192	155	37
г.Севастополь	Государственные, муниципальные (без учета организаций в ведении ФСИН); Очная	"   из них за счет средств: 
   стипендиального фонда / 15.0"	521	487	34	255	255	0
г.Севастополь	Государственные, муниципальные (без учета организаций в ведении ФСИН); Очная	"   именные стипендии, учрежденные: 
   органами государственной власти субъекта Российской Федерации / 5.0"	0	0	0	10	10	0
г.Севастополь	Государственные, муниципальные (без учета организаций в ведении ФСИН); Очная	   именные стипендии, учрежденные: органами местного самоуправления / 6.0	0	0	0	0	0	0
г.Севастополь	Государственные, муниципальные (без учета организаций в ведении ФСИН); Очная	   именные стипендии, учрежденные: федеральными государственными органами / 4.0	0	0	0	0	0	0
г.Севастополь	Государственные, муниципальные (без учета организаций в ведении ФСИН); Очная	   именные стипендии, учрежденные: физическими лицами / 9.0	0	0	0	0	0	0
г.Севастополь	Государственные, муниципальные (без учета организаций в ведении ФСИН); Очная	   именные стипендии, учрежденные: юридическими лицами / 7.0	0	0	0	0	0	0
г.Севастополь	Государственные, муниципальные (без учета организаций в ведении ФСИН); Очная	   полученных от приносящей доход деятельности / 17.0	0	0	0	13	11	2
г.Севастополь	Государственные, муниципальные (без учета организаций в ведении ФСИН); Очная	   стипендии Правительства Российской Федерации / 3.0	0	0	0	8	5	3
г.Севастополь	Государственные, муниципальные (без учета организаций в ведении ФСИН); Очная	"   стипендии, назначенные физическими лицами (кроме именных,
   указанных в строке 09) / 12.0"	0	0	0	0	0	0
г.Севастополь	Государственные, муниципальные (без учета организаций в ведении ФСИН); Очная	"   стипендии, назначенные юридическими лицами (кроме именных,
   указанных в строке 07) / 10.0"	0	0	0	0	0	0
г.Севастополь	Государственные, муниципальные (без учета организаций в ведении ФСИН); Очная	Численность студентов, получающих другие формы материальной поддержки / 14.0	533	496	37	643	558	85
г.Севастополь	Государственные, муниципальные (без учета организаций в ведении ФСИН); Очная	Численность студентов, получающих: государственные академические стипендии / 1.0	1307	1182	125	2719	2405	314
